Dd, Dd, Dd, Dd^Fds, Gs^Fds, Gg^Fms, Gg^Fms, Gs^Fds, Gs^Fds, Gs^Qhh, Gs, Rb^Qhh, Rb^Qhh, Gg, Gg, Gg^Qhhf, Gs^Qhhf, Gg^Qhhf, Gs^Qhhf, Gs^Fdf, Gs^Qhhf, Gg^Qhhf, Gs^Qhhf, Gs^Qhhf, Gs^Qhhf, Rrd^Fdw, Hh^Qhh, Hh^Qhh, Hh^Qhh, Gg^Qhh, Gg^Qhhf, Hh^Qhh, Hh^Qhh, Hh^Qhh, Hh^Qhh, Dd^Fds, Gd, Ce, Ke, Ce, Rb, Gg^Efm, Gg^Efm, Gg, Rb, Rb, Gg^Fms, Gg^Fms, Rrd^Fms, Rrd^Fds, Gs^Fmf, Rb
Rrd, Dd^Fdw, Rrd, Rrd, Rrd^Fdw, Gs^Fds, Gs^Fds, Gd^Fms, Gg^Fms, Gs^Qhh, Re^Vct, Rb^Qhh, Gd, Gd, Gg^Fms, Gs, Gs^Fms, Gs^Fdf, Gs^Qhhf, Gs^Fdf, Gs^Fdf, Gs^Fds, Gs^Qhhf, Gs^Qhhf, Dd, Dd, Rrd, Hh^Qhh, Hh^Qhh, Hh^Qhhf, Hh^_mh, Hh^Qhhf, Hh^Qhh, Hh^Qhhf, Hh^Qhh, Ce^Edt, Gs^Edt, Ce, Ce, Rrd^Fdw, Re^Vct, Gg^Efm, Gs, Gg, Rb, Re, Gg^Fms, Gd^Fmf, Gll^Fmf, Gll^Fmf, Gll^Fmf, Gg^Fms
Rrd^Fdw, Dd, Rrd, Dd^Fds, Gs^Fds, Gs^Fds, Gs, Gs^Qhh, Ce^Qhh, Gd^Qhh, Gd, Re, Re, Gd, Gs, Gg^Fms, Gs, Gg^Qhhf, Gg^Qhhf, Gs^Fdf, Gs^Qhhf, Gs^Qhhf, Dd, Dd, Dd, Rrd^Fdw, Dd^Dr, Gg, Gg, Hh^Qhh, Hh^Qhh, Hh^Qhhf, Hh^Qhh, Hh^Qhh, Gs, Gs, Gs^Edt, Gs, Gs, Gs, Rb, Gd, Rb, Re, Rrd^Fdw, Gd, Gd^Fmf, Gll^Fmf, Rrd^Fmf, Gd^Fmf, Gd^Fmf, Gd^Fmf
Rrd^Fdw, Rrd^Fdw, Dd, Dd, Gs, Gs, Ce, 8 Ke, Ce^Edt, Ce, Rb^Edt, Re, Re^Vct, Rb, Rb^Qhh, Re^Vct, Gg^Qhh, Hh^Qhh, Hh, Gg^Qhhf, Gll^Fmf, Gg^Fmf, Rrd^Fdw, Dd^Fdw, Gs, Gs, Gll^Fdf, Dd^Fdw, Gll^Fdf, Gg, Gg, Gg, Dd, Gg^Fms, Gg^Fdf, Gg, Dd, Rrd, Dd, Gg^Fdf, Dd^Fdf, Rb, Gd, Rrd, Dd, Rrd^Fms, Dd^Fdw, Gll^Fmf, Gll^Fdf, Dd, Rrd^Fdw, Rrd
Gg, Rrd, Gs, Ce^Edt, Gs, Gs, Gd, Rb, Re, Re, Dd^Edt, Re^Vct, Gd, Dd, Gs, Gs^Qhh, Dd, Hh, Dd, Gg^Fmf, Gll^Fmf, Gll^Fmf, Gll^Fms, Gg^Fdf, Gll^Fdf, Gll, Gll^Fdf, Cv^Dr, Gll^Fdf, Gll^Fdf, Gg, Gll^Fdf, Gd^Fdw, Gg, Gg^Fdf, Gg^Fdf, Rrd^Fdw, Rrd^Fdw, Gll^Fmf, Dd^Fdf, Gll^Fdf, Rb, Rrd^Fdw, Re^Vct, Ds, Dd^Fdw, Rrd^Fdw, Rrd^Fdw, Gd, Dd^Fdw, Dd^Fdw, Rb
Gs, Gs^Fds, Dd, Gs, Rrd^Fdw, Dd, Dd, Ce^Edt, Gs^Qhh, Dd^Qhh, Dd^Qhh, Gd^Qhh, Gd, Gs, Gs^Qhh, Gs^Qhh, Dd, Dd, Rrd^Fdw, Dd^Fdw, Gll^Fdf, Gll^Fmf, Gs^Fdf, Gll^Fms, Gg^Fdf, Gg, Gll^Fdf, Gg^Fdf, Gll^Fdf, Gll, Gll^Fdf, Gg^Fdf, Rrd, Gg, Dd, Gg^Fms, Dd^Fmf, Dd, Gll^Fmf, Gll^Fdf, Rb, Gs, Gs, Rrd, Re^Vct, Dd, Rrd^Fdw, Rrd^Fdw, Rrd, Gs, Gd, Gd
Wwt, Gs^Fds, Dd^Fds, Rrd, Rrd, Dd, Rrd^Fdw, Dd, Dd^Qhh, Rrd^Fdw, Gs, Rrd^Fdw, Hh^Qhh, Hh^Qhh, Hh, Gg^Fms, Gg^Fdf, Gg^Fms, Dd^Fdw, Gg^Fdf, Gll^Fms, Gll^Fdf, Gg^Fms, Gg^Fdf, Gg^Fms, Cv, Gg^Fdf, Gll^Fdf, Gll^Fms, Gll^Fdf, Gg^Fms, Cv, Gll^Fdf, Gll^Fdf, Dd, Rrd^Fdw, Rrd^Fdw, Rrd^Fdw, Gg^Fmf, Rb, Ds, Gs, Re^Vct, Ce^Edt, 4 Ke, Re^Ecf, Dd, Ds, Dd^Fdw, Rrd^Fdw, Dd^Fdw, Dd^Fdw
Gs, Wwt, Wwt, Rrd^Fdw, Rrd, Rrd^Fdw, Dd, Rrd, Rrd^Qhh, Gs^_mh, Rrd^Qhh, Rrd^Qhh, Hh, Gg, Rrd, Dd^Fms, Gg^Fdf, Gg, Gg, Gg^Fms, Gll^Fms, Gg^Fms, Gg^Fdf, Gg^Fdf, Gg, Gg^Fms, Gg^Fdf, Gg, Wwt, Gg^Ve, Gg^Fet, Gg^Fdf, Gll^Fdf, Gg^Fdf, Gg^Fdf, Gg^Fms, Rrd^Fdw, Dd^Fds, Rb, Rb, Rb, Rb^Edt, Ce, Gd, Ce, Ce, Gs^Edt, Re, Gs, Dd^Fdw, Rrd^Fdw, Gd
Gs, Gs, Dd^Fdw, Wwt, Wwf, Rrd, Dd^Fms, Rrd, Rrd^Fdw, Dd^Qhh, Gs^Qhh, Hh, Gg, Dd, Rrd^Fdw, Dd^Fdw, Gll^Fdf, Gll^Fdf, Gll^Fdf, Gg^Fdf, Gg, Gg^Efm, Gg^Efm, Gg^Fms, Cv, Gg^Fms, Gg^Fdf, Gg^Fdf, Wwt, Wwt, Gll^Fdf, Gg^Fdf, Gll^Fms, Gll^Fdf, Gg^Fms, Dd^Fdw, Dd^Fdw, Dd, Rrd^Fdw, Dd, Gd, Gs, Gd, Gd, Rb, Rb, Ce^Edt, Rb, Ce^Edt, Gd^Edt, Rb, Rrd
Dd^Fdw, Dd, Rrd, Rrd^Fdw, Wwf, Gg^Fdf, Gg^Fms, Rrd, Gs^Qhh, Dd^Qhh, Gg^Efm, Hh, Gll^Fms, Gll^Fds, Gg, Gg^Fms, Gll^Fdf, Gll^Fdf, Gs, Gg^Fdf, Gg, Gg^Efm, Gg^Fds, Cv, Kv, Cv, Gg^Fet, Gll^Fdf, Gll^Fdf, Gll^Fdf, Gll^Fms, Gll^Fdf, Gg^Fms, Gll^Fms, Rb, Dd, Rb, Rb, Gg, Gd, Gg, Dd, Rrd^Fdw, Dd, Dd, Gs, Gs^Edt, Re, 5 Ke, Ce, Re, Gs^Edt
Gg, Gll^Fdf, Gll^Fms, Gg^Fms, Gg^Fms, Wwf, Rrd, Dd^Fdf, Rrd^Fdw, Gg^Efm, Dd, Gg^Fms, Wwt, Gg, Wwt, Gg, Gs, Gs, Wwt, Gs, Wwt, Gs, Gg^Fms, Cv, Gg^Efm, Gg^Efm, Gg^Fms, Gg^Fms, Gll^Fms, Gll^Fdf, Gg^Fdf, Gg^Fdf, Rb, Gg, Gg^Fdf, Rrd^Fdw, Rb, Dd^Fdw, Dd^Fdw, Gg^Fdf, Gg^Fdf, Gs^Fmf, Gs^Fmf, Ds, Dd^Fdw, Re, Re, Ce^Edt, Ce, Ce, Rb, Re
Wwt, Gg, Gll^Fdf, Gll^Fms, Gs^Fdf, Wwf, Gg, Rrd, Dd, Dd, Gg^Fdf, Rrd^Fdw, Wwt, Wot, Wot, Wwt, Wot, Wwt, Wwt, Wwt, Wot, Wwt, Wwt, Gg^Efm, Gg^Efm, Gg^Fms, Gg^Fms, Gg^Fms, Gll^Fdf, Gll^Fdf, Gg^Fdf, Gg^Efm, Gg^Efm, Gg^Fms, Gg^Fdf, Gg, Gg^Fdf, Dd^Fdw, Gg^Fdf, Rrd^Fdw, Gg^Fdf, Rrd, Gg, Ds, Re, Re, Re^Vct, Gs, Re^Vct, Rb, Rb^Vct, Gs
Gs^Fdf, Wwt, Gg^Fdf, Gs^Fdf, Wwt, Wwt, Dd^Fdw, Dd, Rrd^Fdw, Gg, Gg^Fdf, Gg^Fdf, Gg^Fdf, Cv, Cv, Wot, Wot, Wwt, Gg^Fdf, Wot, Wot, Wot, Gg^Fms, Gg^Fms, Gg, Gg^Efm, Gg, Gg^Fdf, Gll^Fms, Gll^Fdf, Gg^Efm, Gg^Efm, Gg, Gll^Fdf, Gll^Fmf, Gg^Fdf, Gg^Fdf, Gll^Fdf, Gll^Fdf, Gll^Fdf, Gll^Fdf, Rrd^Fdw, Dd^Fdw, Gg, Gg^Fdf, Gs, Gs, Re, Re^Edt, Re^Ecf, Re, Rb
Gs^Fdf, Wwt, Wwt, Wwt, Wwf, Gg, Gg^Fdf, Gg^Fdf, Gg^Fdf, Gg^Fdf, Cv, Gg^Fdf, Gg^Fdf, 2 Kv, Gg^Ve, Wot, Wwt, Gg^Fdf, Cv, Gg^Fdf, Wot, Wwt, Wwt, Gg^Fmf, Gg^Ve, Gg^Fms, Gg^Fdf, Gg, Gg^Efm, Gg^Efm, Gll^Fmf, Gg, Gll^Fmf, Gll^Fdf, Gll^Fmf, Cv, Rb, Gll^Fdf, Gll^Fdf, Gll^Fms, Gg^Fdf, Dd^Fdw, Gg^Fdf, Gg, Gs^Fmf, Gs^Fmf, Gg, Re^Edt, Gs^Edt, Rb^Vct, Re, Gs
Gll^Fdf, Gs^Fms, Gll, Wwt, Gll^Fms, Gg^Fdf, Gll, Gll^Fdf, Gll^Fdf, Gg^Fdf, Gg^Fdf, Gg, Gg, Gg, Gg^Fdf, Wwt, Gg^Fet, Gg^Fdf, Gg^Fdf, Wwt, Wot, Wot, Wwt, Gg, Gg^Fdf, Gg^Fdf, Gg^Fdf, Gg, Gg, Gg, Gll^Fmf, Gll^Fmf, Gll^Fmf, Gll^Fmf, Gg^Fds, Gg, Gg^Fdf, Dd^Fdw, Gg^Fms, Gs^Fdf, Gs, Gll^Fdf, Gll^Fdf, Gg^Fdf, Gg, Gg^Edt, Gd, Gs, Gs, Gs, Rb^Vct, Rb^Vct
Gs^Fdf, Gll^Fdf, Gs^Fdf, Wwt, Gg, Gll^Fms, Gll^Fms, Gg, Gg^Fdf, Gg^Fdf, Gg^Fdf, Gg^Fdf, Gg^Ve, Gg, Gg^Fdf, Gg^Fdf, Gg^Fdf, Gg^Fms, Gg^Fdf, Wwt, Wwt, Wwt, Wwt, Gg^Efm, Gg^Fmf, Gg^Fdf, Gg^Efm, Gg, Gg^Fdf, Gg^Fdf, Gg^Fmf, Gll^Fmf, Gg^Fmf, Gll^Fmf, Cv, Cv, Gll^Fdf, Gg^Fdf, Cv, Gg^Fms, Gs^Fds, Gs^Fds, Gg^Fdf, Dd^Fdw, Gg, Gd, Rrd^Fdw, Dd, Gd, Rrd^Fdw, Dd^Fdw, Re^Vct
Gg, Gll^Fdf, Gs^Fdf, Wwt, Wwt, Gll, Gll^Fms, Gll, Gg^Fms, Gg^Fdf, Gg^Fms, Gg^Fdf, Gg, Gg, Cv, Gg^Fdf, Gg^Fdf, Gg^Fdf, Gg^Fdf, Gg^Fms, Gg^Fdf, Gg^Fms, Gg^Efm, Gg^Efm, Gg, Gg, Gg^Fmf, Gg^Efm, Gg, Gg^Fmf, Gg^Fdf, Gg^Ve, Gg^Fmf, Gg^Fmf, Gg, 3 Kv, Cv, Gll^Fdf, Gll^Fdf, Gg^Fdf, Gll^Fdf, Gll^Fms, Gg, Rrd^Fdw, Gs, Gs, Dd, Rrd^Fdw, Rrd^Fdw, Rrd^Fdw, Dd^Fdw, Rrd^Fdw
Gg, Gg^Fds, Gs^Fdf, Wwt, Wwf, Gg^Fms, Gg^Fds, Gll, Gg, Gll^Fms, Gll^Fms, Gll^Fdf, Gg^Fdf, Gg^Fdf, Gg^Fdf, Gg^Fdf, Gg, Gg^Ve, Gg^Fdf, Gg^Fdf, Gg, Gg^Fdf, Gll^Fdf, Gg, Gg^Fdf, Gg, Gg, Gll^Fmf, Gll^Fdf, Gg^Fet, Gll^Fdf, Gll^Fmf, Gs^Fdf, Gg^Fmf, Gg^Ve, Gg, Gg, Gll^Fms, Gll^Fdf, Gg^Fdf, Gg, Gg, Gg^Fms, Gs, Gg^Fms, Gs, Gs, Rrd^Fdw, Gs, Gs, Rrd^Fdw, Dd^Fdw
Gg^Fms, Gg, Re, Gg^Fms, Re, Wwf, Gg, Gg, Gg^Fdf, Gg, Gll, Gll^Fdf, Gg, Gg, Gg^Fms, Gg, Gg^Fdf, Gg, Gg^Efm, Gg, Gll^Fdf, Gll^Fdf, Gll^Fdf, Gll^Fdf, Gg^Efm, Gg^Efm, Dd^Fdw, Rrd, Gll^Fdf, Gll^Fdf, Gll^Fmf, Gg^Fmf, Gll^Fmf, Gg, Gg, Gg, Gg^Fdf, Gg^Fdf, Gll^Fdf, Gll^Fdf, Gg, Gg, Gg, Gg^Fms, Gg^Fms, Rrd^Fdw, Dd, Gs, Rrd^Fdw, Dd, Dd, Rrd^Fdw
Gg, Re, Gg^Fms, Gg, Gg^Fms, Wwt, Wwf, Gll^Fdf, Gll^Fmf, Gg, Gll^Fmf, Gll^Fdf, Gll^Fmf, Gg, Gg, Gg^Fdf, Gg, Gg^Efm, Gg^Efm, Gg^Efm, Gg^Efm, Gll^Fdf, Gll^Fdf, Gg^Fdf, Dd^Fdw, Gg, Gd, Gll^Fdf, Gll^Fdf, Gll^Fdf, Gg^Fmf, Gll^Fmf, Gll^Fmf, Gg^Fmf, Gg, Dd^Fdw, Dd^Fdw, Gg^Fdf, Gg, Dd, Dd^Fdw, Dd, Dd, Gs, Gs, Hh, Gs, Gd, Gs, Gs, Gs^Edt, Gs
Gg, Gg, Gg^Fms, Gll^Fms, Gg^Ve, Wwt, Gll^Fdf, Gll^Fdf, Gll^Fmf, Gll^Fdf, Gll^Fmf, Gg^Fmf, Gg^Efm, Gg^Efm, Gg^Fds, Gg, Gll^Fmf, Gg, Gll^Fdf, Gg, Gg, Gg^Fdf, Gll^Fdf, Gll^Fdf, Gg^Fdf, Gs, Dd^Fdw, Gs, Gd, Gs, Gd, Gll^Fmf, Gs, Gg^Fmf, Dd, Gg^Fds, Dd^Fdw, Gg, Gg^Fds, Dd, Rrd^Qhu, Ce^Edt, Hh^Qhu, Rrd^Fdw, Hh, Gs, Dd, Rrd, Hh^Qhh, Dd^Fdw, Dd, Dd
Gg^Fms, Gg^Fms, Gg^Qhhf, Gll^Qhhf, Gll^Qhhf, Wwt, Wwt, Gll^Fdf, Gll^Fmf, Gg^Fmf, Gll^Fmf, Gll^Fdf, Gg^Fdf, Gg^Efm, Gll^Fmf, Gll^Fmf, Gll^Fmf, Gll^Fdf, Gll^Fdf, Gll^Fdf, Gll^Fdf, Gg^Fms, Gg^Fms, Gg^Fdf, Gs, Gs, Dd, Dd^Fdw, Gs, Gs, Rrd, Gs, Dd, Gs, Gg^Fds, Gg, Rrd^Qhu, Rrd, Gs^Qhu, Gs^Qhu, Dd^Fdw, Gs^Qhu, Hh, Hh^Qhu, Hh^Qhh, Hh^Qhh, Hh^Qhh, Hh^Qhh, Hh^Qhh, Hh^Efm, Gg, Dd
Gg, Gll^Qhh, Gll^Fdf, Gll^Fmf, Gll^Fmf, Gll^Qhhf, Gll^Qhhf, Wwt, Wwt, Gll^Fmf, Gll^Fdf, Gll^Fdf, Gg, Gg^Fmf, Gg^Fmf, Gll^Fdf, Gg^Fmf, Gll^Fdf, Gg^Fdf, Gll^Fdf, Gg^Fdf, Gg^Fms, Gll^Fdf, Gs, Gs, Rb^Vct, Dd, Rrd, Rrd^Qhuf, Gs^Qhu, Gd^Qhu, Gd, Dd, Dd, Dd^Qhu, Dd^Qhu, Rrd^Fdw, Rrd^Qhu, Dd, Dd, Rrd, Hh, Rrd, Hh, Rb^Vct, Hh^Qhh, Hh^Efm, Hh^Qhh, Hh, Gg, Gg, Gg
Gg^Qhh, Gg^Qhhf, Gg^Fmf, Gll^Fmf, Gg^Fmf, Gll^Fmf, Gll^Fdf, Gll^Qhhf, Wwt, Gg^Fmf, Gg^Fdf, Gll^Fdf, Gg^Fdf, Gg, Gll^Fmf, Gg^Ve, Gg, Gll^Fdf, Gg^Fdf, Gll^Fdf, Gg^Efm, Gll^Fdf, Gg^Fdf, Rb^Vct, Gs^Qhu, Gs^Qhu, Dd^Qhu, Dd^Qhuf, Rrd^Fdw, Gd, Gs, Gd^Qhu, Gd^Qhu, Gs^Qhu, Gs, Dd, Dd, Dd, Gd, Dd, Dd^Fdw, Dd, Dd, Re^Vct, Re, Hh, Gd, Hh, Wwt, Wwt, Wwt, Wwt
Hh^Qhh, Gg, Gg, Gll, Gll^Fmf, Gll, Gg^Qhhf, Gll^Qhhf, Gg^Efm, Wwt, Wwt, Gg, Gll, Gll^Fmf, Gll^Fmf, Gll^Fmf, Gll^Fmf, Gll^Fdf, Dd, Gg^Fdf, Gg^Fdf, Dd, Gs^Qhu, Gs^Qhu, Gs, Rb^Vct, Rb, Gd, Ce^Edt, Gs, Ce, Gd, Gg, Rrd^Fdw, Dd, Gg^Fdf, Gg^Fmf, Re^Vct, Re^Fds, Dd, Rrd, Ce^Edt, 6 Ke, Ce, Wwt, Rb^Vct, Wwt, Wwt, Wwt, Wwt, Wwt, Wwt
Hh, Gll^Fmf, Gll^Fmf, Gll^Fmf, Gll^Qhhf, Gg^Qhh, Gg^_mh, Gg^Qhhf, Gll^Qhhf, Wwt, Gg, Gll^Fds, Gll^Fmf, Gll^Fmf, Gll^Fmf, Gll^Fmf, Gll^Fmf, Gg^Efm, Dd^Fdw, Rrd, Dd^Qhu, Gs^Qhu, Rb^Vct, Rb, Gd^Ecf, Gd, Rb, Ce, 7 Ke, Gs, Ce^Edt, Ce, Rrd, Dd, Wwt, Gg^Fmf, Wwt, Gg^Fmf, Gs^Edt, Gs^Edt, Gs^Edt, Ce^Edt, Wwt, Wwt, Wwt, Wwt, Wot, Wot, Wot, Wot, Wot, Wot
Gg, Gll^Fms, Hh^Qhhf, Gll^Fmf, Gll^Fmf, Gg^Fmf, Gg^Fmf, Gll^Fmf, Gg^Qhhf, Wwt, Wwt, Gg^Fmf, Gg^Fds, Gll^Fmf, Gg^Fds, Gg^Fmf, Gg, Gg^Fds, Gg^Fds, Dd^Qhu, Dd^_ml, Rb^Vct, Gs, Rb, Rb, Rb^Vct, Rb^Edt, Ce^Edt, Gs, Rb, Wwt, Gs, Wwt, Wwt, Wot, Wwt, Wwt, Wwt, Wwt, Gg^Fds, Wwt, Wwt, Wwt, Wwt, Wwt, Wwt, Wot, Wot, Wot, Wot, Wot, Wot
Gg, Hh, Hh^Qhhf, Gg^Qhhf, Gg^Qhhf, Gll^Qhhf, Gg^Qhh, Gg^Qhhf, Gg^Qhh, Wwt, Wwt, Gg^Fds, Gg^Fds, Gg^Fds, Gg^Fds, Gg, Gg, Rrd, Gs, Dd^Qhu, Dd^Qhu, Dd, Rb^Qhu, Rb, Gs, Gd, Wwt, Wwt, Wwt, Wwt, Wwt, Wwt, Wwt, Wot, Wot, Wot, Wot, Wwt, Wwt, Wwt, Wwt, Wwt, Wot, Wot, Wot, Wot, Wot, Wot, Wot, Wot, Wot, Wot
