Rrd^Fdw, Rrd, Dd, Dd^Fds, Gs^Fds, Gs^Fds, Gg, Gg^Qhh, Ce^Qhh, Gs^Qhh, Gs, Rb^Qhh, Rb^Qhh, Gg, Gg, Gg, Gg, Dd, Gg^Qhhf, Gs^Fds, Gg^Qhhf, Gg^Qhhf, Dd, Dd, Dd, Rrd^Fdw, Dd, Dd, Dd, Rrd, Rrd, Gg, Dd, Gg, Gg, Dd^Fds, Dd, Dd^Fds, Dd^Fdw, Gg, Rb, Gg, Gg^Efm, Re, Rrd^Fdw, Gs, Gg^Fms, Gg^Fms, Rrd^Fms, Rrd^Fds, Dd, Rb
Rrd^Fdw, Rrd^Fdw, Dd, Dd, Gs, Gs, Ce, 8 Ke, Ce^Edt, Ce, Rb^Edt, Re^Vct, Re^Vct, Rb, Re^Vct, Re^Vct, Gg^Qhh, Hh^Qhh, Hh, Gg^Qhhf, Gg^Fms, Gg^Fms, Rrd^Fdw, Dd^Fdw, Gs, Gs, Gg^Fds, Dd^Fdw, Gg^Fds, Dd^Fdw, Rrd^Fdw, Rrd^Fdw, Dd, Gg^Fds, Gg^Fds, Dd^Fds, Dd^Fdw, Dd^Fds, Dd, Gg^Fms, Dd^Fds, Rb, Gg, Rrd, Dd, Rrd^Fms, Dd, Gg^Fms, Gg^Fds, Dd, Rrd^Fdw, Rrd
Gg, Rrd, Gs, Ce^Edt, Gs, Gg, Gg, Rb, Re, Re, Dd^Edt, Re^Vct, Gg, Dd, Gg, Gg^Qhh, Dd, Hh, Dd, Gg^Fms, Gg^Fms, Gg^Fms, Gs^Fms, Gg^Fds, Gg^Fds, Gg, Gg^Fds, Gg, Gg^Fds, Gg^Fds, Gg, Gg^Fds, Gg^Fds, Gg, Gg^Fds, Gg^Fds, Rrd^Fdw, Rrd^Fdw, Gg^Fms, Dd^Fds, Gg^Fds, Rb, Rrd^Fdw, Ds, Ds, Dd, Rrd, Rrd, Gs, Dd, Dd, Rb
Gs, Gs^Fds, Dd, Gs, Rrd^Fdw, Dd, Dd, Ce^Edt, Gs^Qhh, Dd^Qhh, Dd^Qhh, Gg^Qhh, Gg, Gg, Gs^Qhh, Gg^Qhh, Dd, Dd, Rrd^Fdw, Dd^Fdw, Gg^Fds, Gg^Fms, Gs^Fds, Gs^Fms, Gg^Fds, Gg^Ve, Gg^Fds, Gg^Fds, Gg^Fds, Gg, Gg, Gg^Fds, Rrd^Fdw, Gg, Dd, Gg^Fms, Dd^Fds, Dd, Gg^Fms, Dd^Fds, Rb, Gg, Gg, Rrd, Gg, Dd, Rrd^Fdw, Rrd^Fdw, Rrd, Gs, Gs, Rb
Wwt, Gs^Fds, Dd^Fds, Rrd, Rrd, Dd, Rrd^Fdw, Dd, Dd^Qhh, Rrd^Fdw, Gs, Rrd^Fdw, Hh^Qhh, Hh^Qhh, Hh, Gg^Fms, Gg^Fds, Gg^Fms, Dd^Fdw, Gg^Fds, Gg^Fms, Gs^Fds, Gg^Fms, Gg^Fds, Gg^Fds, Gg^Fds, Gg^Fds, Cv, Gg^Fms, Gg^Fds, Gg^Fms, Gg, Dd^Fdw, Dd, Dd, Rrd^Fdw, Rrd^Fdw, Rrd^Fdw, Gg^Fms, Rb, Ds, Gg, Gg, Ce^Edt, 4 Ke, Gg, Dd, Ds, Dd, Rrd^Fdw, Dd, Dd
Gs, Wwt, Wwt, Rrd^Fdw, Rrd, Rrd^Fdw, Dd, Rrd, Rrd^Qhh, Gs^_mh, Rrd^Qhh, Rrd^Qhh, Hh, Gg, Rrd, Dd^Fms, Gg^Fds, Gg^Fms, Gg^Fms, Gg^Fms, Gg^Fms, Gg^Fms, Gg^Fds, Gg^Fds, Cv, Cv, Gg^Fds, Gg^Fds, Gg^Fds, Gg^Fds, Gg^Fms, Cv, Gg^Fds, Dd^Fdw, Dd, Dd, Rrd^Fdw, Dd^Fds, Rb, Rb, Rb, Rb^Edt, Ce, Gg, Ce, Ce, Gg^Edt, Re, Gg, Dd, Rrd^Fdw, Gs
Gs, Gs, Dd^Fdw, Wwt, Wwf, Rrd, Dd^Fms, Rrd, Rrd^Fdw, Dd^Qhh, Gs^Qhh, Hh, Gg, Dd, Rrd^Fdw, Dd^Fdw, Gg^Fds, Gg^Fds, Gg^Fds, Gg^Fds, Gg^Fds, Gg^Fds, Gg^Fds, Gg^Fms, Cv, Kv, Gg, Gg, Gg^Fds, Gg^Ve, Gg^Fms, Gg^Fds, Rrd, Dd, Dd, Dd^Fdw, Dd^Fdw, Dd, Rrd^Fdw, Dd, Gg, Gg, Gg, Gg, Rb, Rb, Ce^Edt, Rb, Ce^Edt, Gg^Edt, Rb, Rrd
Dd^Fdw, Dd, Rrd, Rrd^Fdw, Wwf, Gg^Fds, Gg^Fms, Rrd, Gs^Qhh, Dd^Qhh, Gg^Efm, Hh, Gg^Fms, Dd^Fds, Gg^Fms, Gg^Fms, Gg^Fds, Gg^Fds, Gg^Fms, Gg^Fds, Gg^Fms, Gg^Fds, Gg^Fds, Gg^Fms, Gg^Fds, Gg^Fds, Gg^Fds, Gg^Fds, Gg, Gg, Gg^Fms, Gg^Fds, Gg, Dd^Fdw, Rb, Dd, Rb, Rb, Gg, Gg, Gg, Dd, Rrd^Fdw, Dd, Dd, Gg, Gg^Edt, Re, 5 Ke, Ce, Re, Gg^Edt
Gg, Gs^Fds, Gg^Fms, Gg^Fms, Gg^Fms, Wwf, Rrd, Dd^Fds, Rrd^Fdw, Gg^Efm, Dd, Gg^Fms, Wwt, Gg^Fms, Wwt, Gg^Fms, Gg, Gg, Wwt, Gg^Fms, Wwt, Gg^Fds, Gg^Fms, Gg^Fms, Gg^Fds, Gg^Fds, Gg^Fms, Gg^Fms, Gg, Gg^Fds, Gg^Fds, Gg^Fds, Rb, Gg, Gg, Cv, Rb, Dd^Fdw, Dd^Fdw, Gg^Fds, Gg^Fds, Gs^Fms, Gs^Fms, Ds, Dd^Fdw, Re, Re, Ce^Edt, Ce, Ce, Rb, Re
Wwt, Gg, Gg^Fds, Gg^Fms, Gs^Fds, Wwf, Gg, Rrd, Dd, Dd, Gg^Fds, Rrd^Fdw, Wwt, Wot, Wot, Wwt, Wot, Wwt, Wwt, Wwt, Wot, Wwt, Wwt, Gg, Gg^Fds, Gg^Fds, Gg^Fds, Gg, Gg^Fds, Gg, Gg^Efm, Gg^Efm, Gg, Gg^Fms, Gg^Fds, Gg, Gg^Fds, Dd^Fdw, Gg^Fds, Rrd^Fdw, Gg^Fds, Rrd, Gg, Ds, Re, Re, Gg, Gg, Re^Vct, Rb, Rb^Vct, Gg
Gs^Fds, Wwt, Gg^Fds, Gs^Fds, Wwt, Wwt, Dd^Fdw, Dd, Rrd^Fdw, Gg, Gg^Fds, Gg^Fds, Gg^Fds, Cv, Cv, Wot, Wot, Wwt, Gg^Fds, Wot, Wot, Wot, Gg^Fms, Gg^Fms, Gg^Fms, Gg^Fms, Gg^Fds, Gg^Fds, Gg^Fms, Gg, Gg^Efm, Gg^Efm, Gg^Fds, Gg^Fds, Cv, Cv, Gg^Fds, Gg^Fds, Cv, Gg^Fds, Gg^Fds, Rrd^Fdw, Dd^Fdw, Gg, Gg^Fds, Re^Vct, Re^Vct, Gg, Rb^Vct, Re^Vct, Re, Rb
Gs^Fds, Wwt, Wwt, Wwt, Wwf, Gg, Gg^Fds, Gg^Fds, Gg^Fds, Gg^Fds, Cv, Gg^Fds, Gg^Fds, 2 Kv, Gg^Ve, Wot, Wwt, Gg^Fds, Cv, Gg^Fds, Wot, Wwt, Gg^Fds, Gg^Ve, Gg^Fds, Gg^Fms, Gg^Fds, Gg, Gg^Efm, Gg^Efm, Gg^Fms, Gg, Gg^Fms, Gg^Fms, Gg, 3 Kv, Cv, Gg^Fds, Gg^Fds, Gs^Fms, Gg^Fds, Dd^Fdw, Gg^Fds, Gg, Gs^Fms, Gs^Fms, Re^Vct, Re^Edt, Gg^Edt, Rb^Vct, Re, Gg
Gs^Fds, Gs^Fms, Gg, Wwt, Gg^Fms, Gg^Fds, Gg, Gg^Fds, Gg^Fds, Gg^Fds, Gg^Fds, Gg, Gg, Gg, Gg^Fds, Wwt, Gg^Fds, Gg^Fds, Gg^Fds, Wwt, Wwt, Wwt, Gg^Fds, Gg^Fds, Gg^Fds, Gg^Fds, Gg^Fds, Gg, Gg, Gg, Gg^Fms, Gg^Ve, Gg^Fms, Gg^Fms, Gg^Ve, Gg, Gg^Fds, Gg^Fms, Gs^Fms, Gs^Fds, Gs, Gg^Fds, Gg^Fds, Gg^Fds, Gg, Gg^Edt, Gg, Gg, Gg, Gs, Rb^Vct, Rb^Vct
Gs^Fds, Gs^Fds, Gs^Fds, Wwt, Gg, Gg^Fms, Gg^Fms, Gg, Gg^Fds, Gg^Fds, Gg^Fds, Gg^Fds, Gg^Ve, Gg, Gg^Fds, Gg^Fds, Gg^Fds, Gg^Fms, Gg^Fds, Wwt, Gg^Fds, Gg^Fds, Gg^Fms, Gg^Fms, Gg^Fms, Gg, Gg, Gg, Gg^Fds, Gg^Fds, Gg^Fms, Gg^Fms, Gs^Fds, Gg^Fms, Gg, Gs^Fds, Gs^Fds, Gg^Qhuf, Gs^Fds, Gs, Gs^Fds, Gs^Fds, Gg^Fds, Dd^Fdw, Gg, Gg, Rrd^Fdw, Dd, Gg, Gg, Gs^Edt, Re^Vct
Gg, Gs^Fds, Gs^Fds, Wwt, Wwt, Gg, Gg^Fms, Gg, Gg^Fms, Gg^Fds, Gg^Fms, Gg^Fds, Gg, Gg, Cv, Gg^Fds, Gg^Fds, Gg^Fds, Gg^Fds, Gg^Fms, Gg^Fds, Gg^Fms, Gg, Gg^Fms, Gg, Gg, Gg^Fms, Gg, Gg, Gg^Fms, Gg^Fds, Gs^Fds, Gs^Fds, Gs^Fds, Gs^Fds, Gs^Fds, Dd^Fdw, Gs^Fds, Gg^Fds, Gg^Fds, Gg^Fds, Gg^Fms, Hh, Rrd^Fdw, Hh, Gg, Dd, Rrd, Hh^Qhh, Gg, Gg, Gs
Gs^Fds, Gg^Fds, Gs^Fds, Wwt, Wwf, Gg^Fms, Gg^Fds, Gg^Ve, Gg, Gg^Fms, Gg^Fms, Gg^Fds, Gg^Fds, Gg^Fds, Gg^Fds, Gg^Fds, Gg, Gg, Gg^Fds, Gg^Fds, Gg, Gg^Fds, Gg^Fds, Gg, Gg^Fds, Gg, Gg, Gg^Fms, Dd^Fdw, Dd^Fdw, Rrd^Fdw, Gg^Fds, Gg^Fms, Gs^Fms, Gg^Fds, Gg, Rrd, Rrd, Gs, Dd^Fdw, Dd^Fdw, Gg^Fms, Hh, Hh, Hh^Qhh, Hh^Qhh, Hh^Qhh, Hh^Qhh, Hh^Qhh, Hh^Efm, Gg, Gg
Gg^Fms, Gs^Fds, Gg, Gg^Fms, Gg, Wwf, Gg, Gg, Gg^Fds, Gg, Gg, Gg^Fds, Gg, Gg, Gg^Fms, Gg^Ve, Gg^Fds, Gg, Gg^Efm, Gg, Gg^Fds, Gg^Fds, Dd^Fdw, Gg^Fds, Gg, Gg, Dd, Rrd, Gg, Rrd, Dd^Qhu, Dd^Qhu, Gs, Gg, Gg, Dd, Rrd^Fdw, Rrd, Dd, Dd, Rrd, Hh, Rrd, Hh, Rb^Vct, Hh^Qhh, Hh^Efm, Hh^Qhh, Hh, Gg, Gg, Gg
Gg^Fms, Gg, Gg^Fms, Gg, Gg^Fms, Wwt, Wwf, Gg^Fds, Gg^Fms, Gg, Gg^Fms, Gg^Fds, Gg^Fms, Gg, Gg, Gg^Fds, Gg, Gg^Efm, Gg^Efm, Gg^Efm, Gg^Efm, Gg, Rrd^Fdw, Rrd^Fdw, Dd, Gg, Dd, Rrd, Gg^Qhu, Gs^Qhu, Gs, Dd, Gs, Dd, Gg, Dd, Dd, Dd, Gg, Dd, Dd^Fdw, Dd, Dd, Re^Vct, Re, Hh, Gg, Hh, Wwt, Wwt, Wwt, Wwt
Gg, Gg, Gg^Fms, Gg^Fms, Gg^Ve, Wwt, Gg^Fds, Gg^Fds, Gg^Fms, Gg^Fds, Gg^Fms, Gg^Fms, Gg, Gg, Gg^Fds, Gg, Gg^Fms, Gg, Gg^Fds, Gg, Gg, Dd, Dd, Gg, Gs^Qhu, Gs^Qhu, Gs^Qhu, Gs^Qhu, Ce^Edt, Gs, Ce, Gs, Gg, Rrd^Fdw, Dd, Gg^Fds, Gg^Fms, Gg, Gg^Fds, Dd, Rrd, Ce^Edt, 6 Ke, Ce, Wwt, Rb^Vct, Wwt, Wwt, Wwt, Wwt, Wwt, Wwt
Gg^Fms, Gg^Fms, Gg^Fms, Gg^Fms, Gg^Fds, Wwt, Wwt, Gg^Fds, Gg^Fms, Gg^Fms, Gg^Fms, Gg^Fds, Gg^Fds, Gg, Gg^Fms, Gg^Fms, Gg^Fms, Gg^Fds, Gg^Fds, Dd, Rrd, Gg, Gs^Qhu, Gs^Qhu, Gs, Gs^Vct, Rb, Ce, 7 Ke, Gs, Ce^Edt, Ce, Rrd, Dd, Wwt, Gg^Fms, Wwt, Gg^Fms, Gg^Edt, Gg^Edt, Gg^Edt, Ce^Edt, Wwt, Wwt, Wwt, Wwt, Wot, Wot, Wot, Wot, Wot, Wot
Gg, Gg^Fms, Gg^Fds, Gg^Fms, Gg^Fms, Gg^Fds, Gg^Fds, Wwt, Wwt, Gg^Fms, Gg^Fds, Gg^Fds, Gg, Gg^Fms, Gg^Fms, Gg^Fds, Gg^Fms, Gg^Fds, Gg^Fds, Dd^Fdw, Gs^Qhu, Gg^Qhu, Gg^Vct, Gg^Efm, Re^Vct, Rb^Vct, Rb^Edt, Ce^Edt, Gs, Rb, Wwt, Gs, Wwt, Wwt, Wot, Wwt, Wwt, Wwt, Wwt, Gg^Fds, Wwt, Wwt, Wwt, Wwt, Wwt, Wwt, Wot, Wot, Wot, Wot, Wot, Wot
Gg, Gg^Fms, Gg^Fms, Gg^Fms, Gg^Fds, Gg^Fms, Gg^Fds, Gg^Fds, Wwt, Gg^Fms, Gg^Fds, Gg^Fds, Gg^Fds, Gg, Gg, Gg, Gg, Rrd, Gs^Qhu, Gs^Qhu, Gg^Efm, Gg^_ml, Rb, Rb, Gs, Gs, Wwt, Wwt, Wwt, Wwt, Wwt, Wwt, Wwt, Wot, Wot, Wot, Wot, Wwt, Wwt, Wwt, Wwt, Wwt, Wot, Wot, Wot, Wot, Wot, Wot, Wot, Wot, Wot, Wot
