Gg^Fds, Dd, Gg^Fds, Dd^Fds, Gs^Fds, Gg^Fms, Gg^Fms, Gs^Fds, Gs^Fds, Gll^Fds, Gg^Fds, Gll^Fds, Gg^Fms, Gg, Re, Gg^Fms, Gg^Fms, Rrd, Dd^Fdw, Rrd, Dd^Fdw, Rrd, Rrd, Gs^Fds, Gs^Fds, Gg^Fms, Gg^Fds, Gg, Gg^Fds, Rrd, Rrd, Dd, Dd, Dd, Gg^Fms, Gg, Gd, Ce, Ke, Ce, Rb, Gg^Efm, Gg^Fds, Gg^Fds, Gg, Gg, Gg^Fds, Gg^Fds, Rb, Rb, Gg^Fms, Rb, Gg^Fms, Gg^Fms, Gg^Fds, Gg^Fds, Gg^Fds, Rb
Gg^Fds, Gg^Fds, Gg^Fds, Gs, Gg^Fms, Gs^Fds, Gs^Fds, Gg^Fms, Gg^Fms, Gg^Fms, Re^Vct, Gg^Fms, Gd, Gd, Gg^Fms, Gs, Gs^Fms, Gg^Fds, Dd, Dd, Gg^Fds, Gs^Fds, Gg^Fms, Gg^Fms, Gs^Fds, Dd, Rrd, Gg^Fds, Gg^Fds, Rrd, Dd, Gg^Fds, Gg^Fms, Gg^Fms, Gg^Fms, Ce^Edt, Gs^Edt, Ce, Ce, Rrd^Fdw, Re^Vct, Gg^Fds, Gg^Fds, Gg^Fds, Gg^Fds, Gg^Fds, Gg^Fds, Gg^Fds, Rb, Rb, Gg^Fms, Gg^Fms, Gg^Fds, Gg, Gg^Fds, Gg^Fms, Gg^Fms, Gg^Fds
Gg^Fds, Gg^Fds, Gg^Fms, Gg^Fms, Gg^Fms, Gs^Fds, Gg^Fds, Gll^Fds, Ce, Gll^Fds, Gg^Fds, Re, Gg^Fms, Gg^Fms, Gg^Fms, Gg^Fms, Gs, Gg^Fds, Hh, Gg^Fds, Gll^Fds, Gg^Fms, Dd, Gs^Fds, Gg^Fds, Rrd^Fdw, Gg^Fms, Gg^Fds, Gg^Fds, Gg^Fds, Dd, Dd, Gg^Fms, Gg^Fms, Gg^Fms, Gs, Gs^Edt, Gs, Gs, Gs, Rb, Gg, Gg^Fds, Gg^Fds, Gg^Fds, Gg^Fds, Gg^Fds, Gg^Fds, Gg^Fms, Gg^Fms, Gg^Fds, Gg^Fms, Gg^Fms, Gg^Fds, Gg^Fds, Gg^Fds, Gg^Fds, Gg^Fds
Gg^Fds, Gg^Fds, Gg^Fds, Gg^Fms, Gg^Fds, Gg^Fds, Ce, 6 Ke, Ce^Edt, Ce, Rb^Edt, Re, Re^Vct, Rb, Gg^Fms, Re^Vct, Gg^Fms, Hh, Gll^Fds, Gll^Fds, Gg^Fms, Gg^Fms, Rrd^Fdw, Dd^Fdw, Gg^Fds, Gg^Fds, Gg^Fds, Dd^Fdw, Gg^Fds, Gg^Fds, Gg^Fds, Rrd, Dd, Gg^Fms, Gg, Gg, Dd, Rrd, Dd, Gg^Fds, Gg^Fds, Gg, Gg^Fds, Gg^Fds, Gg, Gg^Fds, Gg^Fds, Rb, Gg, Gg^Fms, Gg^Fms, Gg^Fms, Gg^Fms, Gg^Fms, Gg^Fds, Gg^Fds, Re, Re
Gg, Gg^Fds, Gs, Ce^Edt, Gg^Fms, Gg^Fds, Gd, Rb, Re, Re, Gg^Fds, Re^Vct, Gg^Fds, Gg^Fds, Gg^Fms, Gg^Fms, Dd, Hh, Dd, Gg^Fms, Gg^Fms, Gg^Fms, Gg^Fms, Gg^Fds, Gg^Fds, Gg^Fms, Gg^Fds, Cv^Dr, Gg^Fds, Gg^Fds, Gg^Fds, Rrd^Fdw, Rrd^Fdw, Gg, Gg, Gg^Fds, Rrd^Fdw, Rrd^Fdw, Rrd, Gg^Fds, Gg^Fds, Gg, Gg, Gg^Fds, Gg^Fds, Gg^Fds, Gg^Fds, Rb, Gg^Fms, Re^Vct, Gg^Fms, Gg^Fms, Gg^Fms, Gg^Fms, Gg, 2 Re, Re, Re
Gs, Gs^Fds, Dd, Gs, Gg^Fms, Gg^Fms, Dd, Ce^Edt, Gg^Fds, Re, Re, Gg^Fms, Gll^Fds, Gg^Fds, Gg^Fms, Gg^Fms, Dd, Dd, Rrd^Fdw, Dd^Fdw, Gg^Fds, Gg^Fms, Gg^Fds, Gg^Fms, Gg^Fds, Gg^Fms, Gg^Fds, Gg^Fds, Gg^Fds, Gll, Gg^Fds, Gg^Fds, Rrd, Gg, Dd, Gg^Fms, Gg^Fms, Dd, Rrd, Rrd, Gg^Fds, Gg^Fds, Gg^Fds, Gg^Fds, Gg^Fds, Gg^Fds, Rb, Gg, Rb, Gg^Fms, Re^Vct, Gg^Fms, Gg^Fms, Gg^Fms, Re, 3 Rb, Gg^Fms, Gg^Fms
Wwt, Gs^Fds, Dd^Fds, Rrd, Gg^Fds, Gg^Fms, Rrd^Fdw, Dd, Gg^Fds, Gg, Re, Rrd^Fdw, Rrd, Dd, Rrd, Rrd, Gg^Fds, Gg^Fms, Dd^Fdw, Gg^Fds, Gg^Fms, Gg^Fds, Gg^Fms, Gg^Fds, Gg^Fms, Cv, Gg^Fds, Gg^Fds, Gll^Fms, Gg^Fds, Gg^Fms, Cv, Gg^Fds, Gg^Fds, Dd, Rrd^Fdw, Rrd^Fdw, Rrd^Fdw, Rrd, Gg^Fds, Gg^Fds, Gg^Fds, Gg^Fds, Gg^Fds, Gg^Fds, Rb, Ds, Gs, Re^Vct, Ce^Edt, Ke, Re^Ecf, Gg^Fds, Ds, Re, Rb, Gg^Fds, Gg^Fms
Gs, Wwt, Wwt, Rrd^Fdw, Gs, Rrd^Fdw, Dd, Gg^Fds, Rrd, Gg^Fds, Gg, Gs, Gg^Fds, Rrd, Rrd, Dd^Fms, Gg^Fds, Gg, Gg^Fds, Gg^Fds, Gg^Fds, Gg^Fms, Gg^Fds, Gg^Fds, Gg, Gg^Fms, Gg^Fds, Gg, Wwt, Gg^Ve, Gg^Fet, Gg^Fds, Gg^Fds, Gg^Fds, Gg^Fds, Gg^Fms, Rrd^Fdw, Dd^Fds, Rb, Gg^Fds, Gg^Fds, Gg, Rb, Gg^Fds, Rb, Rb, Gg^Fds, Rb^Edt, Ce, Gd, Ce, Ce, Gg^Fds, Gg^Fds, Gs, Gg^Fds, Gg^Fds, Gg^Fds
Gs, Gs, Dd^Fdw, Wwt, Wwf, Rrd, Dd^Fms, Rrd, Rrd^Fdw, Rrd, Gg^Fds, Gg, Gg^Fds, Rrd, Rrd^Fdw, Dd^Fdw, Gg^Fds, Gg^Fds, Gg^Efm, Gg^Fds, Gg, Gg^Efm, Gg^Efm, Gg^Fms, Cv, Gg^Fms, Gg^Fds, Gg^Fds, Wwt, Wwt, Gg^Fds, Gg^Fds, Gll^Fms, Gg^Fds, Gg^Fms, Dd^Fdw, Dd^Fdw, Dd, Gg, Gg^Fds, Rb, Rb, Gg^Fds, Rb, Gg^Fds, Rrd, Rrd, Gg^Fds, Rrd, Gd, Rb, Rb, Ce^Edt, Rb, Ce^Edt, Gd^Edt, Rb, Gg^Fds
Dd^Fdw, Dd, Rrd, Rrd^Fdw, Wwf, Gg^Fds, Gg^Fms, Rrd, Gll^Fds, Gll^Fds, Gg^Fds, Gg^Fds, Gll^Fms, Gll^Fds, Gg^Efm, Gg^Fms, Gg^Efm, Gg^Fds, Gg^Fds, Gg^Efm, Gg^Fms, Gg^Efm, Gg^Fds, Cv, Kv, Cv, Gg^Fet, Gg^Fds, Gg^Fds, Gg^Fds, Gll^Fms, Gg^Fds, Gg^Fms, Gll^Fms, Rb, Dd, Rb, Rb, Gg, Gg, Rrd, Gg^Fds, Gg^Fds, Gg^Fds, Gg^Fds, Gg^Fds, Gg^Fds, Dd, Rrd^Fdw, Gg^Fds, Gg^Fds, Gg^Fds, Gg^Fds, Re, Ke, Ce, Re, Gg^Fds
Gg, Gg^Fds, Gll^Fms, Gg^Fms, Gg^Fms, Wwf, Rrd, Gg^Fds, Rrd^Fdw, Gg^Efm, Dd, Gg^Fms, Wwt, Gg, Wwt, Gg^Efm, Gg^Fds, Gg^Efm, Wwt, Gg^Efm, Wwt, Gs, Gg^Fms, Cv, Gg^Efm, Gg^Efm, Gg^Fms, Gg^Fms, Gll^Fms, Gg^Fds, Gg^Fds, Gg^Fds, Gg^Fms, Gg^Fds, Gg^Efm, Gg, Gg^Fms, Gg^Fms, Gg^Fds, Gg^Fds, Gg^Fds, Gg, Gg^Fds, Gg^Fds, Gg^Fds, Gg^Fds, Gg^Fds, Rrd, Gg^Fds, Gg^Fds, Dd^Fdw, Gg^Fds, Gg^Fds, Ce^Edt, Ce, Ce, Rb, Re
Wwt, Gg, Gg^Fds, Gll^Fms, Gg^Fds, Wwf, Gs^Fds, Gs^Fds, Gs^Fds, Dd, Gg^Fds, Rrd^Fdw, Wwt, Wot, Wot, Wwt, Wwt, Wwt, Wot, Wwt, Wot, Wwt, Wwt, Gg^Efm, Gg^Efm, Gg^Fms, Gg^Fms, Gg^Fms, Gg^Fds, Gg^Fds, Gg^Fds, Gg^Fds, Gg^Fds, Gg^Efm, Gg^Efm, Gg^Efm, Gg^Fds, Gs^Fds, Gg^Fms, Gg^Fds, Gg^Fds, Gd, Dd, Rrd^Fdw, Dd, Rrd, Gg, Gg^Fds, Gg^Fds, Gg^Fds, Gg^Fds, Gs, Re^Vct, Gg^Fds, Re^Vct, Rb, Rb^Vct, Rb^Vct
Gg^Fds, Wwt, Gg^Fds, Gg^Fds, Wwt, Wwt, Dd^Fdw, Gs^Fds, Rrd^Fdw, Gg, Gg^Fds, Gg^Fds, Gg^Fds, Cv, Cv, Wot, Wot, Wwt, Gg^Fds, Wot, Wot, Wot, Gg^Fms, Gg^Fms, Gg^Fds, Gg^Efm, Gg, Gg^Fds, Gll^Fms, Gg^Fds, Gg^Fds, Gg^Fds, Gg^Fds, Gg^Efm, Gg^Fms, Gg^Fds, Gg^Fds, Gg^Fds, Gg^Fds, Gg^Fds, Gg^Fds, Rrd^Fdw, Dd, Dd, Gg^Fds, Gg^Fds, Gg^Fds, Gg, Gg, Gg^Fds, Gg^Fds, Gg^Fms, Gg^Fms, Re, Re^Edt, Re^Ecf, Gg^Fds, Rb^Vct
Gg^Fds, Wwt, Wwt, Wwt, Wwf, Gg, Gg^Fds, Gg^Fds, Gg^Fds, Gg^Fds, Cv, Gg^Fds, Gg^Fds, 7 Kv, Gg^Ve, Wot, Wwt, Gg^Fds, Cv, Gg^Fds, Wot, Wwt, Wwt, Gg^Fms, Gg^Ve, Gg^Fms, Gg^Fds, Gg, Gg^Fds, Gg^Fds, Gg^Fds, Gg^Fds, Gg, Gg^Fds, Gg^Fms, Cv, Rb, Gg^Fds, Gg^Fds, Gll^Fms, Gg^Fds, Dd^Fdw, Gg^Fds, Gg^Fds, Gg^Fms, Gg^Fds, Gg^Fds, Gg^Fds, Gg, Gg^Fds, Rrd^Fdw, Gg^Fds, Gg^Fms, Re^Edt, Gg^Fms, Rb^Vct, Gg^Fds, Gg^Fms
Gg^Fds, Gs^Fms, Gll, Wwt, Gll^Fms, Gg^Fds, Gll, Gg^Fds, Gg^Fds, Gg^Fds, Gg^Fds, Gg, Gg, Gg, Gg^Fds, Wwt, Gg^Fet, Gg^Fds, Gg^Fds, Wwt, Wot, Wot, Wwt, Gg^Fds, Gg^Fds, Gg^Fds, Gg^Fds, Gg, Gg, Gg, Gg^Fms, Gg^Fms, Gg^Fms, Gg^Fms, Gg^Fds, Gg, Gg^Fms, Gg^Fds, Gg^Fms, Gg^Fds, Gs, Gg^Fds, Gg^Fds, Gg^Fds, Gg^Fms, Gg^Edt, Gg^Fds, Gg^Fds, Gg^Fds, Dd, Dd, Gg^Fds, Gg^Fds, Gs^Fds, Gs^Fds, Gs, Rb^Vct, Gs^Fds
Gg^Fds, Gg^Fds, Gg^Fds, Wwt, Gg, Gll^Fms, Gll^Fms, Gg, Gg^Fds, Gg^Fds, Gg^Fds, Gg^Fds, Gg^Ve, Gg, Gg^Fds, Gg^Fds, Gg^Fds, Gg^Fms, Gg^Fds, Wwt, Wwt, Wwt, Wwt, Gg^Efm, Gg^Fms, Gg^Fds, Gg^Efm, Gg, Gg^Fds, Gg^Fds, Gg^Fms, Gg^Fms, Gg^Fms, Gg^Fms, Cv, Cv, Gg^Fds, Gg^Fms, Cv, Gg^Fms, Gs^Fds, Gs^Fds, Gg^Fds, Dd^Fdw, Gs^Fds, Gg^Fms, Rrd^Fdw, Gg^Fds, Dd, Dd, Rrd^Fdw, Gg, Gg^Fds, Gg^Fds, Gd, Gs^Fds, Gs^Fds, Gs^Fds
Gg, Gg^Fds, Gg^Fds, Wwt, Wwt, Gll, Gll^Fms, Gll, Gg^Fms, Gg^Fds, Gg^Fms, Gg^Fds, Gg, Gg, Cv, Gg^Fds, Gg^Fds, Gg^Fds, Gg^Fds, Gg^Fms, Gg^Fds, Gg^Fms, Gg^Efm, Gg^Efm, Gg^Fms, Gg^Fms, Gg^Fms, Gg^Efm, Gg, Gg^Fms, Gg^Fms, Gg^Ve, Gg^Fms, Gg^Fms, Gg^Efm, 8 Kv, Cv, Gg^Fds, Gg^Fds, Gg^Fds, Gg^Fds, Gll^Fms, Gs^Fds, Rrd^Fdw, Gs^Fds, Gs^Fds, Dd, Rrd^Fdw, Gg^Efm, Gg^Fds, Gg^Fds, Gg^Fds, Gg^Fds, Gg^Fds, Gg^Fds, Gg^Fds, Gs^Fds, Gs^Fds
Gg, Gg^Fds, Gg^Fds, Wwt, Wwf, Gg^Fms, Gg^Fds, Gll, Gg, Gll^Fms, Gll^Fms, Gg^Fds, Gg^Fds, Gg^Fds, Gg^Fds, Gg^Fds, Gg^Fds, Gg^Ve, Gg^Fds, Gg^Fds, Gg^Fds, Gg^Fds, Gg^Fds, Gg, Gg^Fds, Gg^Fms, Gg^Fms, Gg^Fms, Gg^Fds, Gg^Fet, Gg^Fds, Gg^Fms, Gg^Fds, Gg^Fms, Gg^Ve, Gg^Efm, Gg, Gll^Fms, Gg^Fds, Gg^Fds, Gs^Fds, Gg, Gs^Fds, Gs^Fds, Gg^Fms, Gs^Fds, Gs^Fds, Rrd^Fdw, Gs^Efm, Gg^Fds, Gg^Fds, Gg^Fds, Gg^Fds, Gg^Fds, Gg^Fds, Gs^Efm, Gg^Fds, Gs^Fds
Gg^Fms, Gg, Re, Gg^Fms, Re, Wwf, Gg, Gg, Gg^Fms, Gg, Gll, Gg^Fds, Gg, Gg^Fds, Gg^Fds, Gg^Fds, Gg^Fms, Gg^Fds, Gg^Fds, Gg^Fds, Gg^Fms, Gg^Fms, Gg^Fds, Gg^Fds, Gg^Efm, Gg^Efm, Dd^Fdw, Rrd, Dd, Gg^Fds, Gg^Fms, Gg^Fms, Gg^Fms, Gg, Gg^Fms, Gg^Fms, Gg^Fds, Gg^Fds, Gg^Fds, Gg^Fds, Gs^Fds, Gg^Fms, Gg^Fms, Gg^Fms, Gg^Fms, Rrd^Fdw, Dd, Gs^Efm, Rrd^Fdw, Gg^Fds, Gg^Fds, Gg^Fds, Gg^Fds, Gg^Fds, Gg^Fds, Gg^Fds, Wwt, Wwt
Gg, Re, Gg^Fms, Gg, Gg^Fms, Wwt, Wwf, Gg^Fds, Gg^Fms, Gg, Gg^Fms, Gg^Fds, Gg^Fms, Gg^Fds, Gg^Fds, Gg^Fms, Gll^Fds, Gg^Fds, Gll^Fds, Gll^Fds, Gg^Fms, Gg^Fds, Gg^Fds, Gg^Fds, Dd^Fdw, Gg, Gg^Fds, Gg^Fds, Dd, Dd, Gg^Fms, Gg^Fms, Gg^Fms, Gg^Fms, Gg^Fms, Gg^Fds, Gg^Fds, Gg^Fds, Gg, Gg^Fds, Gg^Fds, Gg^Fds, Gg^Fds, Gg^Fms, Gg^Fms, Hh, Gs, Gs^Fds, Gs^Fds, Gs^Fds, Gs^Fds, Gs^Fds, Gg^Fms, Gs^Efm, Wwt, Wwt, Wwt, Wwt
Gg, Gg, Gg^Fms, Gll^Fms, Gg^Ve, Wwt, Gg^Fds, Gg^Fds, Gg^Fms, Gg^Fms, Gg^Fms, Gg^Fms, Gg^Efm, Gg^Efm, Gg^Fds, Gll^Fds, Gll^Fms, Gll^Fds, Gll^Fds, Gll^Fms, Gll, Gg^Fds, Gg^Fds, Gg^Fds, Gg^Fds, Gg^Fms, Dd^Fdw, Gg^Fds, Gd, Gs, Gd, Gg^Fms, Gg, Gg^Fms, Gg^Fds, Gg^Fds, Gg^Fds, Gg^Fms, Gg^Fms, Gg, Gg^Fds, Gg^Fds, Hh, Gg^Fds, Hh, Gs, Dd, Rrd, Hh^Qhh, Dd^Fdw, Gs^Fds, Gg^Fms, Gg^Fms, Wwt, Wwt, Wwt, Wot, Wot
Gg^Fms, Gg^Fms, Gg^Qhhf, Gg^Qhhf, Gg^Qhhf, Wwt, Wwt, Gg^Fds, Gg^Fms, Gg^Fms, Gg^Fms, Gg^Fds, Gg^Fds, Gg^Efm, Gg^Fms, Gg^Fms, Gg^Fms, Gll^Fds, Gll^Fds, Gll^Fds, Gll^Fds, Gg^Fms, Gg^Fms, Gg^Fds, Gg^Fds, Gg^Fds, Dd, Dd, Gg^Fds, Gg^Fds, Rrd, Gs, Dd, Gg^Fds, Gg^Fds, Gg^Fds, Gg^Fds, Gg^Fds, Gg^Fms, Gg^Fms, Dd^Fdw, Gg^Fds, Hh, Hh, Hh^Qhh, Hh^Qhh, Hh^Qhh, Hh^Qhh, Hh^Qhh, Hh^Efm, Gs^Fds, Gg^Fms, Wwt, Wwt, Wwt, Wot, Wot, Wot
Gg, Gll^Qhh, Gg^Fds, Gg^Fms, Gg^Fds, Gg^Qhhf, Gg^Qhhf, Wwt, Wwt, Gll^Fms, Gg^Fds, Gg^Fds, Gg, Gg^Fms, Gg^Fms, Gg^Fms, Gg^Fms, Gll^Fds, Gll^Fds, Gll^Fds, Gg^Fms, Gg^Fms, Gg^Fds, Gg^Fds, Rb, Rb^Vct, Gg^Fds, Rrd, Gg^Fds, Gg^Fds, Gg^Fds, Gg^Fds, Dd, Dd, Gg, Gg^Fds, Rrd^Fdw, Gg, Dd, Dd, Rrd, Hh, Rrd, Hh, Rb^Vct, Hh^Qhh, Hh^Efm, Hh^Qhh, Hh, Gs^Fds, Gg, Gs^Fds, Wwt, Wwt, Wot, Wot, Wot, Wot
Gg^Qhh, Gg^Qhhf, Gg^Fms, Gg^Fds, Gg^Fms, Gg^Fds, Gg^Fds, Gg^Qhhf, Wwt, Gll^Fms, Gll^Fds, Gg^Fds, Gg^Fds, Gg, Gg^Fms, Gg^Ve, Gg, Gg^Fds, Gg^Fds, Gg^Fds, Gg^Efm, Gg^Fds, Gg^Fms, Rb^Vct, Rb, Gg^Fds, Gg^Fds, Gg^Fds, Rrd^Fdw, Gg^Fms, Gg^Fms, Gs, Gg^Fds, Gg^Fds, Gg^Fds, Dd, Dd, Dd, Gd, Dd, Dd^Fdw, Dd, Dd, Re^Vct, Re, Hh, Gd, Hh, Wwt, Wwt, Wwt, Wwt, Wwt, Wwt, Wot, Wot, Wot, Wot
Hh^Qhh, Gg^Fds, Gg, Gg^Fds, Gg^Fms, Gg^Fds, Gg^Qhhf, Gg^Qhhf, Gg^Efm, Wwt, Wwt, Gll^Fds, Gll^Fds, Gg^Fms, Gg^Fms, Gg^Fms, Gg^Fms, Gg^Fds, Gg^Efm, Gg^Fds, Gg^Fds, Gg^Efm, Gg^Fds, Gg^Fds, Gg^Fms, Rb^Vct, Rb, Gd, Ce^Edt, Gs, Ce, Gd, Gg, Rrd^Fdw, Dd, Gs^Fds, Gs^Fds, Re^Vct, Re^Fds, Dd, Rrd, Ce^Edt, 4 Ke, Ce, Wwt, Rb^Vct, Wwt, Wwt, Wwt, Wwt, Wwt, Wwt, Wot, Wot, Wot, Wot, Wwt, Wwt
Hh, Gg^Fms, Gg^Fds, Gg^Fms, Gll^Qhhf, Gg^Qhh, Gg^_mh, Gg^Qhhf, Gg^Qhhf, Wwt, Gg, Gll^Fds, Gll^Fms, Gg^Fms, Gg^Fms, Gg^Fms, Gg^Fms, Gg^Efm, Gg^Fds, Gg^Efm, Gg^Fds, Gg^Fds, Rb^Vct, Rb, Gd^Ecf, Gd, Rb, Ce, 5 Ke, Gs, Ce^Edt, Ce, Rrd, Dd, Wwt, Gs^Fds, Wwt, Gs^Fds, Gs^Edt, Gs^Edt, Gs^Edt, Ce^Edt, Wwt, Wwt, Wwt, Wwt, Wot, Wot, Wot, Wot, Wot, Wot, Wot, Wwt, Wot, Wot, Wwt, Wwt
Gg, Gll^Fms, Hh^Qhhf, Gg^Fds, Gg^Fms, Gg^Fds, Gg^Fms, Gg^Fms, Gg^Qhhf, Wwt, Wwt, Gg^Fms, Gg^Fds, Gg^Fms, Gg^Fds, Gg^Fms, Gg, Dd^Fdw, Rrd, Gg^Fds, Gg^Fds, Rb^Vct, Gs, Rb, Rb, Rb^Vct, Rb^Edt, Ce^Edt, Gs, Rb, Wwt, Gs, Wwt, Wwt, Wot, Wwt, Wwt, Wwt, Wwt, Gg^Fds, Wwt, Wwt, Wwt, Wwt, Wwt, Wwt, Wot, Wot, Wot, Wot, Wot, Wot, Wwt, Wot, Wot, Wwt, Gs^Fds, Gs^Fds
Gg, Hh, Hh^Qhhf, Gg^Qhhf, Gg^Qhhf, Gll^Qhhf, Gg^Qhh, Gg^Qhhf, Gg^Qhh, Wwt, Wwt, Gg^Fds, Gg^Fds, Gg^Fds, Gg^Fds, Gg, Gg, Dd^Fdw, Dd, Dd, Gg, Dd, Gs, Rb, Gs, Gd, Wwt, Wwt, Wwt, Wwt, Wwt, Wwt, Wwt, Wot, Wot, Wot, Wot, Wwt, Wwt, Wwt, Wwt, Wwt, Wot, Wot, Wot, Wot, Wot, Wot, Wot, Wot, Wot, Wwt, Gg, Wwt, Gs^Fds, Gs^Fds, Gs^Fds, Gs^Fds
