Gg, Gs^Fds, Gs^Fds, Gs^Fds, Gs^Fds, Gs^Fds, Gs^Fds, Gg, Gg, Gg, Gs^Fds, Gg, Gg^Fds, Gg^Fds, Gg^Fds, Gg^Fds, Gg, Gg, Gg, Gg, Gg^Fds, Gg, Gg, Gg, Gg, Gg, Gg, Gg, Gg, Gg, Gg^Fds, Gg
Gg, Gg, Gs^Fds, Gs^Fds, Gs^Fds, Gs^Fds, Gg, Gg, Gs^Fds, Gs^Fds, Gs^Fds, Gs^Fds, Xuf, Xuf, Xuf, Gg^Fds, Gg^Fds, Gg^Fds, Gg, Gg^Fds, Gg, Gg^Fds, Gg^Fds, Gg^Fds, Gg^Fds, Gg, Gg, Gg, Gg, Gg^Fds, Gg, Gg
Gs^Fds, Gg, Gs^Fds, Gs^Fds, Gs^Fds, Gs^Fds, Gs^Fds, Gs^Fds, Gg, Gs^Fds, Xuf, Xuf, Xuf, Xuf, Xuf, Xuf, Xuf, Gg, Gg, Gg, Gg^Fds, Gg^Fds, Gg^Fds, Gg, Gg, Gg^Fds, Gg, Gg^Fds, Gg, Gg^Fds, Gg^Fds, Gg
Gg, Gg, Gg, Gs^Fds, Gg, Gs^Fds, Gs^Fds, Gs^Fds, Xuf, Xuf, Xuf, Xuf, Xuf, Xuf, Xuf, Xuf, Xuf, Xuf, Xuf, Gg, Gg, Gg, Gg^Fds, Gg^Fds, Gg, Gg, Gg, Gg^Fds, Gg, Gg, Gg^Fds, Gg
Gs^Fds, Gg, Gg, Gg, Gs^Fds, Gs^Fds, Gs^Fds, Xuf, Xuf, Xuf, Xuf, Xuf, Gg^Efm, Gg^Efm, Gg^Efm, Xuf, Xuf, Xuf, Xuf, Xuf, Xuf, Gg^Fds, Gg^Fds, Gg^Fds, Gg, Gg, Gg, Gg, Gg^Fds, Gg, Gg, Gg
Gg, Gs^Fds, Gs^Fds, Gs^Fds, Gs^Fds, Gs^Fds, Xuf, Xuf, Xuf, Xuf, Xuf, Xuf, Gg^Efm, Gg^Ii, Gg^Efm, Xuf, Xoi, Xoi, Xoi, Xuf, Xoi, Xuf, Xuf, Gg^Fds, Gg, Gg^Fds, Gg, Gg^Fds, Gg^Fds, Gg, Gg^Fds, Gg
Wwt, Gg, Wwt, Gg, Xuf, Xuf, Xuf, Xuf, Xuf, Xuf, Iwr^Xo, Iwr^Xo, Iwr, Gg^Efm, Xoi, Xoi, Iwr^Xo, Iwr, Iwr^Xo, Xoi, Xoi, Xoi, Xoi, Gg^Fds, Gg^Fds, Gg, Gg, Gg, Gg^Fds, Gg^Fds, Gg, Gg^Fds
Gs^Fds, Wwt, Gg, Wwt, Wwt, Xuf, Xuf, Xuf, Wwt, Xuf, Xuf, Iwr, Iwr^Ii, Iwr, Iwr, Iwr^Xo, Iwr, Iwr^Efs, Xoi, Xoi, Xoi, Xoi, Xuf, Gg^Fds, Gg^Fds, Gg, Gg, Gg^Fds, Gg^Fds, Gg^Fds, Gg^Fds, Gg^Fds
Gs^Fds, Gs^Fds, Gs^Fds, Gs^Fds, Xuf, Wwt, Wwt, Wwt, Xoi, Wwt, Wwf, Iwr, Gg, Gg, Gg, Iwr^Efs, Xuf, Xuf, Xoi, Xoi, Xoi, Xuf, Gg^Fms, Gg, Gg, Gg^Fds, Gg^Fds, Gg, Gg, Gg^Fds, Gg, Gg
Gg, Gs^Fds, Gs^Fds, Gs^Fds, Xuf, Xuf, Xuf, Xuf, Xoi, Xoi, Xoi, Wwf^Ewl, Wwt^Ewf, Xuf, Re, Gg, Gg, Xuf, Xuf, Xoi, Gg^Fms, Gg^Fds, Gg^Fds, Gg^Fms, Gg, Gg, Gg, Gg, Gg, Gg, Gg, Gg
Gg, Gg, Gs^Fds, Gs^Fds, Xuf, Xuf, Xuf, Xuf, Xoi, Xoi, Iwr^Ii, Gg, Gg, Wwt, Wwt, Re, Re^Ii, Re, Rb, Xuf, Gg, Gg^Efm, Gg^Efm, Gg, Wwt^Ewf, Wwt, Wwt, Gg, Gg, Gg, Gg^Fds, Gg
Gg, Gg, Gs^Fds, Gs^Fds, Gs^Fds, Xuf, Xuf, Xuf, Xoi, Iwr^Ii, Iwr, Iwr^Ebn, Iwr, Gg, Wwf^Ii, Gg^Efm, Xoi, Gg, Rb, Re, Re, Gg, Gg^Efm, Gg^Efm, Gg, Wwt, Gg, Gg, Gg^Fds, Gg^Fds, Gg^Fds, Gg
Gs^Fds, Gg, Gs^Fds, Gs^Fds, Gs^Fds, Xuf, Xuf, Xuf, Xuf, Iwr, Iwr, Iwr, Iwr, Wwf, Wwf^Ii, Xoi, Xoi, Xoi, Gg, Rb, Gg, Re, Rb, Gg^Efm, Rb, Gg, Gg, Gg^Fds, Gg, Gg^Fds, Gg^Fds, Gg
Gg, Gs^Fds, Gg, Gg, Gs^Fds, Gg, Xuf, Xuf, Xuf, Xuf, Xuf, Xuf, Xuf, Wwt, Wwt, Wwt^Ewl, Xoi, Xuf, Xuf, Gg, Gg, Rb, Gg, Re, Rb, Rb, Gg, Gg^Fds, Gg, Gg, Gg^Fds, Gg
Gg, Gg, Gg, Gs^Fds, Gs^Fds, Gg, Gs^Fds, Xuf, Xuf, Xuf, Xuf, Xuf, Xuf, Xuf, Xuf, Wwt, Xuf, Xuf, Xuf, Gg, Gg^Fds, Gg^Fds, Gg^Fds, Gg, Gg, Re, Rb, Gg, Gg, Gg^Fds, Gg, Gg^Fds
Gs^Fds, Gg, Gg, Gs^Fds, Gg, Gg, Gs^Fds, Gs^Fds, Gs^Fds, Xuf, Gg^Efm, Xuf, Xuf, Xuf, Xuf, Wwt, Gg^Fds, Xuf, Gg^Fds, Gg, Gg, Gg^Fds, Gg^Fds, Gg, Gg^Efm, Rb, Re, Re, Gg, Gg, Gg^Efm, Gg^Efm
Gg, Gs^Fds, Gs^Fds, Gg, Gg, Gg, Gg, Gs^Fds, Gs^Fds, Gs^Fds, Gg^Efm, Gg, Gs^Fds, Xuf, Gg^Fds, Wwt, Wwt, Gg^Fds, Gg^Efm, Gg^Efm, Gg, Gg, Gg^Fds, Gg^Efm, Gg^Efm, Gg, Re, Re, Re, Gg, Gg, Gg
Gs^Fds, Gs^Fds, Gs^Fds, Gs^Fds, Gs^Fds, Gg, Gg, Gg, Gg, Gg, Gg, Gg, Gg, Gs^Fds, Gg^Fds, Gg^Fds, Wwt, Gg, Gg^Fds, Gg, Gg, Gg, Gg^Fds, Gg^Efm, Gg^Efm, Gg^Efm, Gg, Re, Rb, Gg, Gg, Gg
Gg, Gs^Fds, Gs^Fds, Gg, Gs^Fds, Gg, Gg, Gs^Fds, Gs^Fds, Gs^Fds, Gs^Fds, Gs^Fds, Gg, Gg^Fds, Gg^Fds, Gg^Fds, Gg, Wwt, Gg, Gg^Fds, Gg^Fds, Gg^Fds, Gg^Fds, Gg^Fds, Gg, Gg^Efm, Gg, Re, Re, Gg, Gg, Gg
