Gs^Qhhf, Gs^Qhhf, Gs^Qhhf, Gs^Qhhf, Gs^Qhhf, Gs^Qhhf, Gs^Qhhf, Gs^Qhhf, Gs^Qhhf, Gs^Qhhf, Gg, Gg, Gg, Gs^Fds, Gg^Fms, Gs^Fds, Gs^Fds, Gg, Gg^Fms, Gg, Gg, Gg, Gs, Gg, Gs, Gg, Ce, Gg, Re, Gg, Re, Gg, Gs, Wwt, Wwt, Gg, Gg, Gs^Fds, Rrd, Gg^Fms, Rrd, Wwf, Rrd, Dd^Fds, Rrd^Fdw, Gg^Efm
Gs^Qhhf, Gs^Fms, Gs^Fms, Gs^Fms, Gs^Fms, Gs^Fds, Gs, Gs^Fds, Gs^Qhhf, Gs^Qhhf, Gg, Gg, Gg^Efm, Gg^Fms, Gg, Gs^Fds, Gg, Gs^Fds, Gll^Fds, Gg^Fms, Gll^Fms, Gs^Fds, Gs^Fds, Gs, Re^Vct, Re^Vct, Ce^Edt, 3 Ke, Gs, Re^Ecf, Ce^Edt, Ce, Gs^Fds, Gg, Gs, Wwt, Wwt, Gg, Gs^Fds, Rrd^Fdw, Rrd, Wwf, Gg, Rrd, Gg^Fds, Dd
Gs^Qhhf, Gs^Fds, Gs^Fds, Gs^Fms, Gs^Qhhf, Gs^Qhhf, Gs^Qhhf, Gs^Qhhf, Gg, Gg, Gg^Efm, Gg, Gg, Gg^Efm, Gg, Gg, Gs^Fds, Gll, Gs^Fds, Gll^Fms, Gll^Fds, Gs^Fds, Gs, Gs, Gs^Efm, Re^Edt, Gs^Edt, Ce^Edt, Re^Es, Re, Gs, Ce, Gg, Gs^Fds, Gs^Fds, Gs^Fds, Gs^Fds, Wwt, Gs^Fds, Gs^Fds, Wwt, Wwt, Dd^Fdw, Gg^Fds, Rrd^Fdw, Gg
Gg^Qhh, Gs, Gs^Fds, Gs^_mh, Gs^Qhhf, Gg, Gg, Gs^Fds, Gg, Gg^Efm, Gg^Fms, Gg, Gs^Fds, Gs^Fds, Gs^Fds, Gg, Gg, Gs^Fds, Gg, Gs^Fds, Gs, Gs, Gg^Fms, Gg^Efm, Gg, Gs, Gs, Gs, Gs, Ce, Gg, Gs^Fds, Gs^Fds, Gs^Fds, Gs^Fds, Gs^Fds, Gs^Fds, Wwt, Wwt, Wwt, Wwf, Gg, Dd, Rrd^Fdw, Rrd, Dd
Gs^Qhh, Gs^Fds, Gs^Qhhf, Gs^Qhhf, Gg^Fms, Gg, Gg^Es, Gg, Gs, Gs^Fds, Gs^Fds, Gg^Fms, Gll^Fms, Gs^Fds, Gs^Fds, Gg, Gg^Efm, Gg, Gg^Es, Gs, Gs^Fms, Gs^Fms, Gs^Fms, Gg^Fms, Gg^Fms, Gg^Fms, Gg^Fms, Gs^Fms, Gg, Gs, Gg, Gs, Gs, Gs, Gs^Fds, Gs^Fds, Gs^Fds, Gs^Fms, Gg, Wwt, Dd, Gg^Fds, Gg, Rrd, Rrd, Rrd
Gs^Qhhf, Gs^Qhhf, Gg, Gg^Fms, Gg, Gg, Gs, Gs, Gg^Fms, Gs^Fms, Gll^Fms, Gll^Fms, Gg^Fms, Gg^Fms, Gs^Fds, Gg, Gs^Fds, Gg^Efm, Gg^Efm, Gg^Fms, Gll^Fms, Gs^Fms, Gs, Gg^Fms, Gll^Fms, Gll^Fms, Gll^Fms, Gg^Fms, Gs^Fms, Gs^Fds, Gs^Fds, Gs, Gs^Fds, Gs, Gs, Gs^Fds, Gs^Fds, Gs^Fds, Gs^Fds, Wwt, Gg, Dd^Fdw, Dd, Gg, Rrd^Fdw, Dd
Gs, Gg, Gs, Gg, Gg, Gg, Gg, Gs^Fds, Gg^Fms, Gg^Fms, Gg^Fms, Gg^Fms, Gs^Fds, Gs^Fds, Gs^Fds, Gs^Fds, Gs^Fds, Gs, Gs, Gs, Gll^Fms, Gll^Fms, Gll^Fms, Gll^Fms, Gll^Fms, Gll^Fms, Gll^Fms, Gs^Fms, Gs^Fds, Gs^Fds, Gs^Fds, Gs^Fds, Gg, Gs, Gs^Fds, Gs^Fds, Gg^Efm, Gs^Fds, Gs^Fds, Wwt, Wwt, Gg, Gg^Fms, Gg, Rrd, Rrd^Fdw
Gs, Gs, Gs, Gg, Gg^Efm, Gg^Efm, Gg, Gg, Gs^Fds, Gg^Fms, Gg^Fds, Gg^Fds, Gg, Gs^Fds, Gs, Gs^Fds, Gs, Gg, Gll^Fms, Gs^Fms, Gg^Fms, Gll^Fms, Gs^Fds, Gll^Fds, Gll^Fms, Gg^Fms, Gs^Fds, Gs^Fds, Gs^Fds, Gg, Gll^Fds, Gs^Fds, Gll^Fds, Gg, Gg, Gg, Gg, Gg^Fds, Gs^Fds, Wwt, Wwf, Gg^Fms, Gg^Fds, Gg, Gg, Dd
Gg, Gg^Efm, Gg^Efm, Gg^Efm, Gg, Gg, Gg^Fds, Gg^Fds, Gg^Fds, Gg^Fds, Gg, Gg, Gg^Efm, Gs, Gs^Efm, Gs, Gg, Gg^Efm, Gg, Gg^Fms, Gg, Gg^Fms, Gg^Fms, Gll^Fms, Gs^Fds, Gs^Fds, Gs^Fds, Gs^Fds, Gs^Ve, Gs^Fds, Re, Gll^Fds, Gll^Fds, Gll, Gg, Gg, Gg^Fms, Gg, Re, Gg^Fms, Re, Wwf, Gg, Gg, Gg^Fds, Gg
Gs, Gs, Gs, Gg^Efm, Gg, Gg, Gg, Gg^Fds, Gg, Gg, Gg^Efm, Gg^Efm, Gg, Gg, Gs^Fds, Gg, Gs^Fds, Gs^Fds, Gs^Fds, Gg, Gg, Gg, Gs^Fds, Gs^Fds, Gg, Gg, Re, Gg, Gs^Fds, Re, Gs^Fds, Re, Rb^Qhh, Gg, Rb, Gg^Es, Gg, Re, Gg^Fms, Gg, Gg^Fms, Wwt, Wwf, Dd, Dd, Gg
Gg, Gs, Gs, Gg, Gg, Gg, Gg, Gg, Gg, Gg, Gg^Efm, Gg^Efm, Gg^Ve, Gs^Fds, Gs^Fds, Gs^Fds, Gs^Fds, Gs^Fds, Gg^Efm, Gg, Gg, Gg, Gg, Gg, Rb, Rb, Gs, Gs, Hh^Qhhf, Gs^Fds, Hh, Re, Gg, Re^Qhh, Gg^Qhh, Re, Gg, Gg, Gg^Fms, Gg^Fms, Gg^Ve, Wwt, Rrd, Rrd, Dd, Dd
Gg, Gs^Fds, Gs^Fds, Gs^Fds, Gs^Fds, Gs^Fds, Gs^Fds, Gg^Fds, Gg^Fds, Gg, Gg, Gg, Gs^Fds, Gs^Fds, Gs^Fds, Gs^Fds, Gg, Gg, Gg^Efm, Gg^Efm, Gg^Efm, Gg^Efm, Re, Re, Gg, Gg, Hh^Qhh, Hh^Qhh, Hh, Hh^Qhh, Hh^Qhh, Hh, Hh^Qhh, Gg, Gg^Qhhf, Gg^Fms, Gg^Qhhf, Gg^Qhhf, Gg^Qhhf, Gg^Qhhf, Gg^Qhhf, Wwt, Wwt, Dd, Dd^Fdw, Dd
Gs^Fds, Gg, Gs^Fds, Gs^Fds, Gs^Fds, Gs^Fds, Gg^Fms, Gg^Fms, Gg^Fms, Gg^Fms, Gg^Fms, Gs^Fds, Gs^Fds, Gs^Fds, Gs^Fds, Gs^Fds, Gg^Fms, Gs^Fds, Gg, Gg^Efm, Gg, Gg, Re, Gg, Gg, Hh^Qhh, Hh^Qhhf, Hh^_mh, Hh, Hh, Hh, Hh^Qhh, Hh, Gg, Gg, Gg^Qhhf, Gg^Fms, Gs, Gs^Fds, Gg^Fms, Gg^Fms, Gg^Qhhf, Gg^Qhhf, Wwt, Wwt, Dd^Fdw
Gs^Fds, Gs^Fds, Gs^Fds, Gs^Fds, Gs^Fds, Gg^Ve, Gg^Fms, Gg^Fms, Gll^Fds, Gll^Fms, Gll^Fds, Gll^Fms, Gg^Fms, Gs^Fds, Gg, Gs^Fds, Gg^Fms, Gg^Fms, Gg^Efm, Gg^Efm, Gg, Gs^Ve, Gg, Gg, Gg, Gs, Hh^Qhhf, Hh^Fds, Hh, Hh, Hh, Hh, Hh, Hh, Gg, Gg^Fms, Gg, Gg^Fds, Gg^Fms, Gg^Fms, Gg^Fms, Gg^Fms, Gg^Fds, Gg^Qhhf, Wwt, Dd
Gs^Fds, Gs^Fds, Gs^Fds, Gs, Gs^Fds, Gs^Fds, Gs^Fds, Gs^Fds, Gs^Fds, Gll^Fms, Gll^Fms, Gll^Fds, Gs^Fds, Gg^Fms, Gg^Fms, Gs^Fds, Gg^Fms, Gg^Ve, Gg, Gg, Cv, Cv, Re, Re, Gg, Cv^Fet, Hh^Qhh, Hh^Fds, Hh^Qhhf, Hh^Qhhf, Hh^Qhh, Hh^Qhh, Hh^Qhh, Hh, Hh^Fms, Hh, Hh, Gg, Gg^Es, Gg, Gg^Fds, Gg, Gg^Qhhf, Gg^Qhhf, Gg^Efm, Wwt
Gg^Fms, Gs^Fds, Gs^Fds, Gs^Fds, Gs^Fds, Gs^Fds, Gs, Gs, Gs^Fds, Gs^Fds, Gg^Fds, Gg^Fds, Gg^Fds, Gg^Fds, Gg^Fds, Gg^Fms, Gg^Fds, Gg^Fds, Gg, Gg^Ve, Gg, Kv, Gg, Rb, Gg^Efm, Hh^Qhh, Hh^Qhh, Hh^Qhhf, Ds, Ds, Ds, Dd, Hh^Qhh, Gg^Fms, Hh^Qhhf, Hh, Hh, Gg^Fds, Gg^Fds, Gg^Fds, Gg^Fds, Gg, Gg, Gg^Qhhf, Gg^Qhhf, Wwt
Gs^Fds, Gs^Fms, Gs^Fms, Gs^Fds, Gs^Fds, Gg, Gs^Fds, Gs^Fds, Gs, Gs, Gg^Fds, Gg^Fds, Gg, Gg^Fds, Gg, Gs^Fds, Gg, Gg, Gg, Gg, Gg, Cv^Fet, Gg, Gg, Gs^Ve, Gs^Efm, Hh^Qhh, Hh^Qhh, Hh^Qhh, Hh^Qhhf, Dd, Dd, Gg^Fds, Hh^Qhhf, Gg, Hh^Qhh, Gg^Qhhf, Hh^Qhhf, Gg^Qhhf, Gg^Fds, Gg^Fds, Gg^Fds, Gg^Fds, Gg^Fds, Gg^Qhh, Wwt
Gs, Gs, Gs, Gg, Gg, Gs^Fds, Gs^Fds, Gs^Fds, Gs^Fds, Gs^Fds, Gg, Gg, Gg, Gg, Gg, Gg, Gg, Gg, Cv^Fet, Gg, Re, Gg, Re, Re, Gs, Gs^Efm, Cv^Fet, Hh^Qhh, Hh^Qhh, Hh^Qhhf, Gg^Fms, Dd, Dd, Hh^Qhh, Gg^Fds, Gg^Fds, Gg, Gg, Hh^Qhhf, Gg^Fds, Gg^Qhhf, Gg^Qhhf, Gg^Qhh, Gg^Qhhf, Hh^Qhh, Gg^Qhh
Gll^Fms, Gs, Gg^Efm, Gg^Efm, Gg^Efm, Gs, Gs^Ve, Gg, Gs^Fds, Gs^Fds, Gg, Gg, Gg^Efm, Gg^Efm, Gg, Gg, Gg, Gg, Gg, Gg, Re, Rb, Re, Gg, Hh, Hh, Hh, Hh^Qhhf, Hh^Fds, Gg^Fms, Hh^Fds, Dd, Dd, Gg^Fms, Rrd^Fds, Gg^Fds, Gg, Hh^Qhh, Hh^Qhh, Hh^Qhh, Rrd^Fdw, Rrd^Fdw, Hh, Hh, Hh, Hh^Qhh
Gs^Fds, Gll^Fds, Gll^Fds, Gs^Fds, Gs, Gs, Gs, Gs, Gg, Gg, Gg, Gg^Efm, Gg, Gg^Efm, Gg^Efm, Cv^Fet, Re, Gg, Re, Re, Gg, Re, Gg, Gg, Gg, Gg, Gg, Gg, Gg, Hh, Gg^Efm, Dd, Gs^Fms, Gs^Fds, Gg^Fds, Rrd, Rrd, Gg, Gs, Rrd, Rrd, Rrd^Fdw, Re, Hh, Gg, Gg
Gll^Fds, Gll^Fds, Gg^Fms, Gs^Fds, Gg^Fms, Gs^Fds, Gs^Fds, Gs, Gg, Gg, Gg^Efm, Gg^Efm, Cv^Fet, Gg, Gg, Rb, Rb, Re, Re, Re, Gg^Efm, Cv^Fet, Gg^Efm, Gg^Efm, Gg^Fms, Gg, Gg, Gg^Es, Gg, Gg^Efm, Gs, Gg^Efm, Gs^Efm, Gg^Fds, Rrd, Rrd^Fdw, Gs, Rrd^Fdw, Gg^Es, Gg, Ce^Edt, Rb, Rb^Vct, Ce, 4 Ke, Ce^Edt
Gll^Fds, Gs^Fds, Gll^Fms, Gll^Fms, Gg^Fms, Gs^Fds, Gg, Gg, Gg, Gg^Efm, Gg, Gg^Efm, Gg, Re, Re, Re, Gg, Gg, Cv^Fet, Gg, Gg^Efm, Gg^Efm, Gg, Gg^Fms, Gg^Fms, Gg, Gg, Gs^Efm, Gs^Efm, Gs^Fms, Gs^Fds, Gs, Gs, Gs, Gg, Rrd, Gs^Edt, Gs, Rb, Gg, Ds, Ds, Gg, Ce, Ds, Dd^Edt
Gs^Fds, Gg^Fms, Gg^Fms, Gg^Fms, Gs, Gs, Gs^Fds, Gg, Gs^Fds, Gs^Fds, Gg, Gg, Rb, Re, Gg, Gg, Gg, Gg, Gg, Gg^Efm, Gg, Gg^Efm, Gg, Gg^Fms, Gg^Fms, Gg^Ve, Gg, Gs^Efm, Hh, Gg^Fms, Rrd^Fds, Rrd, Rrd^Fdw, Gs, Gs, Gs^Edt, Ce^Edt, Ce, Dd, Re^Vct, Dd^Edt, Ds, Wwt^Ewl, Wwt, Wwt, Wwt^Edt
Gg, Gs^Fds, Gs, Gs, Gs, Gs^Fds, Gg^Fms, Gg, Gg, Gg, Rb, Rb, Gg, Rb, Gg, Cv^Fet, Gg, Gg^Es, Gg, Gg, Gg^Fms, Gg, Gs^Fds, Gs^Fds, Gg, Gg^Fms, Hh^Fms, Hh, Hh^Fds, Gs, Rrd, Rrd, Gg, Gg^Es, Ds, Ds, Ce, 5 Ke, Dd, Dd^Edt, Wwt, Wwt, Wwt, Wwt, Wot, Wwt
Gs, Gs, Dd, Dd, Dd, Gg^Fms, Dd, Gg, Gs^Fds, Gg, Rb, Re, Gll^Fms, Gs^Fds, Gs^Fds, Gg, Gs^Fds, Gs^Fds, Gs, Gs^Fds, Hh^Fds, Hh^Fds, Hh^Fms, Hh^Fms, Hh^Fms, Hh, Hh^Fms, Hh^Fds, Gs, Gs, Gs, Dd, Dd, Dd, Wwf, Ds, Wwf^Edt, Ds, Wwt, Wwt, Wwt, Wwt, Wot, Wot, Wot, Wot
Dd, Dd, Dd, Dd, Wwt, Wwt, Wwt, Wwt, Wwf, Wwf, Wwf, Re, Wwf, Gll^Fms, Gs^Fds, Gs^Fds, Gll^Fms, Gg^Fms, Gs, Gs, Hh^Fms, Gg^Fms, Hh^Fms, Hh^Fms, Gg, Hh, Hh, Hh^Fms, Gg, Gs, Dd, Dd, Wwt, Wwf, Wwt, Wwf, Wwt, Wwt, Wot, Wot, Wot, Wot, Wot, Wot, Wot, Wot
Wwt, Wwt, Wwt, Wwt, Wot, Wwt, Wwt, Wwt, Wwt, Wwf, Wwf, Wwt, Wwt, Wwt, Wwt, Wwt^Ewf, Wwt, Gll^Fms, Dd, Gs, Gs, Hh^Fms, Hh^Fms, Hh^Fms, Hh^Fms, Hh, Dd, Gg, Wwt, Wwt, Wwt, Wwt, Wwt, Wwt, Wot, Wwt, Wot, Wot, Wot, Wot, Wot, Wot, Wot, Wot, Wot, Wot
Wwt, Wwt, Wwt, Wot, Wot, Wot, Wot, Wwt, Wwt, Wwt, Wwt, Wwt, Wwt, Wwt, Wot, Wwt, Wot, Wwt^Ewf, Wwt, Dd, Dd, Dd, Dd, Gg, Dd, Dd, Wwt, Wwt, Wot, Wwt, Wot, Wwt, Wot, Wot, Wot, Wot, Wot, Wot, Wot, Wot, Wot, Wot, Wot, Wot, Wot, Wot
Wot, Wwt, Wot, Wot, Wwt, Wot, Wwt, Wwt, Wwf, Wwt, Wwt, Wwt, Wwt, Wwt, Wwt, Wot, Wot, Wot, Wot, Wwt, Wwt, Wwt, Wwt, Wwt, Wwt, Wwt, Wwt, Wot, Wot, Wot, Wot, Wot, Wot, Wot, Wot, Wot, Wot, Wot, Wot, Wot, Wot, Wot, Wwt, Wwt, Wwt, Wwt
Wot, Wot, Wot, Wot, Wwt, Wwt, Wwt, Wwf, Wwf, Wwf, Wwf, Wwt, Wwt, Wwt, Wwt, Wwt, Wot, Wot, Wot, Wwt, Wot, Wwt, Wot, Wwt, Wot, Wwt, Wot, Wot, Wot, Wot, Wot, Wot, Wot, Wot, Wot, Wot, Wot, Wot, Wot, Wot, Wot, Wwt, Ds, Ds, Gg^Qhhf, Gg^Qhhf
Wot, Wot, Wwt, Wwt, Wwt, Wwt, Dd, Dd^Es, Dd^Es, Re, Rb, Wwf, Dd^Es, Wwt, Wwt, Wwt, Wwt, Wot, Wot, Wot, Wot, Wot, Wot, Wot, Wot, Wot, Wot, Wot, Wot, Wot, Wot, Wot, Wot, Wot, Wot, Wot, Wot, Wot, Gs^Qhh, Wot, Gs^Qhhf, Gs^Qhhf, Gs^Qhhf, Gg^Qhhf, Gg^Fms, Gg^Qhhf
Wwt, Wwt, Gs^Fds, Gg^Fms, Gg^Fms, Gg^Fms, Gg^Fet, Dd^Es, Gg^Fms, Re, Gg^Fms, Gg^Fet, Dd, Dd, Dd, Wwt, Dd, Wwt, Wwt, Wot, Wot, Wot, Wot, Wot, Wot, Wot, Wot, Wot, Wot, Wot, Wwt, Wwt, Wwt, Wwt, Wwt, Wwt, Gg^Qhhf, Gs^Qhh, Gg^_mh, Gg^Qhhf, Gs^Fds, Gs^Fds, Gs^_mh, Gg^Fms, Gg^Fms, Gg^Qhhf
Gs^Fds, Gs^Fds, Gs^Fds, Gg^Fms, Gs^Fds, Gg^Fms, Gs^Fds, Gs^Fds, Gg^Fms, Re, Re, Gg^Fms, Gg^Fms, Gg^Fms, Gs, Dd, Gs, Gs, Gg^Fms, Dd, Wwt, Wwt, Wwt, Wot, Wot, Wot, Wot, Wot, Wot, Wot, Wwt, Wwt, Wwt, Wwt, Ds, Ds, Gg^Qhhf, Gg^Qhhf, Gs^Fds, Gg^Qhhf, Gs^Fds, Gs^Fds, Gg^Fms, Gg^Fms, Gg^Fms, Gg^Qhhf
Gs^Fds, Gs^Fds, Gs^Fds, Gg^Fms, Gs^Fds, Gs^Fds, Gs^Fds, Gs^Fds, Gg^Fms, Gg^Fms, Re, Gg^Fms, Dd, Gg^Fms, Gg^Fms, Gg^Fms, Gg^Fms, Gg^Fms, Gg^Fms, Gg^Fms, Gg^Fms, Wwt, Wwt, Wot, Wot, Wot, Wwt, Wwt, Wwt, Wwt, Gg^Qhh, Gg^Qhh, Gg^Qhh, Gg^Qhh, Gg^Qhh, Gg^Qhhf, Gg^Qhhf, Gs^Fds, Gg^Qhhf, Gg^Qhhf, Gs^Fds, Gs^Fds, Gg^Fms, Gg^Fms, Gg^Fms, Gg^Qhhf
