Gs^Qhhf, Gs^Qhhf, Gs^Qhhf, Gs^Qhhf, Gs^Qhhf, Gs^Qhhf, Gs^Qhhf, Gs^Qhhf, Gs^Qhhf, Gs^Qhhf, Gg, Gg, Gg, Gs^Fdf, Gg^Fmf, Gs^Fdf, Gs^Fdf, Gg, Gg^Fmf, Gg, Gg, Gg, Gs, Gg, Gs, Gg, Ce, Gg, Re, Gg, Re, Gg, Gs, Wwt, Wwt, Gg, Gg, Gs^Fdf, Rrd, Gg^Fmf, Rrd, Wwf, Rrd, Dd^Fdf, Rrd^Fdw, Gg^Efm
Gs^Qhhf, Gs^Fmf, Gd^Fmf, Gd^Fmf, Gd^Fmf, Gd^Fdf, Gd, Gs^Fdf, Gs^Qhhf, Gs^Qhhf, Gg, Gg, Gg^Efm, Gg^Fmf, Gg, Gs^Fdf, Gg, Gs^Fdf, Gll^Fdf, Gg^Fmf, Gll^Fmf, Gs^Fdf, Gs^Fdf, Gs, Re^Vct, Re^Vct, Ce^Edt, 3 Ke, Gs, Re^Ecf, Ce^Edt, Ce, Gs^Fdf, Gg, Gs, Wwt, Wwt, Gg, Gs^Fdf, Rrd^Fdw, Rrd, Wwf, Gg, Rrd, Gd^Fdf, Dd
Gs^Qhhf, Gs^Fdf, Gd^Fdf, Gs^Fmf, Gs^Qhhf, Gs^Qhhf, Gs^Qhhf, Gd^Qhhf, Gd, Gd, Gs^Efm, Gg, Gs, Gg^Efm, Gg, Gg, Gs^Fdf, Gll, Gs^Fdf, Gll^Fmf, Gll^Fdf, Gs^Fdf, Gs, Gs, Gs^Efm, Re^Edt, Gs^Edt, Ce^Edt, Re^Es, Re, Gs, Ce, Gg, Gs^Fdf, Gs^Fdf, Gs^Fdf, Gs^Fdf, Wwt, Gs^Fdf, Gs^Fdf, Wwt, Wwt, Dd^Fdw, Gd^Fdf, Rrd^Fdw, Gs
Gg^Qhh, Gd, Gs^Fdf, Gs^_mh, Gs^Qhhf, Gg, Gd, Gd^Fdf, Gs, Gs^Efm, Gs^Fmf, Gs, Gs^Fdf, Gs^Fdf, Gs^Fdf, Gg, Gg, Gs^Fdf, Gg, Gs^Fdf, Gs, Gs, Gg^Fmf, Gg^Efm, Gs, Gs, Gs, Gs, Gs, Ce, Gg, Gs^Fdf, Gs^Fdf, Gs^Fdf, Gs^Fdf, Gs^Fdf, Gs^Fdf, Wwt, Wwt, Wwt, Wwf, Gg, Dd, Rrd^Fdw, Rrd, Dd
Gs^Qhh, Gs^Fdf, Gs^Qhhf, Gs^Qhhf, Gg^Fmf, Gd, Gd^Es, Gs, Gs, Gs^Fdf, Gs^Fdf, Gg^Fmf, Gll^Fmf, Gs^Fdf, Gs^Fdf, Gs, Gs^Efm, Gg, Gs^Es, Gs, Gs^Fmf, Gs^Fmf, Gs^Fmf, Gg^Fmf, Gd^Fmf, Gs^Fmf, Gd^Fmf, Gs^Fmf, Gg, Gs, Gg, Gs, Gs, Gs, Gs^Fdf, Gs^Fdf, Gs^Fdf, Gs^Fmf, Gg, Wwt, Dd, Gs^Fdf, Gs, Rrd, Rrd, Rrd
Gs^Qhhf, Gd^Qhhf, Gd, Gd^Fmf, Gd, Gd, Gs, Gs, Gg^Fmf, Gs^Fmf, Gll^Fmf, Gll^Fmf, Gg^Fmf, Gg^Fmf, Gs^Fdf, Gg, Gs^Fdf, Gs^Efm, Gg^Efm, Gg^Fmf, Gll^Fmf, Gs^Fmf, Gd, Gd^Fmf, Gll^Fmf, Gd^Fmf, Gll^Fmf, Gd^Fmf, Gd^Fmf, Gs^Fdf, Gs^Fdf, Gs, Gs^Fdf, Gs, Gs, Gd^Fdf, Gs^Fdf, Gs^Fdf, Gs^Fdf, Wwt, Gg, Dd^Fdw, Dd, Gs, Rrd^Fdw, Dd
Gs, Gg, Gs, Gd, Gg, Gg, Gs, Gs^Fdf, Gg^Fmf, Gg^Fmf, Gg^Fmf, Gg^Fmf, Gs^Fdf, Gs^Fdf, Gs^Fdf, Gd^Fdf, Gd^Fdf, Gd, Gs, Gs, Gll^Fmf, Gll^Fmf, Gd^Fmf, Gd^Fmf, Gll^Fmf, Gd^Fmf, Gll^Fmf, Gs^Fmf, Gs^Fdf, Gs^Fdf, Gd^Fdf, Gd^Fdf, Gd, Gs, Gs^Fdf, Gd^Fdf, Gd^Efm, Gs^Fdf, Gs^Fdf, Wwt, Wwt, Gs, Gd^Fmf, Gs, Rrd, Rrd^Fdw
Gs, Gs, Gs, Gg, Gs^Efm, Gs^Efm, Gs, Gs, Gs^Fdf, Gg^Fmf, Gg^Fdf, Gg^Fdf, Gg, Gs^Fdf, Gs, Gs^Fdf, Gs, Gg, Gs^Fmf, Gs^Fmf, Gd^Fmf, Gd^Fmf, Gd^Fdf, Gd^Fdf, Gd^Fmf, Gd^Fmf, Gs^Fdf, Gs^Fdf, Gs^Fdf, Gg, Gll^Fdf, Gs^Fdf, Gll^Fdf, Gg, Gs, Gg, Gs, Gg^Fdf, Gs^Fdf, Wwt, Wwf, Gd^Fmf, Gd^Fdf, Gd, Gs, Dd
Gg, Gg^Efm, Gs^Efm, Gs^Efm, Gs, Gs, Gg^Fdf, Gg^Fdf, Gg^Fdf, Gg^Fdf, Gs, Gg, Gg^Efm, Gs, Gs^Efm, Gs, Gg, Gs^Efm, Gg, Gg^Fmf, Gg, Gg^Fmf, Gg^Fmf, Gll^Fmf, Gs^Fdf, Gs^Fdf, Gs^Fdf, Gs^Fdf, Gs^Ve, Gs^Fdf, Re, Gll^Fdf, Gll^Fdf, Gll, Gs, Gs, Gg^Fmf, Gg, Re, Gg^Fmf, Re, Wwf, Gs, Gs, Gs^Fdf, Gs
Gs, Gs, Gs, Gg^Efm, Gs, Gs, Gg, Gs^Fdf, Gs, Gs, Gs^Efm, Gs^Efm, Gs, Gs, Gs^Fdf, Gg, Gs^Fdf, Gs^Fdf, Gs^Fdf, Gg, Gg, Gg, Gs^Fdf, Gs^Fdf, Gg, Gg, Re, Gg, Gs^Fdf, Re, Gs^Fdf, Re, Rb^Qhh, Gg, Rb, Gg^Es, Gg, Re, Gs^Fmf, Gg, Gg^Fmf, Wwt, Wwf, Dd, Dd, Gg
Gg, Gs, Gd, Gd, Gd, Gd, Gd, Gg, Gd, Gg, Gg^Efm, Gg^Efm, Gg^Ve, Gs^Fdf, Gs^Fdf, Gs^Fdf, Gs^Fdf, Gs^Fdf, Gg^Efm, Gg, Gg, Gg, Gg, Gg, Rb, Rb, Gs, Gs, Hh^Qhhf, Gs^Fdf, Hh, Re, Gs, Re^Qhh, Gs^Qhh, Re, Gg, Gs, Gs^Fmf, Gs^Fmf, Gg^Ve, Wwt, Rrd, Rrd, Dd, Dd
Gg, Gs^Fdf, Gd^Fdf, Gd^Fdf, Gs^Fdf, Gd^Fdf, Gs^Fdf, Gd^Fdf, Gd^Fdf, Gd, Gd, Gg, Gs^Fdf, Gs^Fdf, Gs^Fdf, Gs^Fdf, Gg, Gg, Gg^Efm, Gg^Efm, Gg^Efm, Gg^Efm, Re, Re, Gg, Gg, Hh^Qhh, Hh^Qhh, Hh, Hh^Qhh, Hh^Qhh, Hh, Hh^Qhh, Gs, Gs^Qhhf, Gd^Fmf, Gd^Qhhf, Gd^Qhhf, Gg^Qhhf, Gs^Qhhf, Gs^Qhhf, Wwt, Wwt, Dd, Dd^Fdw, Dd
Gd^Fdf, Gg, Gd^Fdf, Gs^Fdf, Gs^Fdf, Gs^Fdf, Gg^Fmf, Gg^Fmf, Gg^Fmf, Gd^Fmf, Gd^Fmf, Gs^Fdf, Gs^Fdf, Gs^Fdf, Gs^Fdf, Gs^Fdf, Gg^Fmf, Gs^Fdf, Gg, Gg^Efm, Gg, Gg, Re, Gg, Gg, Hh^Qhh, Hh^Qhhf, Hh^_mh, Hh, Hh, Hh, Hh^Qhh, Hh, Gs, Gs, Gd^Qhhf, Gd^Fmf, Gs, Gs^Fdf, Gg^Fmf, Gd^Fmf, Gg^Qhhf, Gg^Qhhf, Wwt, Wwt, Dd^Fdw
Gs^Fdf, Gd^Fdf, Gd^Fdf, Gd^Fdf, Gs^Fdf, Gg^Ve, Gd^Fmf, Gg^Fmf, Gd^Fdf, Gll^Fmf, Gll^Fdf, Gll^Fmf, Gg^Fmf, Gs^Fdf, Gg, Gs^Fdf, Gg^Fmf, Gg^Fmf, Gg^Efm, Gg^Efm, Gg, Gs^Ve, Gg, Gg, Gg, Gs, Hh^Qhhf, Hh^Fdf, Hh, Hh, Hh, Hh, Hh, Hh, Gd, Gd^Fmf, Gd, Gg^Fdf, Gs^Fmf, Gd^Fmf, Gg^Fmf, Gd^Fmf, Gg^Fdf, Gg^Qhhf, Wwt, Dd
Gs^Fdf, Gs^Fdf, Gs^Fdf, Gs, Gs^Fdf, Gs^Fdf, Gs^Fdf, Gd^Fdf, Gs^Fdf, Gll^Fmf, Gll^Fmf, Gd^Fdf, Gs^Fdf, Gg^Fmf, Gg^Fmf, Gs^Fdf, Gg^Fmf, Gg^Ve, Gg, Gg, Cv, Cv, Re, Re, Gg, Cv^Fet, Hh^Qhh, Hh^Fdf, Hh^Qhhf, Hh^Qhhf, Hh^Qhh, Hh^Qhh, Hh^Qhh, Hh, Hh^Fmf, Hh, Hh, Gs, Gs^Es, Gs, Gg^Fdf, Gs, Gg^Qhhf, Gg^Qhhf, Gg^Efm, Wwt
Gg^Fmf, Gs^Fdf, Gs^Fdf, Gs^Fdf, Gs^Fdf, Gs^Fdf, Gs, Gs, Gs^Fdf, Gs^Fdf, Gg^Fdf, Gd^Fdf, Gg^Fdf, Gg^Fdf, Gd^Fdf, Gg^Fmf, Gg^Fdf, Gg^Fdf, Gg, Gg^Ve, Gg, Kv, Gg, Rb, Gg^Efm, Hh^Qhh, Hh^Qhh, Hh^Qhhf, Ds, Ds, Ds, Dd, Hh^Qhh, Gg^Fmf, Hh^Qhhf, Hh, Hh, Gg^Fdf, Gd^Fdf, Gg^Fdf, Gd^Fdf, Gs, Gg, Gd^Qhhf, Gg^Qhhf, Wwt
Gs^Fdf, Gs^Fmf, Gs^Fmf, Gs^Fdf, Gs^Fdf, Gg, Gs^Fdf, Gs^Fdf, Gs, Gs, Gd^Fdf, Gd^Fdf, Gd, Gd^Fdf, Gg, Gs^Fdf, Gs, Gg, Gg, Gg, Gg, Cv^Fet, Gg, Gg, Gs^Ve, Gs^Efm, Hh^Qhh, Hh^Qhh, Hh^Qhh, Hh^Qhhf, Dd, Dd, Gs^Fdf, Hh^Qhhf, Gs, Hh^Qhh, Gg^Qhhf, Gd^Qhhf, Gg^Qhhf, Gd^Fdf, Gd^Fdf, Gd^Fdf, Gg^Fdf, Gd^Fdf, Gg^Qhh, Wwt
Gs, Gs, Gs, Gg, Gg, Gs^Fdf, Gs^Fdf, Gd^Fdf, Gd^Fdf, Gd^Fdf, Gg, Gs, Gs, Gs, Gs, Gs, Gg, Gg, Cv^Fet, Gg, Re, Gg, Re, Re, Gs, Gs^Efm, Cv^Fet, Hh^Qhh, Hh^Qhh, Hh^Qhhf, Gs^Fmf, Dd, Dd, Hh^Qhh, Gs^Fdf, Gg^Fdf, Gs, Gs, Hh^Qhhf, Gd^Fdf, Gg^Qhhf, Gg^Qhhf, Gg^Qhh, Gg^Qhhf, Hh^Qhh, Gg^Qhh
Gll^Fmf, Gs, Gg^Efm, Gg^Efm, Gg^Efm, Gs, Gs^Ve, Gg, Gs^Fdf, Gd^Fdf, Gs, Gs, Gg^Efm, Gs^Efm, Gg, Gg, Gg, Gg, Gg, Gg, Re, Rb, Re, Gg, Hh, Hh, Hh, Hh^Qhhf, Hh^Fdf, Gs^Fmf, Hh^Fdf, Dd, Dd, Gs^Fmf, Gs^Fdf, Gs^Fdf, Gs, Hh^Qhh, Hh^Qhh, Hh^Qhh, Rrd^Fdw, Rrd^Fdw, Hh, Hh, Hh, Hh^Qhh
Gs^Fdf, Gll^Fdf, Gll^Fdf, Gd^Fdf, Gd, Gs, Gs, Gs, Gs, Gs, Gs, Gg^Efm, Gg, Gg^Efm, Gg^Efm, Cv^Fet, Re, Gg, Re, Re, Gg, Re, Gg, Gg, Gg, Gg, Gs, Gs, Gg, Hh, Gg^Efm, Dd, Gs^Fmf, Gd^Fdf, Gg^Fdf, Rrd, Rrd, Gs, Gs, Rrd, Rrd, Rrd^Fdw, Re, Hh, Gg, Gg
Gll^Fdf, Gll^Fdf, Gg^Fmf, Gs^Fdf, Gg^Fmf, Gd^Fdf, Gd^Fdf, Gs, Gg, Gs, Gg^Efm, Gg^Efm, Cv^Fet, Gg, Gg, Rb, Rb, Re, Re, Re, Gg^Efm, Cv^Fet, Gg^Efm, Gg^Efm, Gg^Fmf, Gs, Gg, Gg^Es, Gg, Gg^Efm, Gs, Gs^Efm, Gs^Efm, Gs^Fdf, Rrd, Rrd^Fdw, Gs, Rrd^Fdw, Gg^Es, Gg, Ce^Edt, Rb, Rb^Vct, Ce, 4 Ke, Ce^Edt
Gd^Fdf, Gd^Fdf, Gll^Fmf, Gll^Fmf, Gd^Fmf, Gs^Fdf, Gd, Gg, Gg, Gg^Efm, Gg, Gg^Efm, Gg, Re, Re, Re, Gg, Gg, Cv^Fet, Gg, Gg^Efm, Gg^Efm, Gg, Gd^Fmf, Gs^Fmf, Gg, Gg, Gs^Efm, Gs^Efm, Gd^Fmf, Gs^Fdf, Gs, Gs, Gs, Gs, Rrd, Gs^Edt, Gs, Rb, Gg, Ds, Ds, Gg, Ce, Ds, Dd^Edt
Gd^Fdf, Gg^Fmf, Gd^Fmf, Gg^Fmf, Gd, Gd, Gs^Fdf, Gg, Gs^Fdf, Gs^Fdf, Gg, Gg, Rb, Re, Gg, Gg, Gg, Gg, Gg, Gg^Efm, Gs, Gg^Efm, Gs, Gs^Fmf, Gs^Fmf, Gs^Ve, Gs, Gs^Efm, Hh, Gs^Fmf, Rrd^Fdf, Rrd, Rrd^Fdw, Gs, Gs, Gs^Edt, Ce^Edt, Ce, Dd, Re^Vct, Dd^Edt, Ds, Wwt^Ewl, Wwt, Wwt, Wwt^Edt
Gg, Gd^Fdf, Gs, Gd, Gs, Gd^Fdf, Gg^Fmf, Gg, Gg, Gg, Rb, Rb, Gg, Rb, Gg, Cv^Fet, Gg, Gg^Es, Gg, Gs, Gg^Fmf, Gs, Gs^Fdf, Gs^Fdf, Gs, Gs^Fmf, Hh^Fmf, Hh, Hh^Fdf, Gs, Rrd, Rrd, Gg, Gg^Es, Ds, Ds, Ce, 5 Ke, Dd, Dd^Edt, Wwt, Wwt, Wwt, Wwt, Wot, Wwt
Gs, Gs, Dd, Dd, Dd, Gg^Fmf, Dd, Gg, Gs^Fdf, Gg, Rb, Re, Gll^Fmf, Gs^Fdf, Gs^Fdf, Gg, Gs^Fdf, Gs^Fdf, Gs, Gs^Fdf, Hh^Fdf, Hh^Fdf, Hh^Fmf, Hh^Fmf, Hh^Fmf, Hh, Hh^Fmf, Hh^Fdf, Gs, Gs, Gs, Dd, Dd, Dd, Wwf, Ds, Wwf^Edt, Ds, Wwt, Wwt, Wwt, Wwt, Wot, Wot, Wot, Wot
Dd, Dd, Dd, Dd, Wwt, Wwt, Wwt, Wwt, Wwf, Wwf, Wwf, Re, Wwf, Gll^Fmf, Gd^Fdf, Gs^Fdf, Gs^Fmf, Gs^Fmf, Gs, Gs, Hh^Fmf, Gg^Fmf, Hh^Fmf, Hh^Fmf, Gg, Hh, Hh, Hh^Fmf, Gg, Gs, Dd, Dd, Wwt, Wwf, Wwt, Wwf, Wwt, Wwt, Wot, Wot, Wot, Wot, Wot, Wot, Wot, Wot
Wwt, Wwt, Wwt, Wwt, Wot, Wwt, Wwt, Wwt, Wwt, Wwf, Wwf, Wwt, Wwt, Wwt, Wwt, Wwt^Ewf, Wwt, Gll^Fmf, Dd, Gs, Gs, Hh^Fmf, Hh^Fmf, Hh^Fmf, Hh^Fmf, Hh, Dd, Gg, Wwt, Wwt, Wwt, Wwt, Wwt, Wwt, Wot, Wwt, Wot, Wot, Wot, Wot, Wot, Wot, Wot, Wot, Wot, Wot
Wwt, Wwt, Wwt, Wot, Wot, Wot, Wot, Wwt, Wwt, Wwt, Wwt, Wwt, Wwt, Wwt, Wot, Wwt, Wot, Wwt^Ewf, Wwt, Dd, Dd, Dd, Dd, Gg, Dd, Dd, Wwt, Wwt, Wot, Wwt, Wot, Wwt, Wot, Wot, Wot, Wot, Wot, Wot, Wot, Wot, Wot, Wot, Wot, Wot, Wot, Wot
Wot, Wwt, Wot, Wot, Wwt, Wot, Wwt, Wwt, Wwf, Wwt, Wwt, Wwt, Wwt, Wwt, Wwt, Wot, Wot, Wot, Wot, Wwt, Wwt, Wwt, Wwt, Wwt, Wwt, Wwt, Wwt, Wot, Wot, Wot, Wot, Wot, Wot, Wot, Wot, Wot, Wot, Wot, Wot, Wot, Wot, Wot, Wwt, Wwt, Wwt, Wwt
Wot, Wot, Wot, Wot, Wwt, Wwt, Wwt, Wwf, Wwf, Wwf, Wwf, Wwt, Wwt, Wwt, Wwt, Wwt, Wot, Wot, Wot, Wwt, Wot, Wwt, Wot, Wwt, Wot, Wwt, Wot, Wot, Wot, Wot, Wot, Wot, Wot, Wot, Wot, Wot, Wot, Wot, Wot, Wot, Wot, Wwt, Ds, Ds, Gg^Qhhf, Gg^Qhhf
Wot, Wot, Wwt, Wwt, Wwt, Wwt, Dd, Dd^Es, Dd^Es, Re, Rb, Wwf, Dd^Es, Wwt, Wwt, Wwt, Wwt, Wot, Wot, Wot, Wot, Wot, Wot, Wot, Wot, Wot, Wot, Wot, Wot, Wot, Wot, Wot, Wot, Wot, Wot, Wot, Wot, Wot, Gs^Qhh, Wot, Gs^Qhhf, Gs^Qhhf, Gs^Qhhf, Gg^Qhhf, Gg^Fmf, Gg^Qhhf
Wwt, Wwt, Gs^Fdf, Gg^Fmf, Gg^Fmf, Gg^Fmf, Gg^Fet, Dd^Es, Gg^Fmf, Re, Gg^Fmf, Gg^Fet, Dd, Dd, Dd, Wwt, Wwt, Wwt, Wwt, Wot, Wot, Wot, Wot, Wot, Wot, Wot, Wot, Wot, Wot, Wot, Wwt, Wwt, Wwt, Wwt, Wwt, Wot, Gg^Qhh, Gs^Qhh, Gg^_mh, Gg^Qhhf, Gs^Fdf, Gs^Fdf, Gs^_mh, Gg^Fmf, Gg^Fmf, Gg^Qhhf
