Aa^Qhhf, Aa^Qhhf, Aa^Qhhf, Aa^Qhhf, Gs^Qhhf, Gs^Qhhf, Gs^Qhhf, Gs^Qhhf, Gs^Qhhf, Gs^Qhhf, Aa, Aa, Aa, Gs^Fdf, Gg^Fmf, Gs^Fdf, Gs^Fdf, Gg, Gg^Fmf, Gg, Aa, Aa, Aa, Aa, Aa, Aa, Ce, Gg, Re, Gg, Re, Gg, Gs, Wwt, Wwt, Gg, Gg, Gs^Fdf, Rrd, Gg^Fmf, Rrd, Wwf, Rrd, Dd^Fdf, Rrd^Fdw, Gg^Efm
Aa^Qhhf, Aa^Fma, Aa^Fma, Aa^Fma, Aa^Fmw, Aa^Fdw, Aa, Gs^Fdw, Gs^Qhhf, Gs^Qhhf, Aa, Aa, Aa, Aa^Fmw, Aa, Aa^Fda, Aa, Gs^Fdw, Gll^Fdw, Gg^Fmf, Gll^Fmf, Gs^Fdw, Gs^Fdw, Aa, Aa^Vct, Aa^Vct, Ce^Edt, 3 Ke, Gs, Re^Ecf, Ce^Edt, Ce, Gs^Fdf, Gg, Gs, Wwt, Wwt, Gg, Gs^Fdf, Rrd^Fdw, Rrd, Wwf, Gg, Rrd, Gd^Fdf, Dd
Aa^Qhhf, Aa^Fma, Aa^Fdw, Aa^Fmw, Gs^Qhhf, Gs^Qhhf, Aa^Qhhf, Aa^Qhhf, Gd, Gd, Gs^Efm, Gg, Gs, Aa, Gg, Aa, Gs^Fdf, Gg, Gs^Fdw, Gll^Fmf, Gll^Fdf, Gs^Fdf, Gs, Gs, Gs^Efm, Re^Edt, Gs^Edt, Ce^Edt, Re^Es, Re, Gs, Ce, Gg, Gs^Fdf, Aa^Fda, Aa^Fda, Aa^Fda, Wwt, Gs^Fdf, Gs^Fdf, Wwt, Wwt, Dd^Fdw, Gd^Fdf, Rrd^Fdw, Gs
Aa^Qhh, Aa, Gs^Fdw, Gs^_mh, Aa^Qhhf, Gg, Gd, Aa^Fma, Gs, Gs^Efm, Gs^Fmf, Gs, Gs^Fdf, Gs^Fdf, Gs^Fdw, Gs, Gg, Gs^Fdw, Gg, Gs^Fdf, Gs, Gs, Gg^Fmf, Gg^Efm, Gs, Gs, Gs, Gs, Gs, Ce, Gg, Gs^Fdf, Gs^Fdf, Gs^Fdf, Aa^Fma, Aa^Fda, Gs^Fdf, Wwt, Wwt, Wwt, Wwf, Gg, Dd, Rrd^Fdw, Rrd, Dd
Aa^Qhh, Aa^Fma, Aa^Qhhf, Gs^Qhhf, Aa^Fma, Gd, Gd^Es, Gs, Gs, Gs^Fdf, Gs^Fdf, Gg^Fmf, Gll^Fmw, Gs^Fdw, Gs^Fdw, Gs, Gs^Efm, Gg, Gs^Es, Gs, Gs^Fmw, Gs^Fmw, Gs^Fmw, Gg^Fmw, Gd^Fmw, Gs^Fmf, Gd^Fmw, Gs^Fmf, Gg, Gs, Gg, Gs, Gs, Gs, Gs^Fdf, Aa^Fma, Aa^Fdf, Aa^Fma, Aa, Wwt, Dd, Gs^Fdf, Gs, Rrd, Rrd, Rrd
Gs^Qhhf, Aa^Qhhf, Aa, Aa^Fma, Aa, Aa, Aa, Gs, Gg^Fmf, Gs^Fmw, Gll^Fmw, Gll^Fmw, Aa^Fmw, Gg^Fmf, Gs^Fdf, Gg, Gs^Fdf, Gs^Efm, Gg^Efm, Gg^Fmw, Gll^Fmw, Gs^Fmw, Gd, Gd^Fmf, Gll^Fmw, Gd^Fmw, Gll^Fmw, Gd^Fmf, Gd^Fmw, Gs^Fdf, Gs^Fdf, Gs, Gs^Fdw, Gs, Gs, Gd^Fdw, Gs^Fdw, Aa^Fdf, Aa^Fda, Wwt, Gg, Dd^Fdw, Dd, Gs, Rrd^Fdw, Dd
Gs, Gg, Gs, Aa, Gg, Aa, Gs, Gs^Fdf, Gg^Fmf, Gg^Fmw, Aa^Fma, Aa^Fma, Aa^Fma, Aa^Fda, Aa^Fda, Aa^Fdw, Gd^Fdf, Gd, Gs, Gs, Gll^Fmw, Gll^Fmw, Gd^Fmw, Gd^Fmf, Gll^Fmw, Gd^Fmw, Gll^Fmw, Gs^Fmw, Gs^Fdw, Gs^Fdf, Gd^Fdf, Gd^Fdw, Gd, Gs, Gs^Fdf, Gd^Fdf, Gd^Efm, Aa^Fma, Gs^Fdw, Wwt, Wwt, Gs, Gd^Fmf, Gs, Rrd, Rrd^Fdw
Gs, Gs, Gs, Gg, Gs^Efm, Gs^Efm, Gs, Gs, Gs^Fdw, Aa^Fma, Aa^Fma, Aa^Fma, Aa, Aa^Fda, Aa, Aa^Fda, Aa, Gg, Gs^Fmf, Gs^Fmf, Gd^Fmw, Gd^Fmw, Gd^Fdf, Gd^Fdw, Gd^Fmf, Gd^Fmf, Gs^Fdw, Gs^Fdw, Gs^Fdf, Gg, Gll^Fdf, Gs^Fdw, Gll^Fdw, Gg, Gs, Gg, Gs, Gg^Fdw, Gs^Fdf, Wwt, Wwf, Gd^Fmf, Gd^Fdf, Gd, Gs, Dd
Gg, Gg^Efm, Gs^Efm, Gs^Efm, Gs, Gs, Gg^Fdf, Gg^Fdw, Aa^Fda, Aa^Fma, Gs, Aa, Gg^Efm, Aa, Aa, Aa, Aa, Aa^Efm, Gg, Gg^Fmf, Gg, Gg^Fmf, Gg^Fmf, Gll^Fmf, Gs^Fdw, Gs^Fdw, Gs^Fdf, Gs^Fdf, Gs^Ve, Gs^Fdf, Re, Gll^Fdw, Gll^Fdf, Gll, Gs, Gs, Gg^Fmf, Gg, Re, Gg^Fmf, Re, Wwf, Gs, Gs, Gs^Fdf, Gs
Gs, Gs, Gs, Gg^Efm, Gs, Gs, Gg, Gs^Fdf, Gs, Gs, Gs^Efm, Gs^Efm, Gs, Gs, Gs^Fdf, Gg, Gs^Fdw, Gs^Fdw, Gs^Fdf, Gg, Gg, Gg, Gs^Fdw, Gs^Fdw, Gg, Gg, Re, Gg, Gs^Fdf, Re, Gs^Fdf, Re, Rb^Qhh, Gg, Rb, Gg^Es, Gg, Re, Gs^Fmf, Gg, Gg^Fmf, Wwt, Wwf, Dd, Dd, Gg
Gg, Gs, Gd, Gd, Gd, Gd, Gd, Gg, Gd, Gg, Gg^Efm, Gg^Efm, Gg^Ve, Gs^Fdf, Gs^Fdf, Gs^Fdw, Gs^Fdw, Gs^Fdw, Gg^Efm, Gg, Gg, Gg, Gg, Gg, Rb, Rb, Gs, Gs, Hh^Qhhf, Gs^Fdf, Hh, Re, Gs, Re^Qhh, Gs^Qhh, Re, Gg, Gs, Gs^Fmf, Gs^Fmf, Gg^Ve, Wwt, Rrd, Rrd, Dd, Dd
Gg, Gs^Fdf, Gd^Fdf, Gd^Fdf, Gs^Fdw, Gs^Fdw, Gs^Fdw, Gs^Fdw, Gd^Fdf, Gd, Gd, Gg, Gs^Fdf, Gs^Fdf, Gs^Fdw, Gs^Fdw, Gg, Gg, Gg^Efm, Gg^Efm, Gg^Efm, Gg^Efm, Re, Re, Gg, Gg, Hh^Qhh, Hh^Qhh, Hh, Hh^Qhh, Hh^Qhh, Hh, Hh^Qhh, Gs, Gs^Qhhf, Gd^Fmf, Gd^Qhhf, Gd^Qhhf, Gg^Qhhf, Gs^Qhhf, Gs^Qhhf, Wwt, Wwt, Dd, Dd^Fdw, Dd
Gs^Fdw, Gg, Gd^Fdf, Gs^Fdw, Gs^Fdf, Gs^Fdw, Gg^Fmw, Gg^Fmw, Gg^Fmw, Gd^Fmw, Gd^Fmw, Gs^Fdf, Gs^Fdw, Gs^Fdw, Gs^Fdf, Gs^Fdw, Gg^Fmf, Gs^Fdf, Gg, Gg^Efm, Gg, Gg, Re, Gg, Gg, Hh^Qhh, Hh^Qhhf, Hh^_mh, Hh, Hh, Hh, Hh^Qhh, Hh, Gs, Gs, Gd^Qhhf, Gd^Fmw, Gs, Gs^Fdw, Gg^Fmw, Gd^Fmw, Gg^Qhhf, Gg^Qhhf, Wwt, Wwt, Dd^Fdw
Gs^Fdw, Gs^Fdw, Gs^Fdw, Gs^Fdw, Gs^Fdf, Gg^Ve, Gd^Fmf, Gg^Fmw, Gd^Fdw, Gll^Fmw, Gll^Fdf, Gll^Fmw, Gg^Fmw, Gs^Fdw, Gg, Gs^Fdw, Gg^Fmf, Gg^Fmf, Gg^Efm, Gg^Efm, Gg, Gs^Ve, Gg, Gg, Gg, Gs, Hh^Qhhf, Hh^Fdf, Hh, Hh, Hh, Hh, Hh, Hh, Gd, Gd^Fmf, Gd, Gg^Fdw, Gs^Fmf, Gd^Fmw, Gg^Fmf, Gd^Fmf, Gg^Fdf, Gg^Qhhf, Wwt, Dd
Gs^Fdf, Gs^Fdw, Gs^Fdw, Gs, Gs^Fdf, Gs^Fdf, Gs^Fdf, Gd^Fdw, Gs^Fdw, Gll^Fmw, Gll^Fmf, Gd^Fdf, Gs^Fdw, Gg^Fmw, Gg^Fmw, Gs^Fdf, Gg^Fmf, Gg^Ve, Gg, Gg, Cv, Cv, Re, Re, Gg, Cv^Fet, Hh^Qhh, Hh^Fdf, Hh^Qhhf, Hh^Qhhf, Hh^Qhh, Hh^Qhh, Hh^Qhh, Hh, Hh^Fmf, Hh, Hh, Gs, Gs^Es, Gs, Gg^Fdf, Gs, Gg^Qhhf, Gg^Qhhf, Gg^Efm, Wwt
Gg^Fmf, Gs^Fdf, Gs^Fdf, Gs^Fdw, Gs^Fdf, Gs^Fdf, Gs, Gs, Gs^Fdw, Gs^Fdw, Gg^Fdf, Gd^Fdw, Gg^Fdf, Gg^Fdw, Gd^Fdw, Gg^Fmf, Gg^Fdw, Gg^Fdf, Gg, Gg^Ve, Gg, Kv, Gg, Rb, Gg^Efm, Hh^Qhh, Hh^Qhh, Hh^Qhhf, Ds, Ds, Ds, Dd, Hh^Qhh, Gg^Fmw, Hh^Qhhf, Hh, Hh, Gg^Fdf, Gd^Fdw, Gg^Fdw, Gd^Fdw, Gs, Gg, Gd^Qhhf, Gg^Qhhf, Wwt
Gs^Fdf, Gs^Fmf, Gs^Fmf, Gs^Fdf, Gs^Fdf, Gg, Gs^Fdw, Gs^Fdw, Gs, Gs^Fdw, Gs^Fdw, Gs^Fdw, Gd, Gd^Fdw, Gg, Gs^Fdf, Gs, Gg, Gg, Gg, Gg, Cv^Fet, Gg, Gg, Gs^Ve, Gs^Efm, Hh^Qhh, Hh^Qhh, Hh^Qhh, Hh^Qhhf, Dd, Dd, Gs^Fdf, Hh^Qhhf, Gs, Hh^Qhh, Gg^Qhhf, Gd^Qhhf, Gg^Qhhf, Gd^Fdw, Gd^Fdw, Gd^Fdw, Gg^Fdf, Gd^Fdw, Gg^Qhh, Wwt
Gs, Gs, Gs, Gg, Gg, Gs^Fdf, Gs^Fdf, Gd^Fdf, Gd^Fdf, Gd^Fdf, Gg, Gs, Gs, Gs, Gs, Gs, Gg, Gg, Cv^Fet, Gg, Re, Gg, Re, Re, Gs, Gs^Efm, Cv^Fet, Hh^Qhh, Hh^Qhh, Hh^Qhhf, Gs^Fmf, Dd, Dd, Hh^Qhh, Gs^Fdf, Gg^Fdf, Gs, Gs, Hh^Qhhf, Gd^Fdf, Gg^Qhhf, Gg^Qhhf, Gg^Qhh, Gg^Qhhf, Hh^Qhh, Gg^Qhh
Gll^Fmf, Gs, Gg^Efm, Gg^Efm, Gg^Efm, Gs, Gs^Ve, Gg, Gs^Fdw, Gd^Fdf, Gs, Aa, Gg^Efm, Gs^Efm, Gg, Gg, Gg, Gg, Gg, Gg, Re, Rb, Re, Gg, Hh, Hh, Hh, Hh^Fdw, Hh^Fdw, Gs^Fmf, Hh^Fdf, Dd, Dd, Gs^Fmf, Gs^Fdw, Gs^Fdw, Gs, Hh^Qhh, Hh^Qhh, Hh^Qhh, Rrd^Fdw, Rrd^Fdw, Hh, Hh, Hh, Hh^Qhh
Gs^Fdf, Gll^Fdf, Gll^Fdw, Gd^Fdf, Gd, Gs, Gs, Gs, Aa, Aa, Aa, Gg^Efm, Gg, Gg^Efm, Gg^Efm, Cv^Fet, Re, Gg, Re, Re, Gg, Re, Gg, Gg, Gg, Aa, Aa, Aa, Aa, Hh, Gg^Efm, Dd, Gs^Fmf, Gd^Fdw, Gg^Fdw, Rrd, Rrd, Gs, Gs, Rrd, Rrd, Rrd^Fdw, Re, Hh, Gg, Gg
Gll^Fdw, Gll^Fdf, Gg^Fmf, Gs^Fdw, Gg^Fmw, Gd^Fdf, Gd^Fdf, Gs, Aa, Aa, Gg^Efm, Gg^Efm, Cv^Fet, Gg, Gg, Rb, Rb, Re, Re, Re, Gg^Efm, Cv^Fet, Gg^Efm, Gg^Efm, Gg^Fmf, Gs, Gg, Aa^Es, Gg, Gg^Efm, Gs, Gs^Efm, Gs^Efm, Gs^Fdf, Rrd, Rrd^Fdw, Gs, Rrd^Fdw, Gg^Es, Gg, Ce^Edt, Rb, Rb^Vct, Ce, 4 Ke, Ce^Edt
Gd^Fdf, Gd^Fdf, Gll^Fmw, Gll^Fmw, Gd^Fmf, Gs^Fdw, Gd, Aa, Aa, Aa, Gg, Gg^Efm, Gg, Re, Re, Re, Gg, Gg, Cv^Fet, Gg, Gg^Efm, Gg^Efm, Gg, Gd^Fmw, Gs^Fmw, Gg, Gg, Gs^Efm, Gs^Efm, Gd^Fmf, Gs^Fdw, Gs, Gs, Gs, Gs, Rrd, Gs^Edt, Gs, Rb, Gg, Ds, Ds, Gg, Ce, Ds, Dd^Edt
Gd^Fdw, Gg^Fmf, Gd^Fmw, Gg^Fmw, Gd, Gd, Gs^Fdf, Gg, Gs^Fdw, Gs^Fdw, Gg, Gg, Rb, Re, Gg, Gg, Gg, Gg, Gg, Gg^Efm, Gs, Gg^Efm, Gs, Gs^Fmw, Gs^Fmw, Gs^Ve, Gs, Gs^Efm, Hh, Gs^Fmf, Rrd^Fdw, Rrd, Rrd^Fdw, Gs, Gs, Gs^Edt, Ce^Edt, Ce, Dd, Re^Vct, Dd^Edt, Ds, Wwt^Ewl, Wwt, Wwt, Wwt^Edt
Gg, Gd^Fdf, Gs, Gd, Gs, Gd^Fdw, Gg^Fmw, Gg, Gg, Gg, Rb, Rb, Gg, Rb, Gg, Cv^Fet, Gg, Gg^Es, Gg, Gs, Gg^Fmf, Gs, Gs^Fdw, Gs^Fdw, Gs, Gs^Fmf, Hh^Fmw, Hh, Hh^Fdf, Gs, Rrd, Rrd, Gg, Gg^Es, Ds, Ds, Ce, 5 Ke, Dd, Dd^Edt, Wwt, Wwt, Wwt, Wwt, Wot, Wwt
Gs, Gs, Dd, Dd, Dd, Gg^Fmw, Dd, Gg, Gs^Fdf, Gg, Rb, Re, Gll^Fmf, Gs^Fdf, Gs^Fdw, Gg, Gs^Fdw, Gs^Fdw, Gs, Gs^Fdf, Hh^Fdf, Hh^Fdf, Hh^Fmw, Hh^Fmf, Hh^Fmf, Hh, Hh^Fmw, Hh^Fdf, Gs, Gs, Gs, Dd, Dd, Dd, Wwf, Ds, Wwf^Edt, Ds, Wwt, Wwt, Wwt, Wwt, Wot, Wot, Wot, Wot
Dd, Dd, Dd, Dd, Wwt, Wwt, Wwt, Wwt, Wwf, Wwf, Wwf, Re, Wwf, Gll^Fmf, Gd^Fdf, Gs^Fdf, Gs^Fmf, Gs^Fmf, Gs, Gs, Hh^Fmw, Gg^Fmw, Hh^Fmw, Hh^Fmf, Gg, Hh, Hh, Hh^Fmw, Gg, Gs, Dd, Dd, Wwt, Wwf, Wwt, Wwf, Wwt, Wwt, Wot, Wot, Wot, Wot, Wot, Wot, Wot, Wot
Wwt, Wwt, Wwt, Wwt, Wot, Wwt, Wwt, Wwt, Wwt, Wwf, Wwf, Wwt, Wwt, Wwt, Wwt, Wwt^Ewf, Wwt, Gll^Fmf, Dd, Gs, Gs, Hh^Fmf, Hh^Fmf, Hh^Fmf, Hh^Fmf, Hh, Dd, Gg, Wwt, Wwt, Wwt, Wwt, Wwt, Wwt, Wot, Wwt, Wot, Wot, Wot, Wot, Wot, Wot, Wot, Wot, Wot, Wot
Wwt, Wwt, Wwt, Wot, Wot, Wot, Wot, Wwt, Wwt, Wwt, Wwt, Wwt, Wwt, Wwt, Wot, Wwt, Wot, Wwt^Ewf, Wwt, Dd, Dd, Dd, Dd, Gg, Dd, Dd, Wwt, Wwt, Wot, Wwt, Wot, Wwt, Wot, Wot, Wot, Wot, Wot, Wot, Wot, Wot, Wot, Wot, Wot, Wot, Wot, Wot
Wot, Wwt, Wot, Wot, Wwt, Wot, Wwt, Wwt, Wwf, Wwt, Wwt, Wwt, Wwt, Wwt, Wwt, Wot, Wot, Wot, Wot, Wwt, Wwt, Wwt, Wwt, Wwt, Wwt, Wwt, Wwt, Wot, Wot, Wot, Wot, Wot, Wot, Wot, Wot, Wot, Wot, Wot, Wot, Wot, Wot, Wot, Wwt, Wwt, Wwt, Wwt
Wot, Wot, Wot, Wot, Wwt, Wwt, Wwt, Wwf, Wwf, Wwf, Wwf, Wwt, Wwt, Wwt, Wwt, Wwt, Wot, Wot, Wot, Wwt, Wot, Wwt, Wot, Wwt, Wot, Wwt, Wot, Wot, Wot, Wot, Wot, Wot, Wot, Wot, Wot, Wot, Wot, Wot, Wot, Wot, Wot, Wwt, Ds, Ds, Gg^Qhhf, Gg^Qhhf
Wot, Wot, Wwt, Wwt, Wwt, Wwt, Dd, Dd^Es, Dd^Es, Re, Rb, Wwf, Dd^Es, Wwt, Wwt, Wwt, Wwt, Wot, Wot, Wot, Wot, Wot, Wot, Wot, Wot, Wot, Wot, Wot, Wot, Wot, Wot, Wot, Wot, Wot, Wot, Wot, Wot, Wot, Gs^Qhh, Wot, Gs^Qhhf, Gs^Qhhf, Gs^Qhhf, Gg^Qhhf, Gd^Fmf, Gg^Qhhf
Wwt, Wwt, Gs^Fdf, Gd^Fmf, Gd^Fmf, Gd^Fmf, Gg^Fet, Dd^Es, Gd^Fmf, Re, Gd^Fmf, Gg^Fet, Dd, Dd, Dd, Wwt, Dd, Wwt, Wwt, Wot, Wot, Wot, Wot, Wot, Wot, Wot, Wot, Wot, Wot, Wot, Wwt, Wwt, Wwt, Wwt, Wwt, Wwt, Gg^Qhhf, Gs^Qhh, Gg^_mh, Gg^Qhhf, Gs^Fdf, Gs^Fdf, Gs^_mh, Gd^Fmf, Gd^Fmf, Gg^Qhhf
Gs^Fdf, Gs^Fdf, Gs^Fdf, Gd^Fmf, Gs^Fdf, Gd^Fmf, Gs^Fdf, Gs^Fdf, Gd^Fmf, Re, Re, Gd^Fmf, Gd^Fmf, Gd^Fmf, Gs, Dd, Gs, Gs, Gd^Fmf, Dd, Wwt, Wwt, Wwt, Wot, Wot, Wot, Wot, Wot, Wot, Wot, Wwt, Wwt, Wwt, Wwt, Ds, Ds, Gg^Qhhf, Gg^Qhhf, Gs^Fdf, Gg^Qhhf, Gs^Fdf, Gs^Fdf, Gd^Fmf, Gd^Fmf, Gd^Fmf, Gg^Qhhf
Gs^Fdf, Gs^Fdf, Gs^Fdf, Gd^Fmf, Gs^Fdf, Gs^Fdf, Gs^Fdf, Gs^Fdf, Gd^Fmf, Gd^Fmf, Re, Gd^Fmf, Dd, Gd^Fmf, Gd^Fmf, Gd^Fmf, Gd^Fmf, Gd^Fmf, Gd^Fmf, Gd^Fmf, Gd^Fmf, Wwt, Wwt, Wot, Wot, Wot, Wwt, Wwt, Wwt, Wwt, Gg^Qhh, Gg^Qhh, Gg^Qhh, Gg^Qhh, Gg^Qhh, Gg^Qhhf, Gg^Qhhf, Gs^Fdf, Gg^Qhhf, Gg^Qhhf, Gs^Fdf, Gs^Fdf, Gd^Fmf, Gd^Fmf, Gd^Fmf, Gg^Qhhf
