Aa^Qhhf, Gs^Qhhf, Aa^Qhhf, Gs^Qhhf, Aa^Qhhf, Aa^Qhhf, Aa^Qhhf, Aa^Qhhf, Aa^Qhhf, Gs^Qhhf, Gg, Gg, Gg, Gll^Fmw, Gll^Fmw, Gs^Fds, Aa^Fda, Gg, Gd^Fmw, Gd, Gd, Gd, Gs, Gs, Gs, Gg, Ce, Gg, Re, Gg, Re, Gg, Gs, Wwt, Wwt, Gd, Gd, Gs^Fds, Rrd, Gg^Fms, Rrd, Wwf, Rrd, Dd^Fds, Rrd^Fdw, Gg^Efm
Aa^Qhhf, Aa^Fma, Aa^Fma, Aa^Fma, Gs^Fdw, Gs^Fdw, Aa, Aa^Fma, Aa^Qhhf, Aa^Qhhf, Aa, Aa, Aa, Gll^Fmw, Aa, Aa^Fda, Aa, Aa^Fda, Aa^Fda, Gd^Fmw, Gll^Fmw, Gs^Fdw, Gs^Fdw, Gs, Re^Vct, Re^Vct, Ce^Edt, 3 Ke, Gs, Re^Ecf, Ce^Edt, Ce, Gs^Fdw, Gg, Gs, Wwt, Wwt, Gs, Gs^Fmw, Rrd^Fdw, Rrd, Wwf, Gs, Rrd, Gd^Fdw, Dd
Aa^Qhhf, Aa^Fma, Gs^Fdw, Gs^Fdw, Gs^Qhhf, Gs^Qhhf, Gs^Qhhf, Gs^Qhhf, Gd, Aa, Aa, Aa, Gd, Aa, Aa, Aa, Aa^Fda, Aa, Aa^Fda, Gll^Fmw, Aa^Fda, Gs^Fdw, Aa, Gd, Gd, Re^Edt, Gs^Edt, Ce^Edt, Re^Es, Re, Gs, Ce, Gg, Gs^Fdw, Aa^Fda, Aa^Fda, Aa^Fda, Wwt, Gs^Fmw, Gs^Fmw, Wwt, Wwt, Dd^Fdw, Gs^Fdw, Rrd^Fdw, Gd
Gg^Qhh, Gs, Aa^Fda, Gs^_mh, Aa^Qhhf, Gd, Gd, Gd^Fdw, Gd, Aa, Aa^Fma, Aa, Aa^Fda, Aa^Fda, Aa^Fda, Aa, Aa, Aa^Fda, Aa, Aa^Fda, Aa, Aa, Aa^Fma, Aa^Efm, Gd, Gd, Gd, Gd, Gs, Ce, Gd, Gs^Fdw, Gs^Fdw, Gs^Fdw, Gs^Fdw, Aa^Fda, Aa^Fda, Wwt, Wwt, Wwt, Wwf, Gs, Dd, Rrd^Fdw, Rrd, Dd
Aa^Qhh, Aa^Fda, Aa^Qhhf, Aa^Qhhf, Aa^Fda, Aa, Aa^Es, Gd, Aa, Aa^Fdw, Gs^Fdw, Aa^Fma, Aa^Fma, Aa^Fda, Aa^Fda, Aa, Aa^Efm, Aa, Aa^Es, Aa, Aa^Fma, Aa^Fma, Gll^Fmw, Aa^Fma, Gll^Fmw, Aa^Fma, Aa^Fma, Aa^Fma, Gs, Gs, Gd, Gs, Gd, Gs, Aa^Fda, Gs^Fdw, Aa^Fda, Aa^Fma, Gg, Wwt, Dd, Gs^Fmw, Gs, Rrd, Rrd, Rrd
Aa^Qhhf, Aa^Qhhf, Gg, Aa^Fda, Gs, Aa, Gs, Aa, Gg^Fmw, Gs^Fmw, Aa^Fma, Aa^Fma, Aa^Fma, Aa^Fma, Gs^Fdw, Aa, Gs^Fdw, Aa^Efm, Aa^Efm, Aa^Fma, Aa^Fma, Aa^Fma, Aa, Aa^Fma, Aa^Fma, Aa^Fma, Aa^Fma, Gg^Fdw, Gs^Fmw, Gs^Fmw, Aa^Fdw, Gs, Aa^Fdw, Gs, Aa, Aa^Fda, Aa^Fda, Aa^Fda, Aa^Fda, Wwt, Gd, Dd^Fdw, Dd, Gs, Rrd^Fdw, Dd
Gs, Gg, Gs, Gs, Gs, Gs, Gs, Gs^Fdw, Gg^Fmw, Gg^Fmw, Aa^Fma, Aa^Fma, Gs^Fdw, Gs^Fdw, Gs^Fdw, Gs^Fdw, Gs^Fdw, Aa, Gs, Aa, Gll^Fmw, Aa^Fma, Aa^Fma, Aa^Fma, Aa^Fma, Aa^Fma, Aa^Fma, Aa^Fma, Aa^Fdw, Aa^Fdw, Aa^Fdw, Gs^Fdw, Gd, Aa, Gs^Fmw, Aa^Fda, Aa, Aa^Fda, Aa^Fda, Wwt, Wwt, Gd, Gd^Fmw, Gs, Rrd, Rrd^Fdw
Gs, Gs, Gd, Gs, Gd, Gd, Gd, Gs, Gs^Fdw, Aa^Fma, Gd^Fdw, Gd^Fdw, Gs, Gs^Fdw, Gs, Gs^Fdw, Gs, Gs, Gll^Fmw, Gs^Fmw, Gd^Fmw, Gll^Fmw, Gs^Fdw, Gd^Fdw, Gll^Fmw, Gd^Fdw, Gs^Fdw, Aa^Fdw, Gs^Fdw, Gg, Gll^Fdw, Gs^Fdw, Gd^Fdw, Gd, Gd, Gd, Gd, Aa^Fda, Aa^Fda, Wwt, Wwf, Gd^Fmw, Gs^Fmw, Gd, Gd, Dd
Gd, Gd, Gd, Gd, Gd, Gd, Gs^Fdw, Gs^Fdw, Gs^Fdw, Gs^Fdw, Gs, Gs, Gd, Gd, Gs, Gs, Gs, Gs, Gs, Gd^Fmw, Aa, Gd^Fmw, Aa^Fdw, Aa^Fdw, Aa^Fdw, Aa^Fdw, Gs^Fdw, Gs^Fdw, Gs^Ve, Gs^Fdw, Re, Gll^Fdw, Gll^Fdw, Gll, Gd, Gd, Gg^Fmw, Aa, Re, Gg^Fmw, Re, Wwf, Gs, Gd, Gs^Fmw, Gs
Gs, Gs, Gs, Gs, Gd, Gg, Gs, Gs^Fdw, Gs, Gs, Gd, Gd, Gs, Gd, Gs^Fdw, Gs, Gs^Fdw, Gs^Fdw, Gs^Fdw, Aa, Aa, Aa, Aa^Fdw, Aa^Fdw, Aa, Aa, Aa, Gs, Gs^Fdw, Re, Gs^Fdw, Re, Rb^Qhh, Gs, Rb, Gs^Es, Gs, Re, Gs^Fdw, Gs, Gs^Fdw, Wwt, Wwf, Dd, Dd, Gs
Gs, Gs, Aa, Gs, Gg, Gs, Gs, Gs, Gg, Gs, Gs, Gs, Gs^Ve, Gs^Fdw, Gs^Fdw, Gs^Fdw, Gs^Fdw, Gs^Fdw, Aa, Gd, Gs, Aa, Aa, Aa, Aa, Aa, Aa, Gs, Ha^Qhh, Gs^Fdw, Ha, Re, Gd, Gd^Qhh, Gd^Qhh, Gs, Gs, Gs, Aa^Fma, Gs^Fdw, Gs^Ve, Wwt, Rrd, Rrd, Dd, Dd
Aa, Aa^Fda, Aa^Fda, Aa^Fda, Aa^Fda, Gs^Fdw, Gs^Fdw, Gg^Fdw, Aa^Fdw, Gs, Aa, Gs, Gs^Fdw, Gs^Fdw, Gs^Fdw, Gs^Fdw, Gg, Gg, Aa, Aa, Aa, Aa, Re, Re, Gs, Aa, Hh^Qhh, Ha^Qhh, Ha, Ha^Qhh, Ha^Qhh, Ha, Ha^Qhh, Gd, Gg^Fdw, Gs^Fdw, Gd^Fdw, Gs^Fdw, Aa^Fda, Gs^Qhhf, Aa^Fda, Wwt, Wwt, Dd, Dd^Fdw, Dd
Aa^Fda, Aa, Aa^Fda, Aa^Fda, Gs^Fdw, Aa^Fda, Aa^Fma, Aa^Fma, Aa^Fma, Aa^Fma, Aa^Fma, Gs^Fdw, Gs^Fdw, Gs^Fdw, Gs^Fdw, Gs^Fdw, Gs^Fmw, Aa^Fda, Aa, Aa, Aa, Gd, Re, Gd, Gd, Hh^Qhh, Hh^Qhhf, Hh^_mh, Ha, Ha, Ha, Ha^Qhh, Ha, Gs, Gs, Gd^Fdw, Gd^Fdw, Aa, Gd^Fdw, Aa^Fma, Aa^Fma, Aa^Fda, Aa^Fda, Wwt, Wwt, Dd^Fdw
Gs^Fdw, Gs^Fdw, Gs^Fdw, Gs^Fdw, Gs^Fdw, Gg^Ve, Aa^Fma, Aa^Fma, Aa^Fda, Aa^Fma, Gll^Fdw, Aa^Fma, Aa^Fma, Aa^Fdw, Aa, Gs^Fdw, Gs^Fmw, Aa^Fda, Aa, Aa, Gs, Gs^Ve, Gs, Gs, Gs, Gs, Hh^Qhhf, Hh^Fdw, Hh, Ha, Hh, Hh, Ha, Ha, Gs, Gd^Fdw, Gs, Gd^Fdw, Aa^Fma, Aa^Fma, Aa^Fma, Aa^Fma, Gd^Fdw, Gd^Fmw, Wwt, Dd
Gs^Fdw, Gs^Fdw, Gs^Fdw, Gs, Aa^Fda, Aa^Fda, Aa^Fda, Aa^Fda, Gs^Fdw, Aa^Fma, Aa^Fma, Gll^Fdw, Gd^Fdw, Gs^Fmw, Gd^Fmw, Gd^Fdw, Gd^Fmw, Gg^Ve, Gd, Gs, Cv, Cv, Re, Re, Gs, Cv^Fet, Hh^Qhh, Hh^Fdw, Hh^Qhhf, Hh^Qhhf, Hh^Qhh, Hh^Qhh, Hh^Qhh, Ha, Hh^Fmw, Hh, Hh, Aa, Aa^Es, Aa, Aa^Fda, Gs, Gd^Fmw, Gd^Fmw, Gd, Wwt
Aa^Fma, Aa^Fda, Aa^Fda, Aa^Fda, Aa^Fda, Aa^Fda, Aa, Aa, Gll^Fdw, Gs^Fdw, Gd^Fdw, Gd^Fdw, Gd^Fdw, Gd^Fdw, Gd^Fdw, Gs^Fmw, Gs^Fdw, Gg^Fdw, Gd, Gg^Ve, Gd, Kv, Gs, Rb, Aa, Ha^Qhh, Ha^Qhh, Hh^Qhhf, Ds, Ds, Ds, Dd, Hh^Qhh, Gg^Fmw, Hh^Qhhf, Hh, Hh, Gd^Fdw, Aa^Fda, Aa^Fda, Aa^Fda, Gs, Gs, Gd^Fmw, Gd, Wwt
Aa^Fda, Aa^Fma, Aa^Fma, Aa^Fda, Gs^Fdw, Gg, Gs^Fdw, Gs^Fdw, Gs, Gd, Gg^Fdw, Gg^Fdw, Gs, Gd^Fdw, Gg, Gd^Fdw, Gs, Gd, Gg, Gs, Gs, Cv^Fet, Gd, Gd, Aa^Vea, Aa, Ha^Qhh, Ha^Qhh, Ha^Qhh, Hh^Qhhf, Dd, Dd, Gg^Fdw, Hh^Qhhf, Gs, Hh^Qhh, Gd^Qhhf, Aa^Qhhf, Aa^Qhhf, Aa^Fda, Aa^Fda, Aa^Fda, Gd^Fdw, Gd^Fdw, Gd^Qhh, Wwt
Gs, Aa, Gs, Gg, Gg, Gs^Fdw, Gs^Fdw, Gs^Fdw, Gs^Fdw, Gs^Fdw, Gg, Gs, Gs, Gs, Gd, Gd, Gd, Gs, Cv^Fet, Gd, Re, Gd, Gd, Re, Aa, Aa, Cv^Fet, Ha^Qhh, Ha^Qhh, Hh^Qhhf, Gg^Fmw, Dd, Dd, Hh^Qhh, Gd^Fdw, Gd^Fdw, Gd, Gd, Aa^Qhhf, Aa^Fda, Aa^Fdw, Aa^Fdw, Gs^Qhh, Gd^Fdw, Hh^Qhh, Gg^Qhh
Gll^Fmw, Gs, Gs, Gs, Gs, Gs, Gs^Ve, Gg, Gs^Fdw, Gs^Fdw, Gs, Gs, Aa, Gd, Aa, Gd, Gd, Gg, Gd, Gd, Re, Rb, Re, Gs, Hh, Hh, Hh, Hh^Qhhf, Hh^Fdw, Gg^Fmw, Hh^Fdw, Dd, Dd, Gd^Fmw, Rrd^Fdw, Gd^Fdw, Gs, Ha^Qhhf, Ha^Qhhf, Ha^Qhhf, Rrd^Fdw, Rrd^Fdw, Hh, Hh, Hh, Hh^Qhh
Aa^Fda, Aa^Fda, Aa^Fda, Gs^Fdw, Gs, Gs, Gs, Gs, Gs, Gs, Aa, Aa, Aa, Aa, Aa, Cv^Fet, Re, Gd, Re, Re, Gd, Re, Gd, Gd, Gs, Gs, Gs, Gs, Gs, Hh, Gd, Dd, Gs^Fmw, Gd^Fdw, Gs^Fdw, Rrd, Rrd, Gs, Gs, Rrd, Rrd, Rrd^Fdw, Re, Hh, Gs, Gg
Gll^Fdw, Aa^Fda, Aa^Fma, Gs^Fdw, Gg^Fmw, Gs^Fdw, Gs^Fdw, Gs, Gs, Aa, Aa, Aa, Cv^Fet, Aa, Gg, Rb, Rb, Re, Re, Re, Gd, Cv^Fet, Gd, Gs, Aa^Fma, Gs, Gd, Gs^Es, Gg, Gs, Gs, Gd, Aa, Gs^Fdw, Rrd, Rrd^Fdw, Gs, Rrd^Fdw, Gg^Es, Gd, Ce^Edt, Rb, Rb^Vct, Ce, 4 Ke, Ce^Edt
Aa^Fda, Aa^Fda, Aa^Fma, Aa^Fma, Gg^Fmw, Gs^Fdw, Gg, Gs, Aa, Aa, Aa, Aa, Gg, Re, Re, Re, Gd, Gs, Cv^Fet, Aa, Aa, Gd, Aa, Aa^Fma, Aa^Fma, Gd, Aa, Aa, Aa, Gs^Fmw, Gs^Fdw, Gs, Aa, Aa, Aa, Rrd, Gs^Edt, Gs, Rb, Gd, Ds, Ds, Gd, Ce, Ds, Dd^Edt
Aa^Fda, Aa^Fma, Aa^Fma, Aa^Fma, Gs, Gs, Gs^Fdw, Gs, Aa^Fda, Aa^Fda, Gg, Aa, Rb, Re, Gd, Gd, Gs, Gs, Gs, Aa, Aa, Aa, Aa, Aa^Fma, Aa^Fma, Aa^Vea, Aa, Aa, Hh, Gg^Fmw, Rrd^Fdw, Rrd, Rrd^Fdw, Gs, Gs, Gs^Edt, Ce^Edt, Ce, Dd, Re^Vct, Dd^Edt, Ds, Wwt^Ewl, Wwt, Wwt, Wwt^Edt
Aa, Aa^Fda, Aa, Aa, Gs, Gs^Fdw, Gs^Fmw, Gs, Gs, Gs, Rb, Rb, Gs, Rb, Gs, Cv^Fet, Gs, Gs^Es, Gs, Aa, Gg^Fdw, Aa, Aa^Fda, Aa^Fda, Aa, Aa^Fma, Ha^Fma, Ha, Hh^Fdw, Gs, Rrd, Rrd, Gs, Gs^Es, Ds, Ds, Ce, 5 Ke, Dd, Dd^Edt, Wwt, Wwt, Wwt, Wwt, Wot, Wwt
Aa, Aa, Dd, Dd, Dd, Gg^Fmw, Dd, Gg, Gs^Fdw, Gg, Rb, Re, Gll^Fmw, Gs^Fdw, Aa^Fda, Gs, Gs^Fda, Gs^Fdw, Gs, Gs^Fdw, Ha^Fda, Ha^Fda, Ha^Fma, Ha^Fma, Ha^Fma, Ha, Ha^Fma, Ha^Fda, Gs, Gs, Gs, Dd, Dd, Dd, Wwf, Ds, Wwf^Edt, Ds, Wwt, Wwt, Wwt, Wwt, Wot, Wot, Wot, Wot
Dd, Dd, Dd, Dd, Wwt, Wwt, Wwt, Wwt, Wwf, Wwf, Wwf, Re, Wwf, Aa^Fma, Aa^Fda, Aa^Fda, Aa^Fma, Aa^Fma, Aa, Aa, Ha^Fma, Ha^Fma, Ha^Fma, Ha^Fma, Aa, Ha, Ha, Ha^Fma, Aa, Aa, Dd, Dd, Wwt, Wwf, Wwt, Wwf, Wwt, Wwt, Wot, Wot, Wot, Wot, Wot, Wot, Wot, Wot
Wwt, Wwt, Wwt, Wwt, Wot, Wwt, Wwt, Wwt, Wwt, Wwf, Wwf, Wwt, Wwt, Wwt, Wwt, Wwt^Ewf, Wwt, Aa^Fma, Dd, Aa, Aa, Ha^Fma, Ha^Fma, Ha^Fma, Ha^Fma, Ha, Dd, Aa, Wwt, Wwt, Wwt, Wwt, Wwt, Wwt, Wot, Wwt, Wot, Wot, Wot, Wot, Wot, Wot, Wot, Wot, Wot, Wot
Wwt, Wwt, Wwt, Wot, Wot, Wot, Wot, Wwt, Wwt, Wwt, Wwt, Wwt, Wwt, Wwt, Wot, Wwt, Wot, Wwt^Ewf, Wwt, Dd, Dd, Dd, Dd, Gd, Dd, Dd, Wwt, Wwt, Wot, Wwt, Wot, Wwt, Wot, Wot, Wot, Wot, Wot, Wot, Wot, Wot, Wot, Wot, Wot, Wot, Wot, Wot
Wot, Wwt, Wot, Wot, Wwt, Wot, Wwt, Wwt, Wwf, Wwt, Wwt, Wwt, Wwt, Wwt, Wwt, Wot, Wot, Wot, Wot, Wwt, Wwt, Wwt, Wwt, Wwt, Wwt, Wwt, Wwt, Wot, Wot, Wot, Wot, Wot, Wot, Wot, Wot, Wot, Wot, Wot, Wot, Wot, Wot, Wot, Wwt, Wwt, Wwt, Wwt
Wot, Wot, Wot, Wot, Wwt, Wwt, Wwt, Wwf, Wwf, Wwf, Wwf, Wwt, Wwt, Wwt, Wwt, Wwt, Wot, Wot, Wot, Wwt, Wot, Wwt, Wot, Wwt, Wot, Wwt, Wot, Wot, Wot, Wot, Wot, Wot, Wot, Wot, Wot, Wot, Wot, Wot, Wot, Wot, Wot, Wwt, Ds, Ds, Aa^Qhhf, Aa^Qhhf
Wot, Wot, Wwt, Wwt, Wwt, Wwt, Dd, Dd^Es, Dd^Es, Re, Rb, Wwf, Dd^Es, Wwt, Wwt, Wwt, Wwt, Wot, Wot, Wot, Wot, Wot, Wot, Wot, Wot, Wot, Wot, Wot, Wot, Wot, Wot, Wot, Wot, Wot, Wot, Wot, Wot, Wot, Aa^Qhh, Wot, Aa^Qhhf, Aa^Qhhf, Aa^Qhhf, Aa^Qhhf, Aa^Fma, Aa^Qhhf
Wwt, Wwt, Aa^Fda, Gg^Fdw, Aa^Fda, Gg^Fdw, Gg^Fetd, Dd^Es, Gs^Fmw, Re, Gs^Fmw, Gs^Fetd, Dd, Dd, Aa, Wwt, Aa, Ai, Ai, Ai, Ai, Wot, Wot, Wot, Wot, Wot, Wot, Wot, Wot, Wot, Wwt, Wwt, Wwt, Wwt, Wwt, Wwt, Aa^Qhhf, Aa^Qhh, Aa^_mh, Gll^Qhhf, Gll^Fdw, Aa^Fda, Aa^_mh, Aa^Fma, Aa^Fma, Aa^Qhhf
Aa^Fda, Aa^Fda, Aa^Fda, Aa^Fda, Aa^Fda, Gg^Fdw, Aa^Fda, Aa^Fda, Aa^Fda, Re, Re, Gd^Fmw, Gd^Fmw, Gd^Fmw, Aa, Aa, Aa, Aa, Gs^Fmw, Aa, Ai, Ai, Wwt, Wot, Wot, Wot, Wot, Wot, Wot, Wot, Wwt, Wwt, Wwt, Wwt, Ds, Ds, Gll^Qhhf, Aa^Qhhf, Gll^Fdw, Aa^Fda, Aa^Fda, Gd^Fdw, Aa^Fma, Aa^Fma, Aa^Fma, Aa^Qhhf
Aa^Fda, Aa^Fda, Aa^Fda, Aa^Fda, Aa^Fda, Aa^Fda, Aa^Fda, Aa^Fda, Aa^Fda, Aa^Fda, Re, Gs^Fmw, Gd, Gd^Fmw, Gg^Fmw, Gd^Fmw, Gd^Fmw, Gs^Fmw, Gs^Fmw, Gs^Fmw, Gs^Fmw, Ai, Wwt, Wot, Wot, Wot, Wwt, Wwt, Wwt, Wwt, Aa^Qhh, Aa^Qhh, Aa^Qhh, Aa^Qhh, Aa^Qhh, Gll^Qhhf, Gll^Qhhf, Gll^Fdw, Gll^Fdw, Aa^Fda, Gd^Fdw, Gd^Fdw, Aa^Fma, Aa^Fma, Aa^Fma, Aa^Qhhf
