Wo, Wo, Wo, Wo, Wo, Wo, Wo, Ww, Wo, Wo, Wo, Wo, Wo, Wo, Wo, Wo, Wo, Wo, Wo, Wo, Wo, Wo, Wo, Wo, Wo, Ww, Ww, Ww, Ww, Ww, Ww, Ww, Ww, Ww, Ww, Ww
Wo, Wo, Wo, Wo, Wo, Wo, Wo, Ww, Wo, Wo, Wo, Wo, Wo, Wo, Wo, Wo, Wo, Wo, Wo, Wo, Wo, Wo, Wo, Wo, Wo, Ww, Ww, Ww, Ww, Ww, Ww, Ww, Ww, Ww, Ww, Ww
Wo, Wo, Wo, Wo, Wo, Wo, Wo, Wo, Wo, Wo, Wo, Wo, Wo, Wo, Wo, Wo, Wo, Wo, Wo, Ww, Ww, Wo, Wo, Wo, Wo, Wo, Ww, Ww, Ww, Ww, Ww, Ww, Ww, Ww, Wo, Wo
Wo, Wo, Wo, Wo, Wo, Wo, Wo, Wo, Ww, Wo, Wo, Wo, Wo, Wo, Wo, Wo, Wo, Wo, Wo, Wo, Wo, Wo, Wo, Wo, Wo, Wo, Ww, Ww, Ww, Ww, Ww, Ww, Ww, Ww, Ww, Ww
Wo, Wo, Wo, Wo, Wo, Wo, Ww, Ww, Ww, Ww, Ww, Ww, Ww, Wo, Ww, Wo, Wo, Wo, Wo, Wo, Wo, Wo, Ww, Wo, Ww, Ww, Ww, Ww, Ww, Ww, Ww, Ww, Ww, Ww, Ww, Ww
Wo, Wo, Wo, Wo, Ww, Ww, Ww, Ww, Ww, Ww, Ww, Ww, Ww, Ww, Ww, Ww, Wo, Wo, Wo, Wo, Wo, Wo, Ww, Ww, Ww, Ww, Ww, Ww, Ww, Ww, Gg, Gg, Gs, Gs, Re^Gvs, Rb^Gvs
Ww, Ww, Wo, Wo, Ww, Ww, Ww, Ww, Rr, Gg, Rr, Ww^Bw/, Ww, Ww, Ww, Ww, Ww, Wo, Wo, Wo, Wo, Wo, Ww, Ww, Ww, Ww, Ww, Ww, Rr, Rr^Vhc, Ch, Re^Gvs, Re^Gvs, Re^Gvs, Rb^Gvs, Rb^Gvs
Ww, Ww, Ww, Ww, Ww, Ww, Ww, Gs, Ch, Rr^Vhc, Rr^Ebn, Gs, Rr^Vhc, Ww, Rr, Ww^Bw/, Ww, Ww, Ww, Wo, Ww, Ww, Ww, Ww, Ww^Bw\, Ww, Ww, Ww^Bw\, Rr, 3 Ch^Kov, Gg, Re^Gvs, Rb^Gvs, Rb^Gvs, Rb^Gvs, Rb^Gvs
Ww, Ww, Ww, Ww, Ww, Ww, Ww, Ch, Rr^Vhc, Gs, Rr, Ch, 2 Kh, Ch, Rr, Gs, Gg^Fds, Ww, Ww, Ww, Ww, Ww^Bw\, Rr, Ww, Rr, Rr, Rr^Ebn, Rr, Rr, Ch, Re^Gvs, Rb^Gvs, Rb^Gvs, Rb^Gvs, Gs, Rb^Gvs
Ww, Ww, Ww, Ww, Ww, Ww, Ch, Ch, Gs, Rr, Rr, Rr, Ch, Rr, Rr^Vhc, Rr^Vhc, Gs^Fms, Gg^Fds, Rr, Ww, Ww^Bsb/, Rr, Rr, Rr, Rr, Rr^Vhc, Rr, Rr^Vhc, Rr, Rr, Rr, Gg, Rr, Rr, Rr, Rr
Ww, Ww, Ww, Ww, Ww, Ds, Gg, Gg, Rr^Ebn, Rr, Rr, Rr, Rr, Rr, Rr, Rr^Ebn, Rr, Rr, Rr, Rr, Ww, Rr, Gg, Ch, Gg, Gg^Fds, Gg^Fms, Ch, Gg, Rr, Gg, Rr, Gg, Gg, Rb, Rb
Ds, Ww, Gg, Ww, Ds, Ds, Rr, Rr, Gg, Rr^Vhc, Ch, Gg, Gg^Fds, Rr, Gg^Fds, Rr, Gg, Rr, Ch, Gg, Ww, Gg, Gg, Gg, Rb^Gvs, Gg, Re^Gvs, Gg, Gg, Gg, Rb^Gvs, Rb^Gvs, Re^Gvs, Rb^Gvs, Rb^Gvs, Rb
Rr, Ds, Rr, Gg, Rr, Rr, Rr, Gg, Gg, Ch, Gg, Ch, Gs^Fms, Gg^Fms, Ch, Ch, Gg, Gg, Gg, Gg, Ww, Ww, Rb, Rb, Rb^Gvs, Rb^Gvs, Rb^Gvs, Re^Gvs, Re^Gvs, Rb^Gvs, Re^Gvs, Re^Gvs, Re^Gvs, Rb^Gvs, Re, Re
Gg^Qhh, Rr, Gg^Qhh, Rr, Gg, Rr, Gg, Gs, Gs, Gg, Gg^Fds, Gg, Gg, Gg, Gg, Gg, Gg, Gg, Ww, Ww, Ce, Ce, Gg, Ce, Ce, Rb^Gvs, Rb^Gvs, Rb^Gvs, Rb^Gvs, Rb^Gvs, Rb^Gvs, Re^Gvs, Re^Vh, Rb^Gvs, Re^Gvs, Re
Gg^Qhhf, Gg^Qhh, Gg^_mh, Gg^Qhh, Gg^Qhh, Gg, Gg, Gs, Gs, Gg^Fds, Gg^Fds, Gg^Fds, Gg, Gg, Gg, Gg, Gg^Fds, Gg^Fds, Ww, Gg, Ce, 4 Ke, Re, Ce, Rb^Gvs, Rb^Gvs, Rb^Gvs, Rb^Gvs, Re^Gvs, Gs^Vh, Gs, Gg, Gg, Re^Gvs, Re^Gvs, Re
Gg^Qhhf, Gg^Fds, Gg^Qhhf, Gg^Qhh, Gg^Fds, Gg^Qhhf, Gg^Qhh, Gs^Qhh, Gs^Qhh, Gs, Gs, Gg, Gg, Gg^Fds, Gg^Fds, Gg, Gg^Fds, Gg^Fds, Rb^Gvs, Ww, Ww, Re^Vct, Rb^Gvs, Rb^Gvs, Rb, Rb, Rb, Re^Gvs, Rb, Rb^Gvs, Rb^Gvs, Rb^Gvs, Rb^Gvs, Re^Gvs, Rb^Gvs, Rb
Gg^Qhhf, Gg^Fds, Gg^Fds, Gg^Qhh, Gg, Gg, Gg^Fms, Gg^Fms, Gg^Fds, Gg^Qhh, Gs^Qhh, Gg, Gg^Qhh, Gg, Gg, Gg^Fds, Rb, Rb^Gvs, Rb^Gvs, Rb^Gvs, Ww, Gg, Gg, Gg, Ww, Gg, Ww, Rb, Rb, Re^Gvs, Rb^Gvs, Rb^Gvs, Rb^Gvs, Rb^Gvs, Rb, Rb
Gg^Qhh, Gg^Qhh, Cer, Gg^Qhh, Cer, Gg, Gg, Gg^Fms, Gg, Gg, Gg, Gg^Qhh, Gg^Fds, Gg^Qhhf, Gg^Qhh, Gg, Gg, Rb^Gvs, Rb^Gvs, Rb^Gvs, Re, Wwf, Wwf, Ww, Gg, Ww, Gg, Ww, Gg, Rb, Rb^Gvs, Gs^Vh, Re^Gvs, Rb^Gvs, Gs, Gg
Gg^Qhh, 5 Ker, Cer, Gg^Qhh, Gg, Gg, Gg^Gvs, Gg^Vhr, Re^Gvs, Re^Gvs, Gg, Gg, Gg, Gg^Fds, Gg, Gg^Qhh, Gg^Qhh, Re^Gvs, Re^Gvs, Rb^Gvs, Rb^Gvs, Re, Gg, Gg, Gg, Gg, Gg, Ww, Ww, Gg, Re, Rb^Gvs, Gg, Gg, Gg, Gs
Gg^Qhh, Cer, Re^Gvs, Re, Re^Gvs, Re^Gvs, Rb^Gvs, Re^Gvs, Re^Gvs, Re, Gg^Fds, Gg^Fds, Gg, Gg, Gg^Fds, Re^Gvs, Re^Gvs, Re^Gvs, Re^Gvs, Rb^Gvs, Rb^Gvs, Rb^Gvs, Rb^Gvs, Rb, Rb^Gvs, Rb^Gvs, Rb^Gvs, Gg, Ww, Gg, Gg, Gg, Ce, Ce, Ce, Gg
Re^Gvs, Re^Gvs, Re^Gvs, Re^Gvs, Rb^Gvs, Re^Vhr, Rb^Gvs, Re^Gvs, Re^Gvs, Re, Re, Gg, Gg, Gg, Gg^Fms, Re^Gvs, Re^Gvs, Rb^Gvs, Rb^Gvs, Re^Gvs, Re^Gvs, Rb^Gvs, Rb^Gvs, Rb^Gvs, Rb^Gvs, Rb^Vwm, Rb^Gvs, Gg, Re, Wwf, Wwf, Ce, Ce, Ke, Gg, Gg
Rb, Rb^Gvs, Rb^Gvs, Rb^Gvs, Re^Gvs, Re^Gvs, Re^Gvs, Re^Gvs, Re, Re^Gvs, Re^Gvs, Re^Gvs, Gg^Fds, Gg^Fds, Gg^Fms, Gg^Fms, Gg^Fds, Re, Re, Rb^Gvs, Rb^Gvs, Rb^Gvs, Rb^Gvs, Rb^Gvs, Rb^Gvs, Re^Gvs, Re^Gvs, Re^Gvs, Rb, Re, Gg, Ww, Gg, Gg, Gg, Gg
