Wo, Wo, Wo, Wo, Wo, Wo, Wo, Ww, Wo, Wo, Wo, Wo, Wo, Wo, Wo, Wo, Wo, Wo, Wo, Wo, Wo, Wo, Wo, Wo, Wo, Ww, Ww, Ww, Ww, Ww, Ww, Ww, Ww, Ww, Ww, Ww
Wo, Wo, Wo, Wo, Wo, Wo, Wo, Ww, Wo, Wo, Wo, Wo, Wo, Wo, Wo, Wo, Wo, Wo, Wo, Wo, Wo, Wo, Wo, Wo, Wo, Ww, Ww, Ww, Ww, Ww, Ww, Ww, Ww, Ww, Ww, Ww
Wo, Wo, Wo, Wo, Wo, Wo, Wo, Wo, Wo, Wo, Wo, Wo, Wo, Wo, Wo, Wo, Wo, Wo, Wo, Ww, Ww, Wo, Wo, Wo, Wo, Wo, Ww, Ww, Ww, Ww, Ww, Ww, Ww, Ww, Wo, Wo
Wo, Wo, Wo, Wo, Wo, Wo, Wo, Wo, Ww, Wo, Wo, Wo, Wo, Wo, Wo, Wo, Wo, Wo, Wo, Wo, Wo, Wo, Wo, Wo, Wo, Wo, Ww, Ww, Ww, Ww, Ww, Ww, Ww, Ww, Ww, Ww
Wo, Wo, Wo, Wo, Wo, Wo, Ww, Ww, Ww, Ww, Ww, Ww, Ww, Wo, Ww, Wo, Wo, Wo, Wo, Wo, Wo, Wo, Ww, Wo, Ww, Ww, Ww, Ww, Ww, Ww, Ww, Ww, Ww, Ww, Ww, Ww
Wo, Wo, Wo, Wo, Ww, Ww, Ww, Ww, Ww, Ww, Ww, Ww, Ww, Ww, Ww, Ww, Wo, Wo, Wo, Wo, Wo, Wo, Ww, Ww, Ww, Ww, Ww, Ww, Ww, Ww, Gs^Edt, Gs, Gs, Gs, Re^Gvs, Rb^Gvs
Ww, Ww, Wo, Wo, Ww, Ww, Ww, Ww, Rp, Gg, Rp, Ww^Bw/, Ww, Ww, Ww, Ww, Ww, Wo, Wo, Wo, Wo, Wo, Ww, Ww, Ww, Ww, Ww, Ww, Rr^Edt, Rr^Vhc, Ch, Re^Gvs, Re^Gvs, Re^Gvs, Rb^Gvs, Rb^Gvs
Ww, Ww, Ww, Ww, Ww, Ww, Ww, Gs, Ch, Rp^Vhc, Rr^Ebn, Gs, Rr^Vhc, Ww, Rp, Ww^Bw/, Ww, Ww, Ww, Wo, Ww, Ww, Ww, Ww, Ww^Bw\, Ww, Ww, Ww^Bw\, Rp, 3 Ch^Kov, Gs^Edt, Re^Gvs, Rb^Gvs, Rb^Gvs, Rb^Gvs, Rb^Gvs
Ww, Ww, Ww, Ww, Ww, Ww, Ww, Ch, Rr^Vhc, Gs, Rp, Ch, 2 Kh, Ch, Rp, Gs^Edt, Gll^Fdf, Ww, Ww, Ww, Ww, Ww^Bw\, Rr, Ww, Rr, Rr, Rr^Ebn, Rp, Rr, Ch^Edt, Re^Gvs, Rb^Gvs, Rb^Gvs, Rb^Gvs, Gs, Rb^Gvs
Ww, Ww, Ww, Ww, Ww, Ww, Ch, Ch^Edt, Gs^Edt, Rr, Rp, Rp, Ch^Edt, Rr, Rr^Vhc, Rp^Vhc, Gll^Fmf, Gll^Fdf, Rr, Ww, Ww^Bsb/, Rr, Rp, Rr, Rp, Rr^Vhc, Rr, Rr^Vhc, Rr, Rp, Rp, Gs^Es, Rr, Rp, Rr, Rr
Ww, Ww, Ww, Ww, Ww, Ds, Gs, Gs, Rr^Ebn, Rr, Rr, Rr, Rr, Rr^Edt, Rr, Rr^Ebn, Rp, Rr, Rr, Rr^Edt, Ww, Rr, Gg^Edt, Ch^Edt, Gs, Gll^Fdf, Gll^Fmf, Ch, Gs, Rr, Gg, Rr, Gg, Gg, Rb, Rb
Ds, Ww, Gg, Ww, Ds, Ds, Rp, Rp, Gg, Rr^Vhc, Ch, Gll^Fmf, Gs, Rr, Gll^Fdf, Rp, Gs, Rr, Ch, Gg, Ww, Gg, Re, Re^Edt, Re^Gvs, Gs, Re^Gvs, Gg, Gg, Gg, Rb^Gvs, Rb^Gvs, Re^Gvs, Rb^Gvs, Rb^Gvs, Rb
Rr, Ds, Rr, Gg, Rr, Rr, Rp, Gg, Gll^Fmf, Ch, Gg, Ch, Re, Re, Ch, Ch, Gg, Gg^Edt, Gs, Gg, Ww, Rb^Gvs, Rb^Gvs, Rb^Gvs, Re^Gvs, Re^Gvs, Rb^Gvs, Rb^Gvs, Re^Gvs, Rb^Gvs, Gs^Vh, Re^Gvs, Re^Gvs, Rb^Gvs, Re^Eff, Re^Eff
Gg, Rr, Gg^Qhh, Rr, Gg^Efm, Rp, Gg^Efm, Gs^Efm, Gs, Gs, Gll^Fdf, Gs, Re, Gs, Gll^Fmf, Gll^Fmf, Gs, Gs, Ww, Ww, Gs, Rb^Gvs, Rb^Gvs, Rb^Gvs, Rb^Gvs, Rb^Gvs, Ce^Edt, Re^Gvs, Re^Gvs, Rb^Gvs, Rb^Gvs, Re^Eff, Re^Eff, Rb^Eff, Re^Gvs, Re
Gs, Gs, Gs^Qhh, Gg^Efm, Gs^Qhh, Gg^Efm, Gs^Efm, Gs^Efm, Gs, Gll^Fdf, Gll^Fdf, Gll^Fdf, Gs, Gs, Gg, Gg, Gll^Fdf, Gll^Fdf, Ww, Gll^Fdf, Gs, Gg, Rb^Gvs, Rb^Gvs, Rb^Gvs, Rb^Gvs, Rb^Qhh, Re^Gvs, Ce^Edt, Re^Gvs, Re^Eff, Re^Eff, Re^Gvs, Re^Gvs, Re^Gvs, Re
Gll^Fdf, Gs^Fdf, Gll^Fdf, Gg^Edt, Gs^Fdf, Gs^Qhhf, Gs^Qhh, Gs^Qhh, Gs^Qhh, Gs, Gs, Gs^Fms, Re, Gg, Gll^Fdf, Gg^Vl, Gll^Fdf, Gll^Fdf, Ww, Ww, Ww, Gs, Rb^Gvs, Rb^Gvs, Re^Edt, Re^Edt, Rb^Qhh, Ce, 4 Ke, Re^Eff, Rb^Gvs, Rb^Gvs, Rb^Gvs, Re^Gvs, Rb^Gvs, Rb
Gll^Fdf, Gll^Fdf, Rb^Eff, Gg^Edt, Gs, Gs, Gll^Fmf, Gll^Fmf, Gg^Fdf, Gg^Qhh, Hh^Qhh, Gg, Hh, Re, Re, Gll^Fdf, Wwf, Ww, Gg, Gg, Ww, Gs, Rb, Gg, Ww, Re^Edt, Ww, Rb^Qhh, Rb^Qhh, Ce^Edt, Rb^Gvs, Rb^Gvs, Rb^Gvs, Rb^Gvs, Rb^Qhh, Rb^Qhh
Gg, Gg, Rb^Eff, Rb^Eff, Rb^Eff, Gg^Edt, Gg, Gll^Fmf, Gg, Gs, Gs, Hh^Qhh, Hh^Fmf, Gs, Wwf, Wwf, Re, Rb^Gvs, Rb^Gvs, Gg, Rb^Gvs, Wwf, Wwf, Ww, Gll^Fdf, Ww, Gll^Fdf, Ww, Ce^Qhh, Re^Edt, Re^Edt, Gs^Vh, Re^Qhh, Rb^Qhh, Rb^Gvs, Gs^Qhh
Rb^Eff, Rb^Eff, Re^Gvs, Re^Gvs, Re^Gvs, Re^Gvs, Re^Gvs, Gg^Vhr, Re^Gvs, Re^Gvs, Gs^Fms, Hh^Qhh, Gs^Qhh, Hh, Ww, Re, Re^Gvs, Re, Gs^Vh, Rb^Gvs, Rb^Gvs, Rb^Gvs, Gs, Gll^Fdf, Gs^Fdf, Gll^Fdf, Gs, Ww, Wwf, Hh^Qhh, Re, Re^Gvs, Re^Gvs, Re^Gvs, Re^Gvs, Gs^Qhh
Re^Gvs, Cer^Edt, Re^Gvs, Re^Gvs, Re^Gvs, Re^Gvs, Rb^Gvs, Re^Gvs, Re^Gvs, Re, Gll^Fdf, Gll^Fdf, Gs, Hh^Qhh, Ds, Ww, Ww, Re, Re, Re, Rb^Gvs, Re, Rb^Gvs, Re^Gvs, Rb^Gvs, Rb^Gvs, Rb^Gvs, Gs, Wwf, Hh^Qhh, Hh^Qhh, Hh, Gg^Fdf, Re^Qhh, Re^Gvs, Gs^Qhh
Re^Gvs, Re^Gvs, Cer^Edt, Re^Vhr, Rb^Gvs, Re^Gvs, Rb^Gvs, Re^Gvs, Re^Gvs, Re, Rb, Gg^Es, Gs, Gs^Qhh, Ds^Es, Ds, Ww, Rb^Gvs, Rb^Gvs, Re, Re, Rb^Gvs, Rb^Gvs, Rb^Gvs, Rb^Gvs, Rb^Gvs, Rb^Gvs, Gg, Re, Wwf, Wwf, Hh^Qhhf, Hh^Qhh, Gg^Fmf, Gg^_mh, Gg^Qhh
Rb, 5 Ker, Cer^Edt, Rb^Gvs, Re^Gvs, Re^Gvs, Re^Gvs, Re^Gvs, Re, Re^Gvs, Rb, Re^Gvs, Gll^Fdf, Gs^Qhh, Gs^Qhh, Ww, Rb^Eff, Rb^Gvs, Rb^Gvs, Rb^Gvs, Re, Re, Rb^Gvs, Rb^Gvs, Rb^Gvs, Re^Gvs, Re^Gvs, Re^Gvs, Rb^Eff, Re, Gs, Ww, Ww, Gg^Qhh, Gll^Fmf, Gll^Fdf
Rb, Cer^Edt, Rb^Gvs, Rb^Gvs, Re^Gvs, Re^Gvs, Re^Gvs, Re^Gvs, Re, Re^Gvs, Rb^Eff, Re^Eff, Re^Gvs, Gs^_mh, Gg^Qhh, Wwf, Wwf, Rb^Eff, Re^Eff, Re^Eff, Gs, Re, Rb^Gvs, Rb^Vwm, Rb^Gvs, Re^Gvs, Re^Gvs, Re^Gvs, Rb^Eff, Rb^Eff, Gs, Gs, Ww, Gg^Qhhf, Gs^Qhh, Gll^Fdf
Rb, Rb^Gvs, Rb^Gvs, Rb^Gvs, Re^Gvs, Re^Gvs, Re^Gvs, Re^Gvs, Rb^Eff, Rb^Eff, Rb, Re^Gvs, Rb^Gvs, Re^Gvs, Re, Gg^Qhh, Gs^Qhh, Ww, Wwf, Gs, Ce, Ce, Ce, Rb^Gvs, Re, Re^Gvs, Rb^Eff, Rb^Eff, Re, Gll^Fdf, Gs, Gs, Gs, Ww, Gs^Qhh, Gs^Qhh
Rb, Rb^Gvs, Rb^Gvs, Rb^Gvs, Re^Gvs, Re^Gvs, Rb^Eff, Rb^Eff, Re^Gvs, Rb^Eff, Re^Eff, Rb^Gvs, Rb^Gvs, Rb^Gvs, Rb^Gvs, Re^Gvs, Re, Gs^Qhh, Wwf, Wwf, Ce, 1 Ke, Rb^Gvs, Re, Rb^Gvs, Re, Gll^Fdf, Re, Rb, Gll^Fdf, Gll^Fmf, Gg^Fdf, Gs^Fdf, Ww, Ww, Gs^Qhh
Rb, Rb^Gvs, Rb^Gvs, Rb^Gvs, Re^Gvs, Rb^Eff, Rb^Gvs, Rb^Gvs, Re^Gvs, Re^Gvs, Re^Gvs, Re^Eff, Re^Gvs, Re^Gvs, Rb^Gvs, Rb^Gvs, Re^Gvs, Gs^Qhh, Gs^Qhh, Wwf, Wwf, Rb^Gvs, Rb^Gvs, Rb^Gvs, Rb^Gvs, Rb^Gvs, Gll^Fdf, Gll^Fdf, Gg, Gll^Fdf, Gll^Fdf, Gll^Fmf, Gll^Fdf, Gg^Fdf, Ww, Gs^Qhh
