Wo, Wo, Wo, Wo, Wo, Wo, Wo, Ww, Wo, Wo, Wo, Wo, Wo, Wo, Wo, Wo, Wo, Wo, Wo, Wo, Wo, Wo, Wo, Wo, Wo, Ww, Ww, Ww, Ww, Ai, Ai, Ai, Ai, Ww, Ww, Ww
Wo, Wo, Wo, Wo, Wo, Wo, Wo, Ww, Wo, Wo, Wo, Wo, Wo, Wo, Wo, Wo, Wo, Wo, Wo, Wo, Wo, Wo, Wo, Wo, Wo, Ww, Ww, Ww, Ww, Ww, Ww, Ai, Ww, Ww, Ww, Ai
Wo, Wo, Wo, Wo, Wo, Wo, Wo, Wo, Wo, Wo, Wo, Wo, Wo, Wo, Wo, Wo, Wo, Wo, Wo, Ww, Ww, Wo, Wo, Wo, Wo, Wo, Ww, Ww, Ww, Ww, Ww, Ww, Ww, Ww, Wo, Wo
Wo, Wo, Wo, Wo, Wo, Wo, Wo, Wo, Ww, Wo, Wo, Wo, Wo, Wo, Wo, Wo, Wo, Wo, Wo, Wo, Wo, Wo, Wo, Wo, Wo, Wo, Ww, Ww, Ww, Ww, Ai, Ww, Ww, Ww, Ww, Ww
Wo, Wo, Wo, Wo, Wo, Wo, Ww, Ww, Ww, Ww, Ww, Ww, Ww, Wo, Ww, Wo, Wo, Wo, Wo, Wo, Wo, Wo, Ww, Wo, Ww, Ww, Ww, Ww, Ww, Ww, Ww, Ww, Ww, Ww, Ww, Ww
Wo, Wo, Wo, Wo, Ww, Ww, Ww, Ww, Ww, Ww, Ww, Ww, Ww, Ww, Ww, Ww, Wo, Wo, Wo, Wo, Wo, Wo, Ww, Ww, Ww, Ww, Ww, Ww, Ww, Ww, Gs^Edt, Gs, Gs, Gs, Aa, Aa
Ww, Ww, Wo, Wo, Ww, Ww, Ww, Ww, Rp, Gg, Rp, Ww^Bw/, Ww, Ww, Ww, Ww, Ww, Wo, Wo, Wo, Wo, Wo, Ww, Ww, Ww, Ww, Ww, Ww, Rr^Edt, Rr^Vhc, Ch, Re, Re, Aa, Aa, Aa
Ww, Ww, Ww, Ww, Ww, Ww, Ai, Gs, Ch, Rp^Vhc, Rr^Ebn, Gs, Rr^Vhc, Ww, Rp, Ww^Bw/, Ww, Ww, Ww, Wo, Ww, Ww, Ww, Ww, Ww^Dr, Ww, Ww, Ww^Bw\, Rp, 2 Ch^Kov, Gs^Edt, Re, Rb, Aa, Rb, Aa
Ww, Ww, Ww, Ww, Ww, Ww, Ai, Ch, Rr^Vhc, Gs, Rp, Ch, 5 Kh, Ch, Rp, Gd^Edt, Gll^Fdf, Ww, Ww, Ww, Ww, Ww^Bw\, Rr, Ww, Rr, Rr, Rr^Ebn, Rp, Rr, Ch^Edt, Re, Rb, Aa, Aa, Rr, Rr
Ww, Ww, Ww, Ww, Ww, Ai, Ch, Ch^Edt, Gs^Edt, Rr, Rp, Rp, Ch^Edt, Rr, Rr^Vhc, Rp^Vhc, Gll^Fmf, Gll^Fdf, Rr, Ww, Ww^Bsb/, Rr, Rp, Rr, Rp, Rr^Vhc, Rr, Rr^Vhc, Rr, Rp, Rp, Aa^Es, Rr, Aa, Aa, Aa
Ww, Ww, Ww, Ai, Ww, Ds, Gs, Gs, Rr^Ebn, Rr, Rr, Rr, Rr, Rr^Edt, Rr, Rr^Ebn, Rp, Rr, Rr, Rr^Edt, Ww^Dr, Rr^Dr, Gs^Dr, Ch^Edt, Gs, Gll^Fdf, Gll^Fmf, Ch^Dr, Gs, Rr, Gd, Rr, Gd, Gd, Rb, Rb
Ds, Ww, Aa, Ww, Aa, Aa, Rp, Rp, Gd, Rr^Vhc, Ch, Gll^Fmf, Gs, Rr, Gll^Fdf, Rp, Gs, Rr, Ch, Gd, Ww, Gs^Dr, Re, Re^Edt, Re, Gs, Re, Gd, Gd, Gd, Rb, Rb, Re, Rb, Rb, Rb
Rr, Ds, Rr, Aa, Aa, Aa, Rp, Gd, Gll^Fmf, Ch, Gg, Ch, Re, Re, Ch, Ch, Aa, Gd^Edt, Gs, Gd, Ww, Rb, Rb, Rb, Aa, Re, Aa, Rb, Re, Rb, Gs^Vh, Re, Re, Rb, Rb^Eff, Re^Eff
Gd, Rr, Gd^Qhh, Rr, Gg^Efm, Rp, Gg^Efm, Gs^Efm, Gs, Gs, Gll^Fdf, Gs, Re, Gg^Dr, Aa^Fma, Aa^Fma, Aa, Gs, Ww, Ww, Gd, Rb, Rb, Rb, Rb, Aa, Ce^Edt, Aa, Aa, Rb, Rb, Re^Eff, Re^Eff, Rb^Eff, Re, Rb
Gs, Gs, Gs^Qhh, Gg^Efm, Gs^Qhh, Gg^Efm, Gs^Efm, Gs^Efm, Gs, Gll^Fdf, Gll^Fdf, Gll^Fdf, Gs, Gs, Gd, Gd, Gll^Fdf, Gll^Fdf, Ww, Gll^Fdf, Gd, Gd, Rb, Rb, Rb, Rb, Aa^Qhh, Aa, Ce^Edt, Re, Re^Eff, Re^Eff, Re, Re, Re, Re
Gll^Fdf, Gs^Fdf, Gll^Fdf, Gd^Edt, Gs^Fdf, Gs^Qhhf, Gs^Qhh, Gs^Qhh, Gs^Qhh, Gs, Gs, Gs^Fms, Re, Gd, Gll^Fdf, Gg^Vl, Gll^Fdf, Gll^Fdf, Ww, Ww, Ww, Gd, Rb, Rb, Re^Edt, Re^Edt, Rb^Qhh, Ce, 3 Ke, Re^Eff, Rb, Rb, Rb, Re, Rb, Rb
Gll^Fdf, Gll^Fdf, Rb^Eff, Gd^Edt, Gs, Gs, Gll^Fmf, Gll^Fmf, Gg^Fdf, Gg^Qhh, Hh^Qhh, Gg, Hh, Re, Re, Gll^Fdf, Wwf, Ww, Gd, Gd, Ww, Gd, Rb, Gd, Ww, Re^Edt, Ww, Rb^Qhh, Rb^Qhh, Ce^Edt, Rb, Rb, Rb, Rb, Rb^Qhh, Rb^Qhh
Gd, Gd, Rb^Eff, Rb^Eff, Rb^Eff, Gd^Edt, Gd, Gll^Fmf, Gd, Gs, Gs, Hh^Qhh, Hh^Fmf, Gs, Wwf, Wwf, Re, Rb, Rb, Gd, Rb, Wwf, Wwf, Ww, Gll^Fdf, Ww, Gll^Fdf, Ww, Ce^Qhh, Re^Edt, Re^Edt, Gs^Vh, Re^Qhh, Aa^Qhh, Aa, Gs^Qhh
Rb^Eff, Rb^Eff, Re, Re, Re, Re, Re, Gd^Vhr, Re, Re, Aa^Fda, Hh^Qhh, Aa^Qhh, Hh, Ww, Re, Rb, Re, Gd^Vh, Rb, Rb, Rb, Gd, Gll^Fdf, Gs^Fdf, Gll^Fdf, Gs, Ww, Wwf, Hh^Qhh, Re, Re, Re, Aa, Aa, Aa^Qhh
Re, Cer^Edt, Re, Re, Re, Re, Rb, Re, Aa, Aa, Gll^Fdf, Aa^Fda, Aa, Hh^Qhh, Ds, Ww, Ww, Re, Re, Re, Rb, Re, Rb, Re, Rb, Rb, Rb, Gd, Wwf, Hh^Qhh, Hh^Qhh, Hh, Gg^Fdf, Re^Qhh, Re, Aa^Qhh
Re, Re, Cer^Edt, Re^Vhr, Rb, Re, Rb, Re, Re, Re, Rb, Aa^Es, Gs, Gs^Qhh, Ds^Es, Ds, Ww, Rb, Rb, Re, Re, Rb, Rb, Rb, Rb, Aa, Aa, Gd, Re, Wwf, Wwf, Hh^Qhhf, Hh^Qhh, Gg^Fmf, Gg^_mh, Gg^Qhh
Rb, 4 Ker, Cer^Edt, Rb, Aa, Re, Re, Re, Re, Re, Rb, Re, Gll^Fdf, Gs^Qhh, Gs^Qhh, Ww, Rb^Eff, Rb, Rb, Rb, Rb, Re, Rb, Rb, Rb, Aa, Re, Aa, Aa^Eff, Re, Gs, Ww, Ww, Gg^Qhh, Gll^Fmf, Gll^Fdf
Rb, Cer^Edt, Rb, Rb, Aa, Aa, Re, Rb, Rb, Re, Rb^Eff, Re^Eff, Re, Gs^_mh, Gd^Qhh, Wwf, Wwf, Rb^Eff, Re^Eff, Rb^Eff, Gs, Re, Rb, Rb^Vwm, Rb, Re, Re, Aa, Aa^Eff, Rb^Eff, Gs, Gs, Ww, Gg^Qhhf, Gs^Qhh, Gll^Fdf
Rb, Aa, Aa, Aa, Aa, Aa, Rb, Rb, Rb^Eff, Aa^Eff, Aa, Re, Aa, Re, Re, Gd^Qhh, Aa^Qhh, Ww, Wwf, Gs, Ce, Ce, Ce, Rb, Re, Re, Rb^Eff, Rb^Eff, Re, Gll^Fdf, Gs, Gs, Gs, Ww, Gs^Qhh, Gs^Qhh
Rb, Rb, Rb, Rb, Rb, Re, Rb^Eff, Rb^Eff, Re, Rb^Eff, Re^Eff, Aa, Rb, Aa, Aa, Aa, Re, Gs^Qhh, Wwf, Wwf, Ce, 1 Ke, Rb, Re, Rb, Re, Gll^Fdf, Re, Rb, Gll^Fdf, Gll^Fmf, Gg^Fdf, Gs^Fdf, Ww, Ww, Gs^Qhh
Rb, Rb, Rb, Rb, Re, Rb^Eff, Rb, Rb, Re, Re, Re, Re^Eff, Re, Aa, Rb, Aa, Re^Gvs, Gs^Qhh, Gs^Qhh, Wwf, Wwf, Rb, Rb, Rb, Rb, Rb, Gll^Fdf, Gll^Fdf, Gg, Gll^Fdf, Gll^Fdf, Gll^Fmf, Gll^Fdf, Gg^Fdf, Ww, Gs^Qhh
