Wo, Wo, Wo, Wo, Wo, Wo, Wo, Ww, Wo, Wo, Wo, Wo, Wo, Wo, Wo, Wo, Wo, Wo, Wo, Wo, Wo, Wo, Wo, Wo, Wo, Ww, Ww, Ww, Ww, Ww, Ww, Ww, Ww, Ww, Ww, Ww
Wo, Wo, Wo, Wo, Wo, Wo, Wo, Ww, Wo, Wo, Wo, Wo, Wo, Wo, Wo, Wo, Wo, Wo, Wo, Wo, Wo, Wo, Wo, Wo, Wo, Ww, Ww, Ww, Ww, Ww, Ww, Ww, Ww, Ww, Ww, Ww
Wo, Wo, Wo, Wo, Wo, Wo, Wo, Wo, Wo, Wo, Wo, Wo, Wo, Wo, Wo, Wo, Wo, Wo, Wo, Ww, Ww, Wo, Wo, Wo, Wo, Wo, Ww, Ww, Ww, Ww, Ww, Ww, Ww, Ww, Wo, Wo
Wo, Wo, Wo, Wo, Wo, Wo, Wo, Wo, Ww, Wo, Wo, Wo, Wo, Wo, Wo, Wo, Wo, Wo, Wo, Wo, Wo, Wo, Wo, Wo, Wo, Wo, Ww, Ww, Ww, Ww, Ww, Ww, Ww, Ww, Ww, Ww
Wo, Wo, Wo, Wo, Wo, Wo, Ww, Ww, Ww, Ww, Ww, Ww, Ww, Wo, Ww, Wo, Wo, Wo, Wo, Wo, Wo, Wo, Ww, Wo, Ww, Ww, Ww, Ww, Ww, Ww, Ww, Ww, Ww, Ww, Ww, Ww
Wo, Wo, Wo, Wo, Ww, Ww, Ww, Ww, Ww, Ww, Ww, Ww, Ww, Ww, Ww, Ww, Wo, Wo, Wo, Wo, Wo, Wo, Ww, Ww, Ww, Ww, Ww, Ww, Ww, Ww, Gg^Edt, Gg, Gs, Gs, Re^Gvs, Rb^Gvs
Ww, Ww, Wo, Wo, Ww, Ww, Ww, Ww, Rp, Gg, Rp, Ww^Bw/, Ww, Ww, Ww, Ww, Ww, Wo, Wo, Wo, Wo, Wo, Ww, Ww, Ww, Ww, Ww, Ww, Rr^Edt, Rr^Vhc, Ch, Re^Gvs, Re^Gvs, Re^Gvs, Rb^Gvs, Rb^Gvs
Ww, Ww, Ww, Ww, Ww, Ww, Ww, Gs, Ch, Rp^Vhc, Rr^Ebn, Gs, Rr^Vhc, Ww, Rp, Ww^Bw/, Ww, Ww, Ww, Wo, Ww, Ww, Ww, Ww, Ww^Dr, Ww, Ww, Ww^Bw\, Rp, 2 Ch^Kov, Gg^Edt, Re^Gvs, Rb^Gvs, Rb^Gvs, Rb^Gvs, Rb^Gvs
Ww, Ww, Ww, Ww, Ww, Ww, Ww, Ch, Rr^Vhc, Gs, Rp, Ch, 5 Kh, Ch, Rp, Gs^Edt, Gg^Fds, Ww, Ww, Ww, Ww, Ww^Bw\, Rr, Ww, Rr, Rr, Rr^Ebn, Rp, Rr, Ch^Edt, Re^Gvs, Rb^Gvs, Rb^Gvs, Rb^Gvs, Gs, Rb^Gvs
Ww, Ww, Ww, Ww, Ww, Ww, Ch, Ch^Edt, Gs^Edt, Rr, Rp, Rp, Ch^Edt, Rr, Rr^Vhc, Rp^Vhc, Gs^Fms, Gg^Fds, Rr, Ww, Ww^Bsb/, Rr, Rp, Rr, Rp, Rr^Vhc, Rr, Rr^Vhc, Rr, Rp, Rp, Gg^Es, Rr, Rp, Rr, Rr
Ww, Ww, Ww, Ww, Ww, Ds, Gg, Gg, Rr^Ebn, Rr, Rr, Rr, Rr, Rr^Edt, Rr, Rr^Ebn, Rp, Rr, Rr, Rr^Edt, Ww^Dr, Rr^Dr, Gg^Dr, Ch^Edt, Gg, Gg^Fds, Gg^Fms, Ch^Dr, Gg, Rr, Gg, Rr, Gg, Gg, Rb, Rb
Ds, Ww, Gg, Ww, Ds, Ds, Rp, Rp, Gg, Rr^Vhc, Ch, Gs^Fms, Gg, Rr, Gg^Fds, Rp, Gg, Rr, Ch, Gg, Ww, Gg^Dr, Re, Re^Edt, Re^Gvs, Gg, Re^Gvs, Gg, Gg, Gg, Rb^Gvs, Rb^Gvs, Re^Gvs, Rb^Gvs, Rb^Gvs, Rb
Rr, Ds, Rr, Gg, Rr, Rr, Rp, Gg, Gs^Fms, Ch, Gg, Ch, Re, Re, Ch, Ch, Gg, Gg^Edt, Gg, Gg, Ww, Rb^Gvs, Rb^Gvs, Rb^Gvs, Re^Gvs, Re^Gvs, Rb^Gvs, Rb^Gvs, Re^Gvs, Rb^Gvs, Gs^Vh, Re^Gvs, Re^Gvs, Rb^Gvs, Re^Eff, Re^Eff
Gg, Rr, Gg^Qhh, Rr, Gg^Efm, Rp, Gg^Efm, Gs^Efm, Gs, Gg, Gg^Fds, Gg, Re, Gg^Dr, Gs^Fms, Gs^Fms, Gg, Gg, Ww, Ww, Gg, Rb^Gvs, Rb^Gvs, Rb^Gvs, Rb^Gvs, Rb^Gvs, Ce^Edt, Re^Gvs, Re^Gvs, Rb^Gvs, Rb^Gvs, Re^Eff, Re^Eff, Rb^Eff, Re^Gvs, Re
Gg, Gg, Gg^Qhh, Gg^Efm, Gg^Qhh, Gg^Efm, Gg^Efm, Gs^Efm, Gs, Gg^Fds, Gg^Fds, Gg^Fds, Gs, Gg, Gg, Gg, Gg^Fds, Gs^Fds, Ww, Gs^Fds, Gg, Gg, Rb^Gvs, Rb^Gvs, Rb^Gvs, Rb^Gvs, Rb^Qhh, Re^Gvs, Ce^Edt, Re^Gvs, Re^Eff, Re^Eff, Re^Gvs, Re^Gvs, Re^Gvs, Re
Gg^Fds, Gg^Fds, Gg^Fds, Gg^Edt, Gg^Fds, Gg^Qhhf, Gg^Qhh, Gs^Qhh, Gs^Qhh, Gs, Gs, Gs^Fms, Re, Gg, Gg^Fds, Gg^Vl, Gg^Fds, Gs^Fds, Ww, Ww, Ww, Gg, Rb^Gvs, Rb^Gvs, Re^Edt, Re^Edt, Rb^Qhh, Ce, 3 Ke, Re^Eff, Rb^Gvs, Rb^Gvs, Rb^Gvs, Re^Gvs, Rb^Gvs, Rb
Gg^Fds, Gg^Fds, Rb^Eff, Gg^Edt, Gg, Gg, Gg^Fms, Gg^Fms, Gg^Fds, Gg^Qhh, Hh^Qhh, Gg, Hh, Re, Re, Gg^Fds, Wwf, Ww, Gg, Gg, Ww, Gg, Rb, Gg, Ww, Re^Edt, Ww, Rb^Qhh, Rb^Qhh, Ce^Edt, Rb^Gvs, Rb^Gvs, Rb^Gvs, Rb^Gvs, Rb^Qhh, Rb^Qhh
Gg, Gg, Rb^Eff, Rb^Eff, Rb^Eff, Gg^Edt, Gg, Gg^Fms, Gg, Gg, Gg, Hh^Qhh, Hh^Fds, Gs, Wwf, Wwf, Re, Rb^Gvs, Rb^Gvs, Gg, Rb^Gvs, Wwf, Wwf, Ww, Gs^Fds, Ww, Gs^Fds, Ww, Ce^Qhh, Re^Edt, Re^Edt, Gs^Vh, Re^Qhh, Rb^Qhh, Rb^Gvs, Gg^Qhh
Rb^Eff, Rb^Eff, Re^Gvs, Re^Gvs, Re^Gvs, Re^Gvs, Re^Gvs, Gg^Vhr, Re^Gvs, Re^Gvs, Gs^Fms, Hh^Qhh, Hh^Qhh, Hh, Ww, Re, Re^Gvs, Re, Gs^Vh, Rb^Gvs, Rb^Gvs, Rb^Gvs, Gg, Gg^Fds, Gg^Fds, Gg^Fds, Gg, Ww, Wwf, Hh^Qhh, Re, Re^Gvs, Re^Gvs, Re^Gvs, Re^Gvs, Gs^Qhh
Re^Gvs, Cer^Edt, Re^Gvs, Re^Gvs, Re^Gvs, Re^Gvs, Rb^Gvs, Re^Gvs, Re^Gvs, Re, Gg^Fds, Gg^Fds, Gs, Hh^Qhh, Ds, Ww, Ww, Re, Re, Re, Rb^Gvs, Re, Rb^Gvs, Re^Gvs, Rb^Gvs, Rb^Gvs, Rb^Gvs, Gg, Wwf, Hh^Qhh, Hh^Qhh, Hh, Gg^Fds, Re^Qhh, Re^Gvs, Gg^Qhh
Re^Gvs, Re^Gvs, Cer^Edt, Re^Vhr, Rb^Gvs, Re^Gvs, Rb^Gvs, Re^Gvs, Re^Gvs, Re, Rb, Gg^Es, Gs, Gs^Qhh, Ds^Es, Ds, Ww, Rb^Gvs, Rb^Gvs, Re, Re, Rb^Gvs, Rb^Gvs, Rb^Gvs, Rb^Gvs, Rb^Gvs, Rb^Gvs, Gg, Re, Wwf, Wwf, Hh^Qhhf, Hh^Qhh, Gg^Fms, Gg^_mh, Gg^Qhh
Rb, 4 Ker, Cer^Edt, Rb^Gvs, Re^Gvs, Re^Gvs, Re^Gvs, Re^Gvs, Re, Re^Gvs, Rb, Re^Gvs, Gs^Fds, Gs^Qhh, Gs^Qhh, Ww, Rb^Eff, Rb^Gvs, Rb^Gvs, Rb^Gvs, Re, Re, Rb^Gvs, Rb^Gvs, Rb^Gvs, Re^Gvs, Re^Gvs, Re^Gvs, Rb^Eff, Re, Gs, Ww, Ww, Gg^Qhh, Gg^Fms, Gg^Fds
Rb, Cer^Edt, Rb^Gvs, Rb^Gvs, Re^Gvs, Re^Gvs, Re^Gvs, Re^Gvs, Re, Re^Gvs, Rb^Eff, Re^Eff, Re^Gvs, Gs^_mh, Gg^Qhh, Wwf, Wwf, Rb^Eff, Re^Eff, Re^Eff, Gs, Re, Rb^Gvs, Rb^Vwm, Rb^Gvs, Re^Gvs, Re^Gvs, Re^Gvs, Rb^Eff, Rb^Eff, Gs, Gs, Ww, Gg^Qhhf, Gs^Qhh, Gg^Fds
Rb, Rb^Gvs, Rb^Gvs, Rb^Gvs, Re^Gvs, Re^Gvs, Re^Gvs, Re^Gvs, Rb^Eff, Rb^Eff, Rb, Re^Gvs, Rb^Gvs, Re^Gvs, Re, Gg^Qhh, Gs^Qhh, Ww, Wwf, Gs, Ce, Ce, Ce, Rb^Gvs, Re, Re^Gvs, Rb^Eff, Rb^Eff, Re, Gs^Fds, Gs, Gs, Gs, Ww, Gs^Qhh, Gs^Qhh
Rb, Rb^Gvs, Rb^Gvs, Rb^Gvs, Re^Gvs, Re^Gvs, Rb^Eff, Rb^Eff, Re^Gvs, Rb^Eff, Re^Eff, Rb^Gvs, Rb^Gvs, Rb^Gvs, Rb^Gvs, Re^Gvs, Re, Gs^Qhh, Wwf, Wwf, Ce, 1 Ke, Rb^Gvs, Re, Rb^Gvs, Re, Gg^Fds, Re, Rb, Gg^Fds, Gg^Fms, Gg^Fds, Gs^Fds, Ww, Ww, Gs^Qhh
Rb, Rb^Gvs, Rb^Gvs, Rb^Gvs, Re^Gvs, Rb^Eff, Rb^Gvs, Rb^Gvs, Re^Gvs, Re^Gvs, Re^Gvs, Re^Eff, Re^Gvs, Re^Gvs, Rb^Gvs, Rb^Gvs, Re^Gvs, Gs^Qhh, Gs^Qhh, Wwf, Wwf, Rb^Gvs, Rb^Gvs, Rb^Gvs, Rb^Gvs, Rb^Gvs, Gg^Fds, Gg^Fds, Gg, Gg^Fds, Gg^Fms, Gg^Fms, Gg^Fds, Gg^Fds, Ww, Gs^Qhh
