Wo, Wo, Wo, Wo, Wo, Wo, Wo, Wo, Wo, Wo, Wo, Wo, Wo, Wo, Wo, Wo, Wo, Wo, Wo, Wo, Wo, Wo, Wo, Wo, Wo, Wo, Wo, Wo, Wo, Wo, Wo, Wo, Wo, Wo, Ww, Ww, Ww
Wo, Wo, Wo, Wo, Wo, Wo, Wo, Wo, Wo, Wo, Wo, Wo, Wo, Wo, Wo, Wo, Wo, Wo, Wo, Wo, Wo, Ww, Ww, Ww, Ww, Wo, Ww, Ww, Ww, Wo, Wo, Wo, Ww, Ww, Ww, Ww, Gs^Fds
Wo, Wo, Wo, Wo, Wo, Wo, Wo, Wo, Wo, Wo, Wo, Wo, Ww, Ww, Wo, Wo, Wo, Wo, Ww, Wo, Ww, Ww, Ww, Ww, Ww, Ww, Ww, Ww, Wo, Wo, Ww, Ww, Ww, Ww, Gs^Fds, Gs^Fds, Gs^Fds
Wo, Wo, Wo, Wo, Wo, Wo, Wo, Wo, Wo, Wo, Ww, Ww, Ww, Ww, Ww, Wo, Wo, Ww, Ww, Ww, Ww, Ww, Wo, Ww, Ww, Ww, Ww, Ww, Ww, Ww, Ss, Ww, Ww, Ww, Gs^Fds, Gg, Gg
Wo, Wo, Wo, Wo, Wo, Wo, Wo, Wo, Ww, Ww, Gs^Fp, Gs^Fp, Ds, Ww, Ww, Wo, Wo, Wo, Wo, Wo, Wo, Wo, Wo, Ww, Ww^Bw\, Ww, Ch, Gs, Ss, Ss^Edt, Ss, Ss, Gs^Fds, Gs^Fds, Gs^Fds, Gs^Fds, Gs^Fds
Wo, Wo, Wo, Wo, Wo, Wo, Wo, Wo, Wo, Ww, Ww, Gs^Fp, Gd^Dr, Ww^Bw/, Ww, Ww, Wo, Wo, Wo, Wo, Ww, Wo^Edt, Ww^Dr, Ww^Edt, Ww, Re, Ch^Kov, Gs, Gs^Edt, Gs^Edt, 3 Gs, Gg, Gg, Gg, Gg, Gs^Fds, Gg
Wo, Wo, Wo, Wo, Wo, Wo, Wo, Ww, Wo, Wo, Ww, Gd, Gd, Ww, Ww, Wo, Wo, Wo, Ww, Ww, Ww, Ww, Ww, Ww^Dr, Ds^Edt, Rr, Rr^Vhc, Ch^Dr, Gs^Edt, Gg^Dr, Gd^Dr, Gs, Re, Re, Re, Re, Re
Wo, Wo, Wo, Wo, Wo, Wo, Ww, Ww, Ww, Ww, Ww, Ww, Gs, Ww, Wo, Wo, Ww, Ww, Ww, Ww, Ww^Edt, Ww, Ww^Edt, Ww^Bw\, Ds, Rr, Gs^Edt, Rr, Rr^Edt, Rr^Dr, Rr, Rr, Gg, Re, Re^Edt, Re^Edt, Gg
Wo, Wo, Wo, Wo, Wo, Wo, Ww, Gs^Fp, Ww, Wo, Wo, Ww, Ww, Ww, Wo, Wo, Wo, Ww, Ww, Ww, Ww^Edt, Ww^Dr, Ww^Dr, Ww^Dr, Ds^Edt, Ds^Edt, Rr, Rr^Dr, Rr^Edt, Rr, Ch^Dr, Gg, Re^Gvs, Re, Gg^Edt, Re, Re
Wo, Wo, Wo, Wo, Wo, Wo, Ww, Gs, Ww, Wo, Wo, Ww, Ww, Ww, Ww, Wo, Wo, Wo, Ww, Ww, Ww^Bw\, Ww, Ss, Ss, Gd^Dr, Gd^Dr, Rr^Edt, Gs^Ebn, Rr^Dr, Gg^Vhc, Rb^Gvs, Re^Gvs, Re^Gvs, Ce^Edt, 2 Ke, Ce, Gg
Wo, Wo, Wo, Wo, Wo, Wo, Ww, Ww, Ww, Wo, Wo, Wo, Wo, Ww, Wo, Wo, Wo, Ww, Ww^Dr, Ww, Ww, Ds^Dr, Ds^Dr, Gs^Vhc, Rr^Edt, Rr^Dr, Gd^Dr, Rr, Rb^Dr, Re^Dr, Rb^Gvs, Rb^Gvs, Re^Gvs, Re^Gvs, Ce, Ce^Edt, Gg^Edt
Ww, Ww, Wo, Wo, Wo, Wo, Wo, Ww, Wo, Wo, Wo, Wo, Wo, Ww, Wo, Wo, Wo, Ww, Ww, Ww^Bw\, Ds^Edt, Ds^Ebn, Gs^Dr, Rr^Dr, Rr, Ch^Dr, Ch^Kov, Ch^Edt, Re, Rb^Gvs, Re^Gvs, Re^Gvs, Re^Gvs, Re^Gvs, Rb^Eff, Gg^Edt, Gs^Fp
Ww, Ww, Ww, Ww, Wo, Wo, Wo, Ww, Ww, Wo, Wo, Wo, Wo, Ww, Ww, Wo, Ww, Ww^Edt, Ww, Ch, Gs, Rr^Vhc, Rr, Rr, Gd^Dr, Ch, Rr^Vhc, Re^Edt, Re, Re, Re, Re^Gvs, Rb^Eff, Re^Eff, Gs^Fms, Gs^Fms, Gs^Fms
Ds, Ds, Ww, Ww, Ww, Wo, Ww, Ww, Ww, Wo, Wo, Wo, Ww, Ww, Ww, Ww, Ww^Edt, Ww^Edt, Ch, 5 Kh, Ch, Rr, Rr^Dr, Rr, Gs^Ebn, Gs, Gs, Gg^Edt, Gg, Gs^Fds, Gs^Fds, Re^Eff, Gg, Gs^Fms, Gs^Fms, Gs^Fp, Gs^Fp
Ds, Ds, Ds, Ds, Ww, Ww, Ww, Ww, Ww, Wo, Wo, Wo, Ww, Ww, Ww, Ww, Ww, Ww, Gs, Rr, Rr^Ebn, Gs^Edt, Rr^Edt, Ch, Ch, Gs, Rb^Gvs, Re^Gvs, Re^Gvs, Gs^Fds, Gs^Vl, Gs^Fds, Gg, Gg, Gg, Gs^Fp, Gs^Fp
Gs, Gd^Vhr, Gs, Gs, Ww, Ww, Ww, Ww, Ww, Wo, Wo, Ww, Gg, Ww, Ww, Gg, Ch, Ch^Kov, Ch, Rr^Vhc, Gs, Rr, Rr^Vhc, Ch^Dr, Re^Gvs, Re^Gvs, Re^Gvs, Re^Gvs, Re^Gvs, Re^Gvs, Re^Gvs, Re^Gvs, Gg, Gg, Gs^Fp, Gs^Fp, Hh
Gs, Gs, Gs, Ss, Ss, Gs, Ds, Ww, Ww, Ww, Ww, Ww, Gs, Gs, Ss, Gs, Gs, Gg, Gs, Gs, Re^Edt, Rr^Edt, Ss, Rb^Gvs, Rb^Gvs, Re^Gvs, Rb^Gvs, Rb^Gvs, Rb^Gvs, Re^Gvs, Re^Gvs, Re^Gvs, Gg, Gs^Fp, Gs^Fp, Hh^Fp, Hh^Fp
Rb^Gvs, Rb^Gvs, Rb^Gvs, Gs, Ss, Gs, Re^Gvs, Gs, Ww, Ww, Ds, Gs^Fds, Gs, Ss, Ss, Gs^Edt, Rb^Edt, Rb, Re, Re, Re^Gvs, Ss^Edt, Re^Eff, Re, Rb^Gvs, Rb^Gvs, Re^Gvs, Rb^Gvs, Rb^Gvs, Re^Gvs, Re^Gvs, Re^Gvs, Gg, Gs^Fp, Hh^Fp, Hh^Fp, Hh^Fp
Re^Gvs, Rb^Gvs, Rb^Gvs, Rb^Gvs, Re^Gvs, Re^Gvs, Re^Gvs, Re^Gvs, Rb^Gvs, Ds, Ds, Ds, Gg, Gs, Gs^Fds, Gs^Edt, Rb, Re^Gvs, Re^Gvs, Re^Gvs, Re^Gvs, Rb^Gvs, Re^Gvs, Re^Eff, Re^Eff, Re^Gvs, Re^Gvs, Rb^Gvs, Re^Gvs, Re^Gvs, Gg, Gg, Hh, Gg, Hh^Vhh, Hh, Hh^Qhh
Gs^Edt, Re^Gvs, Cer, Rb^Gvs, Rb^Gvs, Rb^Gvs, Rb^Gvs, Rb^Gvs, Hh, Hh, Gs^Fds, Gs^Fms, Gs^Fds, Gg, Gs^Fds, Gs^Fds, Rb, Re^Gvs, Re^Gvs, Re^Gvs, Re^Gvs, Re^Gvs, Re^Gvs, Re^Gvs, Gg^Eff, Gs^Eff, Gs^Fms, Re^Gvs, Gs^Fms, Gg, Hh, Hh, Hh, Hh, Hh^Qhh, Hh^Qhh, Hh^Qhh
Gs^Edt, Cer^Edt, 4 Ker, Rb^Gvs, Rb^Gvs, Re^Gvs, Re^Gvs, Rb^Gvs, Rb^Gvs, Hh, Hh^Fms, Gs^Fms, Gg, Gs^Fds, Re, Re, Re^Gvs, Re^Gvs, Re^Gvs, Re^Gvs, Re^Gvs, Re^Gvs, Gg^Eff, Gg^Eff, Gg, Gs^Fms, Gs^Fms, Gs^Fms, Gs^Fms, Gg, Gg, Hh, Hh, Hh^Qhh, Mm, Mm, Mm^Qhh
Gs, Cer, Gs, Re^Gvs, Rb^Gvs, Re^Gvs, Re^Gvs, Re^Gvs, Gd^Vhr, Hh, Gs^Fms, Gg, Gg, Gs^Fds, Re, Re^Gvs, Re^Gvs, Re^Gvs, Re, Hh, Gg, Gs, Gs^Vl, Gg, Gg, Gs^Fms, Gg, Gg, Re^Gvs, Re^Eff, Re^Eff, Hh, Hh, Hh^Qhh, Hh^Qhh, Mm, Mm^Qhh
Ss, Ss, Gs^Edt, Cer^Edt, Gs^Fp, Rb^Gvs, Gs, Gs^Edt, Gs^Fms, Gs^Fms, Gs^Fms, Gs^Fms, Gg, Gg, Re, Gg, Re^Gvs, Re^Gvs, Hh, Hh^Fms, Hh^Fms, Gs^Fms, Gg, Gg, Gg, Gs^Fms, Re^Gvs, Re^Gvs, Rb^Gvs, Re^Gvs, Rb^Gvs, Re^Eff, Re^Eff, Hh, Hh^Qhh, Hh, Hh^Qhh
Gs, Gs, Gg^Edt, Gg^Edt, Gs^Fp, Gs^Fp, Gs, Gs^Edt, Rb^Gvs, Gs^Fms, Gs^Fms, Hh, Gs^Fms, Gs^Fms, Re, Gs^Fms, Gs^Fms, Gs^Fms, Hh, Hh, Gs^Fds, Gs^Fds, Re^Gvs, Gg, Re^Gvs, Re^Gvs, Re^Gvs, Re^Gvs, Rb^Gvs, Rb^Gvs, Rb^Vh, Re^Eff, Gg, Hh, Hh^Qhh, Mm, Mm^Qhh
Gg, Gg, Gg, Gg, Gg, Gs^Fp, Re^Gvs, Rb^Gvs, Re^Gvs, Rb^Gvs, Hh^Fms, Hh, Hh, Gs^Fms, Re, Gs^Fms, Gs^Fds, Gs^Fds, Gs^Fds, Gs^Fms, Gg, Gs^Fms, Rb^Gvs, Re^Gvs, Rb^Gvs, Rb^Gvs, Re^Gvs, Re^Gvs, Rb^Gvs, Rb^Gvs, Hh, Hh, Gg, Hh, Hh^Qhh, Mm, Mm^Qhh
Gll^Fp, Gll^Fp, Gll^Fp, Gg, Gg, Gg, Re^Gvs, Rb^Gvs, Rb^Gvs, Rb^Gvs, Re^Gvs, Hh, Hh, Gs^Fds, Gs^Fds, Re, Gg, Gs^Fds, Gg, Gs^Fms, Rb^Gvs, Rb^Gvs, Rb^Gvs, Rb^Gvs, Rb^Gvs, Rb^Gvs, Rb^Gvs, Re^Gvs, Rb^Gvs, Re, Hh, Hh, Hh^Qhh, Hh^Qhh, Hh, Hh, Hh^Qhh
Gll^Fp, Gll^Fp, Gll^Fp, Gg, Gg, Gg, Gll^Fds, Re^Gvs, Re^Gvs, Re^Gvs, Re^Gvs, Re^Gvs, Re^Gvs, Gg, Gs^Fds, Re, Re, Gg, Gg, Rb^Gvs, Rb^Gvs, Rb^Gvs, Rb^Gvs, Rb^Gvs, Rb^Gvs, Rb^Gvs, Re, Rb^Gvs, Ce, Gg, Hh, Hh^Qhh, Mm, Mm, Mm, Hh^_mh, Hh^Qhh
Gll^Fp, Gll^Fms, Gll^Fms, Gg, Gll^Fds, Gs^Vl, Gll^Fds, Gg, Gg, Re^Eff, Rb^Eff, Rb^Gvs, Re^Gvs, Re^Gvs, Gs^Fds, Gg^Vh, Re, Gg, Gs^Fms, Gg, Gs^Fds, Re, Rb^Gvs, Rb^Gvs, Gs^Fds, Gs^Fds, Gg, Ce, 1 Ke, Gg, Gg, Hh^Qhh, Hh^Qhh, Mm, Mm, Hh, Hh^Qhh
Gll^Fp, Gll^Fp, Gll^Fms, Gg, Gll^Fms, Gll^Fds, Gll^Fds, Gll^Fds, Gll^Fds, Gll^Fds, Gg, Re^Eff, Re^Eff, Re^Eff, Gg, Gg, Re, Gg, Hh, Gs^Fp, Gs^Fms, Gg, Gg, Gg, Gs^Fms, Gs^Fds, Gs^Fds, Ce, Gg^Efm, Gg, Gg^Efm, Gg, Hh, Hh^Qhh, Mm^Qhh, Mm, Mm^Qhh
Gll^Fp, Gll^Fms, Gll^Fp, Gll^Fms, Gll^Fds, Gll^Fds, Gll^Fds, Gll^Fds, Gll^Fds, Gg, Gg, Gg, Gg, Gg, Re, Re, Gg, Gg, Hh^Fp, Gs^Fp, Gg, Gg, Gg, Gg, Gg, Gs^Fms, Gs^Fds, Gg, Gg, Gg^Efm, Gg^Efm, Gg^Efm, Gg, Hh, Mm^Qhh, Mm, Mm^Qhh
Gll^Fms, Gll^Fp, Gll^Fp, Gll^Fms, Gll^Fds, Gll^Fds, Gll^Fds, Gll^Fds, Gll^Fms, Gll^Fds, Gll^Fds, Gll^Fds, Gg, Gg, Re, Re, Hh, Gg, Hh, Hh, Gg, Gs^Vl, Gg, Gg, Gs^Fms, Gs^Fds, Gs^Fms, Gs^Fds, Gg, Gg^Efm, Gg^Efm, Gg^Efm, Gg^Efm, Gg, Hh, Hh^Qhh, Hh^Qhh
Gll^Fms, Gll^Fms, Gll^Fp, Gll^Fms, Gll^Fms, Gll^Fds, Gll^Fms, Gll^Fms, Gll^Fms, Gll^Fds, Gs^Fms, Gll^Fds, Re, Re, Gg, Gg, Hh^Fp, Hh^Fp, Hh^Fp, Hh, Gg, Gg, Gg, Gg, Gs^Fds, Gs^Fds, Gs^Fms, Gs^Fds, Gg, Gg^Efm, Gg, Gg^Efm, Gg^Efm, Gg^Efm, Hh, Hh, Hh
