Wo, Wo, Wo, Wo, Wo, Wo, Wo, Ww, Wo, Wo, Wo, Wo, Wo, Wo, Wo, Wo, Wo, Wo, Wo, Wo, Wo, Wo, Wo, Wo, Wo, Ww, Ww, Ww, Ww, Ww, Ww, Ww, Ww, Ww, Ww, Ww
Wo, Wo, Wo, Wo, Wo, Wo, Wo, Ww, Wo, Wo, Wo, Wo, Wo, Wo, Wo, Wo, Wo, Wo, Wo, Wo, Wo, Wo, Wo, Wo, Wo, Ww, Ww, Ww, Ww, Ww, Ww, Ww, Ww, Ww, Ww, Ww
Wo, Wo, Wo, Wo, Wo, Wo, Wo, Wo, Wo, Wo, Wo, Wo, Wo, Wo, Wo, Wo, Wo, Wo, Wo, Ww, Ww, Wo, Wo, Wo, Wo, Wo, Ww, Ww, Ww, Ww, Ww, Ww, Ww, Ww, Wo, Wo
Wo, Wo, Wo, Wo, Wo, Wo, Wo, Wo, Ww, Wo, Wo, Wo, Wo, Wo, Wo, Wo, Wo, Wo, Wo, Wo, Wo, Wo, Wo, Wo, Wo, Wo, Ww, Ww, Ww, Ww, Ww, Ww, Ww, Ww, Ww, Ww
Wo, Wo, Wo, Wo, Wo, Wo, Ww, Ww, Ww, Ww, Ww, Ww, Ww, Wo, Ww, Wo, Wo, Wo, Wo, Wo, Wo, Wo, Ww, Wo, Ww, Ww, Ww, Ww, Ww, Ww, Ww, Ww, Ww, Ww, Ww, Ww
Wo, Wo, Wo, Wo, Ww, Ww, Ww, Ww, Ww, Ww, Ww, Ww, Ww, Ww, Ww, Ww, Wo, Wo, Wo, Wo, Wo, Wo, Ww, Ww, Ww, Ww, Ww, Ww, Ww, Ww, Gg, Gg, Gs, Gs, Re^Gvs, Rb^Gvs
Ww, Ww, Wo, Wo, Ww, Ww, Ww, Ww, Rr, Gg, Rr, Ww^Bw/, Ww, Ww, Ww, Ww, Ww, Wo, Wo, Wo, Wo, Wo, Ww, Ww, Ww, Ww, Ww, Ww, Rr, Rr^Vhc, Ch, Re^Gvs, Re^Gvs, Re^Gvs, Rb^Gvs, Rb^Gvs
Ww, Ww, Ww, Ww, Ww, Ww, Ww, Gs, Ch, Rr^Vhc, Rr^Ebn, Gs, Rr^Vhc, Ww, Rr, Ww^Bw/, Ww, Ww, Ww, Wo, Ww, Ww, Ww, Ww, Ww^Bw\, Ww, Ww, Ww^Bw\, Rr, 3 Ch^Kov, Gg, Re^Gvs, Rb^Gvs, Rb^Gvs, Rb^Gvs, Rb^Gvs
Ww, Ww, Ww, Ww, Ww, Ww, Ww, Ch, Rr^Vhc, Gs, Rr, Ch, 2 Kh, Ch, Rr, Gs, Gg^Fds, Ww, Ww, Ww, Ww, Ww^Bw\, Rr, Ww, Rr, Rr, Rr^Ebn, Rr, Rr, Ch, Re^Gvs, Rb^Gvs, Rb^Gvs, Rb^Gvs, Gs, Rb^Gvs
Ww, Ww, Ww, Ww, Ww, Ww, Ch, Ch, Gs, Rr, Rr, Rr, Ch, Rr, Rr^Vhc, Rr^Vhc, Gs^Fms, Gg^Fds, Rr, Ww, Ww^Bsb/, Rr, Rr, Rr, Rr, Rr^Vhc, Rr, Rr^Vhc, Rr, Rr, Rr, Gg, Rr, Rr, Rr, Rr
Ww, Ww, Ww, Ww, Ww, Ds, Gg, Gg, Rr^Ebn, Rr, Rr, Rr, Rr, Rr, Rr, Rr^Ebn, Rr, Rr, Rr, Rr, Ww, Rr, Gg, Ch, Gg, Gg^Fds, Gg^Fms, Ch, Gg, Rr, Gg, Rr, Gg, Gg, Rb, Rb
Ds, Ww, Gg, Ww, Ds, Ds, Rr, Rr, Gg, Rr^Vhc, Ch, Gs^Fms, Gg, Rr, Gg^Fds, Rr, Gg, Rr, Ch, Gg, Ww, Gg, Re, Re, Re^Gvs, Gg, Re^Gvs, Gg, Gg, Gg, Rb^Gvs, Rb^Gvs, Re^Gvs, Rb^Gvs, Rb^Gvs, Rb
Rr, Ds, Rr, Gg, Rr, Rr, Rr, Gg, Gs^Fms, Ch, Gg, Ch, Gg, Re, Ch, Ch, Gg, Gg, Gg, Gg, Ww, Ce, 4 Ke, Re, Re^Gvs, Re^Gvs, Rb^Gvs, Rb^Gvs, Re^Gvs, Rb^Gvs, Gs^Vh, Re^Gvs, Re^Gvs, Rb^Gvs, Re, Re
Gg^Qhh, Rr, Gg^Qhh, Rr, Gg, Rr, Gg, Gs, Gs, Gg, Gg^Fds, Gg, Gg, Re, Gs^Fms, Gs^Fms, Gg, Gg, Ww, Ww, Gg, Ce, Ce, Re^Vct, Rb^Gvs, Rb^Gvs, Rb^Gvs, Rb^Gvs, Rb^Gvs, Rb^Gvs, Rb^Gvs, Re^Gvs, Re, Rb^Gvs, Re^Gvs, Re
Gg^Qhhf, Gg^Qhh, Gg^_mh, Gg^Qhh, Gg^Qhh, Gg, Gg, Gs, Gs, Gg^Fds, Gg^Fds, Gg^Fds, Gg, Re, Gg, Gg, Gg^Fds, Gs^Fds, Ww, Gs^Fds, Gg, Gg, Gg, Rb^Gvs, Rb^Gvs, Rb^Gvs, Rb^Gvs, Rb^Gvs, Re^Gvs, Re^Gvs, Re^Gvs, Re^Gvs, Re^Gvs, Re^Gvs, Re^Gvs, Re
Gg^Qhhf, Gg^Fds, Gg^Qhhf, Gg^Qhh, Gg^Fds, Gg^Qhhf, Gg^Qhh, Gs^Qhh, Gs^Qhh, Gs, Gs, Gs^Fms, Gg, Re, Gg^Fds, Gg^Vl, Gg^Fds, Gs^Fds, Ww, Ww, Ww, Gg, Rb^Gvs, Rb^Gvs, Rb, Rb, Rb, Re^Gvs, Rb, Rb^Gvs, Rb^Gvs, Rb^Gvs, Rb^Gvs, Re^Gvs, Rb^Gvs, Rb
Gg^Qhhf, Gg^Fds, Gg^Fds, Gg^Qhh, Gg, Gg, Gg^Fms, Gg^Fms, Gg^Fds, Gg^Qhh, Gs^Qhh, Gg, Gg^Qhh, Re, Gg, Gg^Fds, Ww, Ww, Rb^Gvs, Rb^Gvs, Ww, Gg, Gg, Gg, Ww, Gg, Ww, Rb, Rb, Re^Gvs, Rb^Gvs, Rb^Gvs, Rb^Gvs, Rb^Gvs, Rb, Rb
Gg^Qhh, Gg^Qhh, Cer, Re^Qhh, Cer, Gg, Gg, Gg^Fms, Gg, Gg, Gg, Gg^Qhh, Gg^Fds, Re, Gg^Qhh, Ww, Gg, Rb^Gvs, Rb^Gvs, Rb^Gvs, Re, Wwf, Wwf, Ww, Gs^Fds, Ww, Gs^Fds, Ww, Gg, Rb, Rb^Gvs, Gs^Vh, Re^Gvs, Rb^Gvs, Rb^Gvs, Gg
Gg^Qhh, 5 Ker, Cer, Re^Qhh, Re, Re, Re^Gvs, Gg^Vhr, Re^Gvs, Re^Gvs, Gs^Fms, Gg, Gg, Re, Re, Wwf, Gg^Qhh, Re^Gvs, Gs^Vh, Rb^Gvs, Rb^Gvs, Re, Gg, Gg, Re^Gvs, Gg, Gg, Ww, Wwf, Gg, Re, Re^Gvs, Re^Gvs, Re^Gvs, Re^Gvs, Gs
Gg^Qhh, Cer, Re^Gvs, Re, Re^Gvs, Re^Gvs, Rb^Gvs, Re^Gvs, Re^Gvs, Re, Gg^Fds, Gg^Fds, Ce, Ce, Ce, Wwf, Re^Gvs, Re^Gvs, Re^Gvs, Rb^Gvs, Rb^Gvs, Rb^Gvs, Rb^Gvs, Re^Gvs, Rb^Gvs, Rb^Gvs, Rb^Gvs, Gg, Wwf, Gg, Gg, Gg, Gg, Re^Gvs, Re^Gvs, Gg
Re^Gvs, Re^Gvs, Re^Gvs, Re^Vhr, Rb^Gvs, Re^Gvs, Rb^Gvs, Re^Gvs, Re^Gvs, Re, Re, Gg, Ce, Ke, Ce, Wwf, Re^Gvs, Rb^Gvs, Rb^Gvs, Re^Gvs, Re^Gvs, Rb^Gvs, Rb^Gvs, Rb^Gvs, Rb^Gvs, Rb^Vwm, Rb^Gvs, Gg, Re, Wwf, Wwf, Gg, Gg, Gg, Gg, Gg
Rb, Rb^Gvs, Rb^Gvs, Rb^Gvs, Re^Gvs, Re^Gvs, Re^Gvs, Re^Gvs, Re, Re^Gvs, Re^Gvs, Re^Gvs, Gg^Fds, Re, Gg^Fms, Wwf, Gg^Fds, Re, Re, Rb^Gvs, Rb^Gvs, Rb^Gvs, Rb^Gvs, Rb^Gvs, Rb^Gvs, Re^Gvs, Re^Gvs, Re^Gvs, Rb, Re, Gg, Ww, Gg, Gg, Gg, Gg
