Wog, Wog, Wog, Wog, Wog, Wog, Wog, Wog, Wog, Wo, Wo, Wo, Wo, Wo, Wo, Wo, Wo, Wo, Wo, Ww, Ww, Ww, Wwt, Wwrt, Wwf^Wkf, Dd, Rrd, Gg, Gg^Es, Gs, Gs^Fms, Gs^Fds, Gs^Fds, Gs^Fds
Wog, Wog, Wog, Wog, Wog, Wog, Wo, Wog, Wo, Wo, Wo, Wo, Wo, Wo, Wo, Wo, Wo, Ww, Ww, Ww, Wwt, Wwt, Wwrt, Wwrt^Wkf, Wwf^Wkf, Dd, Dd, Gg, Gs^Vl, Gg, Gs, Gs^Fds, Gs^Fms, Gs^Fds
Wog, Wog, Wog, Wo, Wo, Wo, Wo, Wo, Wo, Wo, Wo, Wo, Ww, Ww, Ww, Wo, Ww, Ww, Ww, Ww, Wwrt, Wwrt, Wwf^Es, Wwrt^Wkf, Wwf^Wkf, Wwf^Wkf, Dd, Gg, Gs^Efm, Gs, Gs, Gs^Fds, Gs^Fds, Gs^Fds
Wog, Wog, Wo, Wo, Wo, Wo, Wo, Wo, Ww, Wo, Wo, Ww, Ww, Ww, Ww, Ww, Ww^Vm, Ww, Ww, Wwt, Wwrt, Wwf^Es, Wwt, Wwf, Ww^Vm, Wwf^Wkf, Dd, Gg, Gs, Gs, Gs^Fms, Gs^Fds, Gs^Fds, Gs^Fds
Wog, Wog, Wo, Wo, Wo, Wo, Wo, Ww, Ww, Wo, Ww, Ww, Ww^Wkf, Ww, Ww^Vm, Rb, Gd, Wwr, Ww^Wkf, Wwt, Wwt, Wwt, Wwt, Wwt, Wot, Wwf, Wwf, Dd, Gs, Gg, Gs, Gs^Fms, Gs^Fds, Gs^Fds
Wog, Wog, Wo, Wo, Wo, Wo, Ww, Ww, Ww, Ww, Wwf, Wwf, Gd, Wwr, Gll, Rb, Cme, Wwr, Dd, Ww^Vm, Wwrt, Wwt, Wwt^Wkf, Wot, Wot, Wot, Wwf, Dd, Rrd, Gg^Vl, Gs, Gs^Fms, Gs^Fms, Gs^Fds
Wo, Wo, Wo, Wo, Ww, Ww, Ww, Ww, Ww, Wwr, Wwf, Gll, Gll, Gd^Es, Rb, Gll, Cme, Rrd, Gd, Wwf^Es, Wwf^Es, Wwrt^Wkf, Wwrt^Wkf, Wwt^Wkf, Wwt, Wot, Wwf, Dd^Ewsh, Dd^Ewsh, Gs, Gg^Efm, Gs, Gs^Es, Gs^Fds
Wo, Wo, Wo, Wo, Ww, Ww, Wwg, Wwg, Ww, Wwr, Gll, Gll, Ww^Wkf, Ww^Vm, Wwr, Cme, Kme, Cme, Gll^Es, Dd, Wwf, Wwf, Wwrt, Wwf^Es, Wwrt, Wwt, Wwt, Wwf, Wwf, Gs, Gs^Efm, Gs^Efm, Gs, Gs^Fds
Wo, Wo, Wo, Ww, Ww, Ww, Ww, Wwg, Wwg^Es, Wwg^Es, Wwrg, Wwg, Wwg^Es, Ww, Gd, Cme, Cme, Cme, Rrd, Rrd, Ds, Wwrt, Wwf, Wwrt, Wwrt, Wwrt, Wwrt, Wwt, Wwt, Wwf, Wwt, Gs, Gs, Gs
Wo, Wo, Wo, Wo, Ww, Ww, Ww, Wwg, Wwrg, Wwrg^Dr, Xur^Qhh, Wwrg^Dr, Wwrg, Wwg, Wwg^Bw/r, Rb, Rrd, Gd, Wwf, Ds^Ewsh, Wwrt^Wkf, Wwf, Wwf^Wkf, Ds, Ds, Wwf^Es, Ds, Ww^Wkf, Wwf^Es, Wwt, Wwt, Wwt, Wwt, Wwt
Wo, Wo, Wo, Wo, Ww, Ww, Wwg, Wwg^Es, Wwrg^Dr, Xur^Qhh, Uu^Es, Xur^Efs, Rr^Pw\o, Wwg^Bw/r, Wwg^Wkf, Dd, Ww^Vm, Dd, Wwrt, Wwrt, Ww^Wkf, Wwrt^Wkf, Wwrt, Ds, Wwrt, Wwf^Wkf, Ds, Wwf, Ds^Es, Gg, Gg, Wwt, Wwt, Wwt
Wo, Wo, Wo, Ww, Ww, Wwg, Ww, Wwg^Es, Wwrg^Dr, Xur^Qhh, Urb, Uu^Es, Xur^Qhh, Xur^Qhh, Wwr, Ww, Wwt, Wwrt, Wot, Wwt, Wot, Wwt, Wwt, Wwf^Es, Wwf^Es, Wwrt, Wwf, Wwf, Gg, Gg, Gg^Es, Gg, Gg, Gg
Wo, Wo, Ww, Ww, Ww, Ww, Ww, Wwrg, Wwrg, Xur^Qhh, Xur^Qhh, Uu^Es, Xur^Qhh, Wwrg^Dr, Wwrg^Es, Wwg, Wwt, Wot, Wot, Wot, Wot, Wwt, Wwrt, Ww^Vm, Ww^Wkf, Wwrt, Wwrt, Ds^Ewsh, Gg, Gg, Gs, Gs, Gg, Gg
Wo, Wo, Ww, Ww, Ww, Ww, Wwg, Wwg, Wwg^Es, Wwrg^Dr, Wwrg^Dr, Xur^Qhh, Wwrg^Dr, Wwrg^Dr, Wwg^Es, Wwt, Wwt, Wwt, Wwt, Wot, Wwrt, Wwrt, Wwf^Es, Wwt, Wwf^Es, Ww^Wkf, Wwf, Ds, Gs, Gs, Gs, Gs, Gs^Es, Hh
Wo, Wo, Wo, Ww, Ww, Ww, Wwg, Ww, Ww, Wwg^Es, Wwrg, Wwrg, Wwt, Wwg^Es, Wwt, Wwrt, Wwrt, Wwt, Wwt, Wwt, Wwrt, Wwf^Es, Wwf^Es, Wwf, Wwf, Wwf^Es, Ds^Ewsh, Ds, Gs, Gs, Gs, Gs, Hh, Hh
Wo, Wo, Ww, Ww, Ww, Ww, Ww, Ww, Ww, Ww, Wwg, Wwt, Wwt, Wwt, Wwt, Wwrt, Wwt, Wwt, Wwt, Wwt, Wwt, Wwt, Wot, Wwt, Ww^Vm, Wwf^Wkf, Ds, Rrd, Gs, Gs, Gs, Gs^Es, Hh, Hh
Wo, Ww, Ww, Ww, Ww, Ww, Ww, Ww, Ww, Ww, Ww, Wwg, Wwrt, Wwrt, Wwt, Wwt, Wwt, Wwt, Wwrt, Wwt, Wwrt, Wot, Wot, Wwt^Wkf, Wwf^Wkf, Wwf^Wkf, Ds, Gg, Gs, Gg, Gs, Hh, Hh^Fms, Hh^Fms
Ww, Ww, Ww, Ww, Ww, Ww, Ww, Ww, Ww, Ww, Ww, Wwt, Wwt, Wwrt, Wwt, Wwt, Wwt, Wwt, Wwt, Wwf^Es, Wwf^Es, Wwrt, Wwrt, Wwt, Wwf, Ds, Gg^Vh, Gg, Gg, Gs^Es, Hh, Hh^Fds, Hh^Fds, Hh^Fms
Ww, Ww, Ww, Ww, Ww, Ww, Ww, Ww, Ww, Ww, Wwt, Ww, Wwt, Wwt, Wwrt, Wwrt, Wwt, Wot, Wot, Wwt, Ww^Vm, Wwf^Es, Wwrt^Wkf, Wwf, Ds^Ewsh, Ds, Gs, Gs, Gs, Gs, Gg, Hh, Hh, Hh^Fms
Wwt, Ww, Ww, Ww, Ww, Ww, Ww, Ww, Wwt, Ww, Wwt, Wwt, Wwt, Wwt, Ww^Vm, Wwf^Es, Wwt^Wkf, Wot, Wwt, Wwt, Wwf^Wkf, Wwf^Es, Wwf^Wkf, Wwf, Ds, Ds, Gs, Gs, Gs, Gg, Gs, Gs, Hh, Hh
Wwt, Ww, Wwt, Ww, Ww, Ww, Wwt, Wwt, Wwt, Wwt, Wwrt, Wwrt, Wwrt, Wwt, Wwt^Wkf, Wwf^Es, Wwrt, Wwt, Wwf^Es, Wwrt^Wkf, Wwf^Wkf, Wwf^Wkf, Rrd, Rrd, Gs, Gs, Gg, Gs, Gg, Gg, Gs, Gs, Gg, Hh
Wwt, Wwt, Wwt, Wwt, Wwt, Wwt, Wwt, Wwt, Wwrt, Wwt, Wwt, Wwf^Es, Wwf^Es, Wwt^Wkf, Wwt^Wkf, Wwf, Wwrt, Wwrt, Wwf^Es, Wwf, Ds, Rrd, Rrd, Rrd, Gs, Gs, Gg^Es, Gs, Gs, Gs, Rd, Gg, Rp, Gg
Wwt, Wwrt, Wwrt, Wwt, Wwt, Wwt, Wwrt, Wwrt, Wwf^Es, Ww^Vm, Wwt, Wwt, Wwt, Wwf, Wwf, Wwf, Wwf, Wwf^Es, Ds, Ds^Ewsh, Ds^Ewsh, Ds, Gg, Gs, Gg, Gg, Rp, Rd, Rp, Rd, Gs, Rp, Gg^Es, Rp
Wwrt^Wkf, Wwrt^Wkf, Wwrt^Wkf, Wwt, Wwt, Wwrt, Wwrt, Wwf^Es, Wwf^Es, Wwt, Wot, Wot, Wwt, Wwf, Wwf^Wkf, Wwf^Wkf, Rrd, Ds, Gg, Ds, Gg, Gg, Gg^Em, Gg, Rp, Rd, Gg, Gs, Gg^Vh, Gs, Gs, Gs, Gg, Gg
Wwf^Wkf, Wwf^Wkf, Wwf^Wkf, Wwrt^Wkf, Wwt, Wwt, Wwrt, Wwf, Wwf^Wkf, Wwrt^Wkf, Wwt^Wkf, Wwt, Ds^Ewsh, Wwf^Es, Rrd, Rrd, Gg, Ds, Gg^Es, Gg, Gg, Gg^Vh, Rp, Rp, Gg, Gs, Gg, Gg, Hh, Gs, Gs, Hh, Hh, Hh
Rrd, Rrd, Rrd, Wwf^Es, Wwf, Wwt, Wwt, Wwf, Wwf^Wkf, Wwf^Wkf, Ds, Ww^Vm, Ds, Rrd, Rrd, Rrd, Gg, Gg, Gg, Gg, Rp, Rd, Gg, Gg, Gg^Es, Gg, Gg, Hh^Fds, Hh^Fds, Gs, Hh, Hh, Hh^Fds, Hh^Fds
Gg, Gs, Gg, Ds, Wwf, Wwt, Wwt, Wwf, Rrd, Ds^Ewsh, Gg, Ds, Gg^Efm, Gg^Efm, Gg, Gg, Rd, Rd, Rd, Rd, Gg, Gg, Gg^Efm, Gg, Gg, Gg, Gs, Gg, Gs^Es, Gs, Co, Hh, Hh, Hh^Fds
Gg, Gg, Gg, Ds, Wwt, Wwt, Wwt, Rrd, Rrd, Rrd, Gg^Vh, Gg, Gg, Gg, Rd, Rp, Gg^Vh, Gg, Gg, Gg, Gg^Efm, Gg^Efm, Gg, Gg^Efm, Gg, Gg, Hh^Fds, Gs, Gd, Rb^Edb, Co, Ko, Co, Hh^Fms
Gs, Gg, Gg, Ds, Wwt, Gs^Vht, Wwt, Ds, Gg^Es, Gg, Rr, Gg, Rr, Rp, Gg, Gg, Gg, Gg, Gg^Fms, Gg, Gg^Efm, Gg^Efm, Gg, Gg, Gg, Gg^Es, Gs, Gd, Rb^Edb, Rb^Edb, Co, Co, Rb, Hh^Fms
Gs, Gg, Gg, Ds, Wwt, Wwt, Wwt, Ds, Rr, Rr, Gg, Rp, Gg, Gg, Gg^Efm, Gg^Efm, Gg, Gg^Fds, Gg^Fms, Gg^Fds, Gg, Gg, Gg, Gg, Hh, Gs, Hh, Hh, Hh, Rb^Edb, Rb, Rb^Vo, Rb^Edb, Hh^Fms
Gs, Gs, Gg, Ds, Wwf, Wwf, Wwf, Ds, Gg, Gg, Gg^Efm, Gg, Gg^Es, Gg, Gg, Gg^Efm, Gg, Gg^Em, Gs^Fms, Gg^Fms, Gs^Fds, Gs, Gs^Es, Gs^Es, Hh^Fds, Hh, Hh, Hh, Hh^Fms, Hh, Hh^Fds, Rb^Edb, Hh^Fds, Hh^Fds
Gg, Gs, Gg, Ds, Wwf, Wwf, Wwf, Ds, Gg, Gg^Efm, Gg, Gg, Gg, Gg, Gg, Gg, Gg, Gg, Gg, Gs^Fms, Gs^Fds, Gs, Gs, Hh^Fds, Hh^Fms, Hh^Fms, Hh, Hh, Hh^Fms, Hh^Fms, Hh^Fms, Hh^Fds, Hh^Fds, Hh^Fds
