Ch^Qhh, Gg^Qhh, Kh^Qhh, Xom^Qhh, Xom^Qhh, Xom^Qhh, Xom^Qhh, Xom^Qhh, Xom^Qhh, Xom^Qhh, Xom^Qhh, Ww, Ww, Gg^Qhh, Xom^Qhh, Xom^Qhh, Xom^Qhh, Xom^Qhh, Xom^Qhh, Xom^Qhh, Gg, Gg, Ww, Gg, Xom, Xom, Xom, Xom, Xom^Efs, Xom, Iwr, Iwr, Iwr, Iwr, Xom, Xom, Xom, Xom, Xom, Xom, Xom, Gg, Gg, Rr, Gg^Fds, Gg^Fds
Kh^Qhh, Ch, Ch, Kh, Rr, Rr, Rr^Es, Xom, Xom^Efs, Xom, Xom^Qhh, Ww, Ww, Gg^Qhh, Gg^_mh, Xom, Xom^Efs, Gs, Gs, Rr, Rr^Qhh, Gg^Qhh, Ww^Ewl, Gg, Rr, Xom, Iwr, Iwr, Iwr, Iwr, Iwc, Iwc, Iwc, Iwr, Iwr, Xom, Xom, Xom, Xom^Efs, Xom, Gg, Gg, Rr, Rr, Gg^Fds, Gg^Fds
Ch^Qhh, 3 Kh, Ch, Ch, Gg, Rr^Ebn, Gg, Ch, Ch, Xom^Qhh, Ww, Ww, Ww, Gg^Qhh, Gs^Qhh, Gg^Qhh, Gs^Efm, Gs^Qhh, Rr^Ebn, Rr^Vhc, Rr^Qhh, Ww^Bsb\, Rr, Rp, Rp, Iwr, Iwr, Iwr, Iwr, Iwc, Iwc, Iwc, Iwr, Iwr, Iwr^Pw/, Xom, Gg, Xom, Gg, Gg, Rr, Gg, Gg, Rr, Gs, Ww
Kh^Qhh, Ch, Ch, Rr, Rr, Gg, Rr, Ch, Gg, Gg^Qhh, Ww^Ewf, Ww, Ww, Ww, Ww, Gs^Qhh, Gs^Qhh, Gs^Efm, Ds^Esd, Gs, Ds^Qhh, Ww, Gg, Rr, Gg, Xom, Xom^Efs, Xom, Xom, Iwr, Xom, Iwr, Xom, Xom^Efs, Gg, Rr, Rr, Gg, Gg, Rr, Gs^Edt, Gg^Edt, Ce, Gg, Gs, Ww
Xom^Qhh, Kh, Rr, Gg, Gg, Rr, Rp, Gg, Gg, Gg^Qhh, Gs^Qhh, Gg^Qhh, Gs^Qhh, Ww, Ww, Ww, Gs^Qhh, Gs^Qhh, Ds^Qhh, Ds^Qhh, Ww, Ww, Gg, Rr, Gg^Efm, Rr^Vhc, Hh, Xom, Xom, Xom, Mm^Xm, Xom, Mm, Hh, Hh^Fds, Gg, Gg, Rr, Gg, Gs, Rr, Gs^Vct, Gg, Gs, Ww, Ww
Xom^Qhh, Xom, Xom, Rr^Vhc, Gs, Rr, Rr, Gg, Rp, Rr^Vhc, Gg^Efm, Gs^Efm, Gs, Gs^Qhh, Gs^Qhh, Ww, Ww, Ww, Ww, Ww, Gg, Gg, Gg, Gg, Gg^Efm, Gg^Efm, Gs^Efm, Hh, Mm, Mm^Xm, Mm, Mm^Xm, Mm, Hh^Fds, Hh^Fds, Gg^Fds, Gs, Gs, Rr, Gg, Gg, Gs^Es, Ke, Ce^Edt, Ww^Edt, Ww
Xom^Qhh, Xom^Efs, Gd, Gs, Xom, Gs, Gs, Rr, Gg^Efm, Rp, Gg^Efm, Gg^Efm, Gs^Ebn, Gs^Qhh, Ww, Ww, Ww, Ww, Ds^Esd, Gg, Gg, Rr, Gs, Gg^Efm, Gs^Fds, Gs, Gg^Fds, Hh, Mm, Mm, Mm, Mm, Mm, Mm, Hh^Es, Hh, Gg, Gg^Edt, Gg^Edt, Ce^Edt, Ce, Gs, Ce^Edt, Ce, Ww, Ww
Xom^Qhh, Gs^Es, Gd, Xom, Xom^Efs, Gd, Gs^Ebn, Rr, Gs^Efm, Gg^Efm, Gs^Fds, Gs^Fds, Gg, Gs^Qhh, Ww, Ww, Ww, Ds, Ds, Gg, Rp, Rp, Rp^Vh, Gs^Fds, Gs^Efm, Gg^Fds, Hh^Fds, Hh, Mm, Mm, Mm, Mm, Mm, Hh, Hh, Gs, Gs, Gg^Edt, Gs, Ce, Gs^Ecf, Gs^Edt, Ww, Ww, Ww, Ww
Gs, Gd, Gd^Efm, Gd^Efm, Gd^Efm, Gd^Efm, Gs^Efm, Gs, Rr, Rr^Vhc, Gs^Fds, Gg^Efm, Gs^Qhh, Gs^Qhh, Ww, Ww, Ww^Ewl, Ds, Gg, Gg, Gg^Es, Rp, Gg, Gs, Gs, Gs^Efm, Hh^Fds, Hh^Fds, Mm, Mm, Mm, Wwf, Hh, Hh, Gs, Gs, Gd, Gs, Gs^Edt, Gs, Gs, Gs, Ww, Ww, Ww, Ww
Gs, Gs^Efm, Gs^Efm, Gd^Efm, Gs, Gd^Efm, Gs, Gg, Rr, Gg^Efm, Gs, Gs^Efm, Gs^Qhh, Ww, Ww, Ww, Ds, Ds^Esd, Ds, Gg, Gg, Rr, Gg, Gg, Hh, Gs, Mm, Mm, Mm, Mm, Wwf, Wwf, Mm, Mm, Hh, Hh, Gd, Gd, Gd, Gd, Ce^Edt, Ww, Ww, Ww, Ww, Ww
Gs, Gs, Gs, Gs, Gs^Es, Gs^Wm, Rr, Gg^_mh, Gg, Gg, Gg^Qhhf, Gg^Qhh, Ds, Ds, Ww, Ww, Ds, Ds, Gg, Gg, Gs, Gs, Gg, Hh, Hh^Vhh, Hh, Mm, Hh, Mm, Mm, Wwf, Hh, Mm, Mm, Hh^Fds, Hh^Fds, Gs^Fds, Gs^Fds, Gd, Gd, Gs, Ww^Edt, Ww, Ww, Wo, Wo
Gs^Fds, Gs^Fds, Gs^Fds, Gs, Gg, Gg, Gg, Rr, Rr, Gs^Fds, Gg^Qhhf, Gg^Qhh, Ww, Ww, Ww, Ww^Ewl, Ds, Gg, Rp, Rp, Gs, Gs, Hh, Gg, Hh, Mm, Mm, Mm, Ww, Ww, Mm, Hh, Gg^Wm, Hh, Hh^Es, Gg^Fds, Gg^Fds, Gs^Fds, Gs, Gs, Gs, Ww, Ww, Ww, Wo, Wo
Gs^Fds, Gg, Gs^Fds, Gs^Fds, Gg^Efm, Gg^Efm, Gg, Rr, Gg, Gg, Gg^Qhh, Ww, Ww, Ww, Ds, Ww^Ewf, Gs, Gs, Rp, Gg, Gs^Es, Hh^Fds, Hh^Fds, Hh, Mm, Mm, Hh^Fds, Hh^Fds, Ww, Hh, Mm, Hh, Gg, Gg, Gg, Gg, Gs, Gg^Fds, Gs, Gs, Ww, Ww, Ww, Wo, Wo, Wo
Gs^Fds, Gs^Fds, Ww, Ww, Ww, Ww, Gs^Fds, Rp, Rp, Gg^Es, Gg^Qhhf, Ww, Ww, Ds, Ds^Esd, Ds, Gg, Gs, Gg, Gg, Gg, Hh, Mm, Mm, Mm, Hh^Fds, Gg^Fds, Ww, Ww, Hh, Hh, Gg, Gs^Efm, Gg^Efm, Gs^Efm, Gs^Efm, Gg, Gg, Gs^Edt, Gs, Gs, Ww, Ww, Ww, Ww, Wo
Gs^Fds, Gg, Gg, Ww, Gg, Gs^Fds, Gg, Gs^Fds, Rr, Gs^Fds, Gg^Qhhf, Ww, Ww, Ww, Ds^Esd, Ds, Rr, Rr, Rp, Gg, Hh, Hh^Es, Hh, Hh, Hh, Gg, Gg, Ww, Ww, Ww, Gg, Gs, Gg^Efm, Gs^Efm, Gg, Gs, Gg^Ecf, Re^Vct, Gs, Gs, Gs, Ww, Ww, Ww, Ww, Ww
Gg, Gg^Es, Gs^Fds, Gg, Gg, Gg, Gg, Gs^Fds, Gg, Gs^Fds, Gg^Qhh, Ww, Ww, Ww, Ww^Bsb/, Gg, Rr, Gg, Gg, Rp^Vh, Gg, Hh, Gg, Gg, Gs, Gg, Gg^Fds, Gg^Fds, Ww, Ww, Gg^Fds, Gg^Efm, Gs, Gg^Edt, Ce^Edt, Gs, Gs, Gs, Ce, Gs^Fds, Gs^Fds, Gs^Fds, Ww, Ww, Ww, Ww
Gs^Fds, Gg, Gs^Fds, Gs^Fds, Gs^Fds, Gs^Fds, Gg, Gg, Ww, Rp, Rp, Gg^Qhh, Rp^Qhh, Ww^Bsb/, Ww^Bsb/, Ww^Bsb/, Ww, Gg, Ww, Gg, Gs^Efm, Gg^Efm, Gs^Efm, Gs^Efm, Gs^Efm, Gg^Efm, Gg, Gg^Fds, Ww, Ww, Ww, Gg, Gs, Gg, Gs^Edt, Gs, Gs^Edt, Ce, Gs, Gs^Fds, Ww, Ww^Edt, Ww, Ww, Ww, Ww
Gs^Fds, Gs^Fds, Gs, Gs, Gg^Efm, Gg, Gg, Ww, Ww, Gs^Fds, Gs^Vh, Rp, Rr, Gg^Qhh, Gg^Qhh, Ww, Ww, Ww, Ww, Ww^Ewl, Gg, Gs^Efm, Gg, Gg, Gg, Gg^Fds, Gg, Ww, Ww, Ww, Ww, Ww, Ww, Gg^Edt, Gs^Edt, Ce^Edt, 2 Ke, Gs^Edt, Gs^Edt, Gs, Ww, Ww, Ww, Wo, Wo, Ww
Gs^Fds, Gs^Fds, Gs^Es, Gs^Efm, Gs^Efm, Gg^Efm, Gg^Efm, Ww, Gs^Fds, Gs^Fds, Gg, Rr, Rr, Rr, Gs, Gs^Qhh, Gs^Fds, Ww, Ww, Ww, Ww, Gg, Gg^Fds, Gg^Fds, Gs^Fds, Gg, Ww, Ww, Ww, Ww, Ds, Ww, Ww, Ww, Ww, Ce, Ww, Ce^Edt, Ww, Ww, Ww, Ww, Ww, Wo, Wo, Wo
Gg, Gs, Gg, Gs, Gs, Gg^Efm, Gg^Efm, Gs^Fds, Gs, Gs, Gs, Rr, Rr, Gs, Gs, Gs, Hh^Qhh, Ww, Ww, Ww, Ww, Gg, Hh, Hh^Fds, Gs^Es, Gg, Gs^Vh, Ww^Ewl, Ww, Ww, Ds^Esd, Ds^Esd, Ds, Ww, Ww, Ww, Ww, Ww, Ww, Ww, Ww, Ww, Ww, Ww, Ww, Ww
Xom, Xom, Xom, Gg, Ww, Gg, Gg^Efm, Gs^Efm, Gg^Efm, Gs, Rp, Rp, Gg, Gg, Hh, Hh^Qhh, Ds, Ds, Ww, Ww, Ww, Hh, Hh, Hh^Fds, Gs, Gs, Ww, Ww, Ww, Ww, Ww, Ww, Ww, Ww, Ww^Ewl, Ww, Ww, Ww, Wo, Ww, Ww, Ww, Ww, Ww, Ww, Ww
Xom, Xom, Xom, Ww, Ww, Gg, Gg^Efm, Gg^Efm, Gs, Gs, Rp, Gg, Rp, Hh, Hh, Hh^Fds, Hh^Qhh, Ds, Ww, Ww, Ww, Ds, Ds, Ds, Ds, Ww, Ww, Ww, Wo, Ww, Ww, Ww, Ww, Ww, Ww, Ww^Ewl, Ww, Wo, Wo, Ww, Wo, Ww, Ww, Ww, Ww, Ww
Ch, Xom, Xom, Xom^Efs, Ww, Ww, Rr^Vhc, Gg, Gg, Rp, Gg, Rp, Gg, Gs^Fds, Gg, Gg, Hh^Fds, Ww, Ww, Ww, Ww, Ww, Ww, Ds, Ww, Ww, Ww, Ww, Wo, Wo, Wo, Wo, Wo, Ww, Ww^Ewl, Ww, Ww, Ww, Wo, Wo, Wo, Wo, Wo, Wo, Wo, Wo
Xom, Ch, Gs, Ch, Rr, Gg, Rp, Rr, Rp, Gs, Rp, Gg, Gg, Gg, Gg^Es, Gs^Fds, Gs^Fds, Ww, Ww, Ww, Ds, Ww, Ww, Ww, Ww, Ww, Ww, Ww, Ww, Ww, Ww, Wo, Ww, Ww, Ww, Ww, Wo, Wo, Wo, Wo, Wo, Wo, Wo, Wo, Wo, Wo
Xom, Xom, Gs, Gs, Gg, Rr^Ebn, Gs, Gs^Fds, Gs^Fds, Rp, Gs, Gg, Gg, Gg, Ce, Gg, Ds, Ww, Ww, Ww, Ds, Gs, Gg, Ww, Ww, Ds, Ww, Ww, Ww, Ww, Ww, Ww, Ww, Ww, Ww, Wo, Wo, Wo, Wo, Wo, Wo, Wo, Wo, Wo, Wo, Wo
Ch, Ch, Xom^Qhh, Ch, Rr, Gg, Rp, Gs, Gs^Fds, Gg, Gg, Gs, Ce, Ce, 1 Ke, Ce, Ds^Esd, Ds, Ww, Ww, Ww, Gs, Ds^Esd, Ww, Wo, Ww, Ww, Ww, Ww, Ds, Ds^Esd, Ww, Ww, Ww, Ww, Ww, Wo, Wo, Wo, Wo, Wo, Wo, Wo, Wo, Wo, Wo
Xom^Qhh, Xom^Qhh, Xom^Qhh, Xom^Efs, Rp^Es, Rp, Rp^Es, Rr^Vhc, Gs^Fds, Gs^Fds, Gs^Fds, Gs, Gs, Gg, Gg, Ds, Ww, Ww, Ww, Ww, Ww, Ww, Ds, Gg, Wo, Wo, Ww, Ww, Gs^Efm, Gs^Vh, Gs^Efm, Ds, Gs, Ww, Ww, Wo, Wo, Wo, Wo, Wo, Wo, Wo, Wo, Wo, Wo, Wo
Rr, Rr, Rr^Vhc, Rp, Xom, Gs, Xom, Gs^Fds, Gs^Fds, Gs^Fds, Gs^Fds, Gs^Es, Gs^Fds, Gg, Gg, Ww^Ewf, Ww^Ewl, Ww, Gs^Fds, Ww, Ww, Ww, Ww^Ewl, Ww^Ewl, Ww, Ww, Gg, Gs^Efm, Gs^Efm, Gs^Efm, Ds, Gg, Ww, Ww, Ww, Wo, Wo, Wo, Wo, Wo, Wo, Wo, Wo, Wo, Wo, Wo
Xom^Qhh, Xom, Rr, Rr, Xom, Xom, Xom, Xom, Gs^Fds, Gs^Fds, Gs^Fds, Gg, Gs^Fds, Gg, Ww, Ww^Ewl, Ww, Ww, Gs^Fds, Gs^Fds, Gs^Fds, Ww, Ww, Ww, Ww, Ww, Ww, Ww, Ww, Ww, Ww, Ds, Ww, Ww, Wo, Wo, Wo, Wo, Wo, Wo, Wo, Wo, Wo, Wo, Wo, Wo
