Mm^Qhh, Mm^Qhh, Mm^Qhh, Hh^Qhh, Hh^Qhh, Re, Re, Aa, Aa^Fda, Gg^Qhh, Gg^Qhh, Gg^Qhhf, Gs^Qhhf, Hh^Qhhf, Hh^Qhhf, Hh^Qhh, Mm^Qhh, Mm^Qhh, Mm^Qhh, Mm^Qhh, Mm^Qhh, Hh^Qhhf, Hh^Qhhf, Gg, Gs^Fp, Aa, Aa, Aa, Aa
Mm^Qhh, Mm, Mm, Hh, Hh^Qhh, Re, Re, Aa, Aa^Fda, Aa, Aa, Gg^Qhh, Gs^Qhhf, Gll^Fmw, Hh^Fp, Hh, Mm, Mm^Xm, Mm^Xm, Mm^Xm, Mm, Hh^Qhhf, Hh^Fp, Gs, Gs^Fp, Gs, Aa, Aa, Aa
Mm^Qhh, Mm, Mm, Hh^_mh, Hh^Qhh, Hh^Qhh, Re, Aa, Aa, Aa, Aa, Gll^Fmw, Gs^Fp, Gs^Qhhf, Gs^Qhhf, Hh, Hh, Hh^_mh, Mm^Xm, Mm, Hh^Qhh, Hh^Qhhf, Hh^Fp, Gll^Fmw, Gs^Fp, Gs, Gs, Aa, Aa
Hh^Qhh, Hh^Qhh, Hh^Qhh, Mm^Qhh, Hh^Qhh, Gg, Re, Gd, Gd, Aa, Aa, Aa, Gs, Gs, Gs^Qhhf, Hh, Mm, Mm^Xm, Hh^Qhh, Hh^Qhh, Gg, Hh, Gs, Gs, Gg^Vh, Gd, Aa, Aa, Aa
Gg, Gg, Gg, Gs, Gs, Gs, Gs, Re, Re, Gs, Ss^Qhu, Ss^Qhu, Aa, Aa, Hh, Hh^Qhh, Mm^Xm, Mm, Hh^Qhh, Hh, Gd, Gd, Gd, Gd, Re, Re, Re, Re, Re
Ds, Ds, Ds, Gg, Gs, Ss^Qhu, Gs, Gg, Re, Gs, Ss^Qhu, Ss^Qhu, Gs^Fp, Aa, Mm^Qhh, Hh^Qhh, Mm^Xm, Mm, Hh^Qhh, Hh, Gg, Gd, Re, Re, Gd, Ss^Qhu, Gd, Gd^Vh, Gd
Ww, Ww, Ww, Ds, Aa, Aa, Aa, Gg^Vh, Aa, Re, Re, Aa, Aa^Fda, Ha^Qhh, Ha, Ms, Ms^Qhh, Hh^Qhh, Gs, Gs, Gs, Re, Gs^Fp, Gll^Fmw, Gs^Fp, Gg, Gs, Gd, Gs
Ww, Ww, Ww, Ds, Ds, Ds, Aa, Aa, Aa, Gg, Aa, Aa, Aa^Fda, Ha^Qhhf, Ha, Ms^Qhh, Ha, Hh, Gd, Gs, Re, Re, Gs^Vl, Gll^Fmw, Gll^Fmw, Gs, Gs, Gs, Gs
Wo, Wo, Ww, Ww, Ww, Ww, Ds, Aa, Gs, Gs, Re, Aa, Hh^Qhh, Mm^Qhh, Ha, Ms^Qhh, Ha, Gd, Re, Re, Gs, Gg, Ce, Gs, Gg, Ds, Ww, Ww, Ww
Wo, Wo, Wo, Ww, Ww, Ww, Ds, Gll^Fmw, Gll^Fmw, Gll^Fmw, Gs^Qhhf, Re, Re, Ha^Qhh, Ha^Qhh, Ha^Qhh, Re, Gd, Re, Gs, Re, Ce, 1 Ke, Gs, Ds, Ds, Ww, Ww, Ww
Wo, Wo, Wo, Wo, Ww, Ds, Gs, Gll^Fdw, Aa^Qhhf, Aa^Qhhf, Ha^Qhh, Hh^Qhh, Hh^Qhh, Re, Re, Re, Hh^Qhh, Re, Hh, Gd, Gd, Re, Ce, Ce, Ds, Ww, Wo, Wo, Wo
Wo, Wo, Wo, Wo, Ww, Ds, Gs, Gll^Fdw, Gs^Qhhf, Aa^Fda, Ha^Fda, Mm, Ha, Mm^Qhh, Hh^Qhh, Mm^Qhh, Mm, Hh^Qhh, Hh, Mm, Aa, Gd, Gs, Ds, Ww, Ww, Wo, Wo, Wo
Wo, Wo, Wo, Wo, Wo, Ww, Ds, Gs, Gs, Ms^Qhh, Mm, Ms^Xm, Ms, Ha, Mm, Mm^Xm, Chr^Dr, Hh^Qhh, Mm^Qhh, Ms, Aa, Gd, Gs, Ww, Ww, Wo, Wo, Wo, Wo
Wo, Wo, Wo, Wo, Ww, Ww, Ds, Gg, Hhd, Hh^Qhh, Mm^Qhh, Ms, Ms^Xm, Ha^_mh, Ms^Xm, Hh^Dr, Khr, Mm^Xm, Mm^Xm, Hh^Qhh, Hhd^Qhh, Hhd, Gs, Gs, Ww, Wo, Wo, Wo, Wo
Wo, Wo, Wo, Ww, Ww, Gg, Gg, Gs, Gs, Hhd, Md, Hh^Qhh, Ha^Qhh, Ms^Xm, Hhd, Chr, Mm, Mm^Xm, Ha, Hhd^Vhr, Hhd^Qhh, Aa, Aa, Gs, Ww, Ww, Wo, Wo, Wo
Wo, Wo, Wo, Ww, Ai, Gg, Gs, Gg, Gs^Vhr, Md, Hhd, Hhd, Mm^Qhh, Mm^Qhh, Hh^Qhh, Hh, Hhd^Vhr, Ha, Ha^Qhh, Ha^Qhh, Aa, Aa, Aa, Ww, Ww, Ww, Ww, Wo, Wo
Wo, Wo, Wo, Ww, Ai, Aa, Aa, Aa, Ha, Hhd, Wwr^Qhu, Hh^Qhh, Ww^Qhu, Hh^Qhh, Gd^Fdw, Hhd^Qhh, Hh^Qhh, Gs^Qhhf, Ss^Qhu, Aa, Aa, Aa, Ds, Wwf, Ds, Ww, Ww, Wo, Wo
Wo, Wo, Wo, Wo, Ww, Ai, Aa, Aa, Aa^Fda, Ha, Ss^Qhu, Ss^Qhu, Urc, Ww^Qhu, Gd^Fdw, Gd^Fdw, Gd, Ss^Qhu, Ss^Qhu, Gs, Gs, Aa, Wwf, Wwf, Gd, Ww, Ww, Ww, Wo
Wo, Wo, Wo, Wo, Wo, Ww, Aa, Aa^Fda, Aa^Fda, Hhd, Gs, Ss^Qhu, Gs, Gd, Hhd, Hhd, Gd, Gs, Ss^Qhu, Gs, Gs, Ds, Wwf, Wwf, Gs^Vhr, Gd, Ww, Ww, Wo
Wo, Wo, Wo, Wo, Ai, Ai, Aa^Fda, Aa^Fda, Gs, Gs, Aa^Fda, Gs, Gs, Gd, Ss^Qhu, Hhd, Gs, Gd, Ww, Ww, Ww, Wwf, Wo, Ds, Gs, Ww, Ww, Wo, Wo
Wo, Wo, Wo, Wwr, Wwr, Ai, Aa^Fda, Aa^Fda, Aa^Fda, Gs, Aa^Fda, Aa^Fda, Gs, Gs, Ss^Qhu, Ss^Qhu, Gd, Gs, Ai, Ww, Ww, Ww, Wo, Wo, Ww, Ww, Ww, Wo, Wo
Wo, Wo, Ai, Aa, Ww, Ww, Gs^Edp, Aa^Fda, Aa, Aa, Aa, Aa, Gs, Ss^Qhu, Gd, Gd, Gd, Ai, Ai, Ai, Wo, Wo, Wo, Wo, Ww, Wo, Wo, Wo, Wo
Wo, Ai, Ai, Aa, Aa, Wo, Wwf, Aa^Fda, Gd, Gd, Gd, Gs, Gs, Ww, Wwr, Gd^Vhr, Gd, Ai, Wo, Wo, Wo, Wo, Ai, Wo, Wo, Wo, Wo, Wo, Wo
Wo, Wo, Ww, Aa, Ww, Wo, Wo, Wwf, Gd, Chr, Chr, Gs, Ww, Ww, Wwr, Gd, Gd, Ai, Wo, Wo, Wo, Ai, Ai, Ai, Ai, Wo, Wo, Wo, Wo
Wo, Wo, Ww, Ww, Gs, Wo, Ww, Wwf, Chw^Qhu, 2 Khr, Ww, Ww, Ww, Wo, Wo, Wwr, Wwr, Wo, Wo, Wo, Wo, Ai, Wo, Wo, Ww, Wo, Wo, Wo, Wo
Wo, Wo, Ww, Gs, Wwr, Wwr, Gd, Wwf, Ds, Chw^Qhu, Ww, Ww, Ww, Wo, Wo, Wwr, Wwr, Wo, Wo, Wo, Wo, Wo, Ww, Ww, Ww, Wo, Wo, Wo, Wo
Wo, Wo, Wo, Ds, Wwr, Wo, Mm, Gd^Edp, Ds, Wwr, Wwr, Wo, Wo, Wo, Ww, Wo, Wo, Ww, Wwr, Wwr, Wwr, Ww, Ds, Wwr, Wwr, Ww, Wo, Wo, Wo
Wo, Wo, Wo, Wwr, Wo, Wo, Ww, Mm, Gs, Wwr, Wwr, Ww, Wo, Wo, Wwr, Wo, Wo, Wo, Wwr, Wwr, Aa^Vha, Aa, Ha, Ha, Ha, Ww, Wo, Wo, Wo
Wo, Wo, Wo, Wo, Wo, Wo, Wo, Ww, Wwr, Wwr, Wo, Wwr, Wwr, Wo, Wo, Ww, Ww, Wo, Wo, Wo, Ww, Wwf, Gll^Fmw, Ha^Fma, Hh, Ww, Ww, Wo, Wo
Wo, Wo, Wo, Wo, Wo, Wo, Wo, Wo, Wo, Wo, Ai, Aa, Aa, Wwr, Wo, Gs, Ds, Ww, Wo, Wo, Wo, Ww, Aa^Vha, Aa^Fma, Aa, Ww, Ww, Wo, Wo
Wo, Wo, Wo, Wo, Wo, Wo, Wo, Wo, Ai, Ai, Ai, Ai, Aa, Wo, Wo, Wwr, Wwr, Wwr, Wo, Wo, Wo, Ww, Ww, Ww, Ww, Ww, Wo, Wo, Wo
Wo, Wo, Wo, Wo, Wo, Wo, Wo, Wo, Wo, Wo, Wo, Ai, Ww, Wo, Wo, Wo, Wo, Wo, Wo, Wo, Wo, Wo, Wo, Wo, Wo, Wo, Wo, Wo, Wo
Wo, Wo, Wo, Wo, Wo, Wo, Wo, Wo, Wo, Wo, Wo, Wo, Ww, Wo, Wo, Wo, Wo, Wo, Wo, Wo, Wo, Wo, Wo, Wo, Wo, Wo, Wo, Wo, Wo
