Mm^Qhh, Mm^Qhh, Mm^Qhh, Hh^Qhh, Hh^Qhh, Re, Re, Gg, Gs^Fp, Gg^Qhh, Gg^Qhh, Gg^Qhhf, Gs^Qhhf, Hh^Qhhf, Hh^Qhhf, Hh^Qhh, Mm^Qhh, Mm^Qhh, Mm^Qhh, Mm^Qhh, Mm^Qhh, Hh^Qhhf, Hh^Qhhf, Gg, Gs^Fp, Gg, Gg, Gg, Gg
Mm^Qhh, Mm, Mm, Hh, Hh^Qhh, Re, Re, Gg, Gs^Fp, Gg, Gg, Gg^Qhh, Gs^Qhhf, Gs^Fms, Hh^Fp, Hh, Mm, Mm^Xm, Mm^Xm, Mm^Xm, Mm, Hh^Qhhf, Hh^Fp, Gg, Gs^Fp, Gg, Gg, Gg, Gg
Mm^Qhh, Mm, Mm, Hh^_mh, Hh^Qhh, Hh^Qhh, Re, Gg, Gg, Gg, Gg, Gs^Fms, Gs^Fp, Gs^Qhhf, Gs^Qhhf, Hh, Hh, Hh^_mh, Mm^Xm, Mm, Hh^Qhh, Hh^Qhhf, Hh^Fp, Gs^Fms, Gs^Fp, Gg, Gg, Gg, Gg
Hh^Qhh, Hh^Qhh, Hh^Qhh, Mm^Qhh, Hh^Qhh, Gg, Re, Gg, Gg, Gs, Gs, Gs, Gs, Gs, Gs^Qhhf, Hh, Mm, Mm^Xm, Hh^Qhh, Hh^Qhh, Gg, Hh, Gg, Gg, Gg^Vh, Gg, Gg, Gg, Gg
Gg, Gg, Gg, Gs, Gs, Gs, Gs, Re, Re, Gs, Ss^Qhu, Ss^Qhu, Gs, Gs, Hh, Hh^Qhh, Mm^Xm, Mm, Hh^Qhh, Hh, Gg, Gg, Gg, Gg, Re, Re, Re, Re, Re
Ds, Ds, Ds, Gg, Gs, Ss^Qhu, Gs, Gg, Re, Gs, Ss^Qhu, Ss^Qhu, Gs^Fp, Gs, Mm^Qhh, Hh^Qhh, Mm^Xm, Mm, Hh^Qhh, Hh, Gg, Gg, Re, Re, Gg, Ss^Qhu, Gg, Gg^Vh, Gg
Ww, Ww, Ww, Ds, Gg, Gs, Gg, Gg^Vh, Gg, Re, Re, Gg, Gs^Fms, Hh^Qhh, Hh, Mm, Mm^Qhh, Hh^Qhh, Gg, Gg, Gg, Re, Gs^Fp, Gs^Fms, Gs^Fp, Gg, Gg, Gg, Gg
Ww, Ww, Ww, Ds, Ds, Ds, Gg, Gg, Gg, Gg, Re, Gg, Gs^Fms, Hh^Qhhf, Hh, Mm^Qhh, Hh, Hh, Gg, Gg, Re, Re, Gs^Vl, Gs^Fms, Gs^Fms, Gg, Gg, Gg, Gg
Wo, Wo, Ww, Ww, Ww, Ww, Ds, Gg, Gg, Gg, Re, Gg, Hh^Qhh, Mm^Qhh, Hh, Mm^Qhh, Hh, Gg, Re, Re, Gg, Gg, Ce, Gg, Gg, Ds, Ww, Ww, Ww
Wo, Wo, Wo, Ww, Ww, Ww, Ds, Gs^Fms, Gs^Fms, Gs^Fms, Gs^Qhhf, Re, Re, Hh^Qhh, Hh^Qhh, Hh^Qhh, Re, Gg, Re, Gg, Re, Ce, 1 Ke, Gg, Ds, Ds, Ww, Ww, Ww
Wo, Wo, Wo, Wo, Ww, Ds, Gg, Gs^Fds, Gs^Qhhf, Gs^Qhhf, Hh^Qhh, Hh^Qhh, Hh^Qhh, Re, Re, Re, Hh^Qhh, Re, Hh, Gg, Gg, Re, Ce, Ce, Ds, Ww, Wo, Wo, Wo
Wo, Wo, Wo, Wo, Ww, Ds, Gg, Gs^Fds, Gs^Qhhf, Gs^Fds, Hh^Fds, Mm, Hh, Mm^Qhh, Hh^Qhh, Mm^Qhh, Mm, Hh^Qhh, Hh, Mm, Gg, Gg, Gg, Ds, Ww, Ww, Wo, Wo, Wo
Wo, Wo, Wo, Wo, Wo, Ww, Ds, Gg, Gg, Mm^Qhh, Mm, Mm^Xm, Mm, Hh, Mm, Mm^Xm, Chr^Dr, Hh^Qhh, Mm^Qhh, Mm, Gg, Gg, Gg, Ww, Ww, Wo, Wo, Wo, Wo
Wo, Wo, Wo, Wo, Ww, Ww, Ds, Gg, Hh, Hh^Qhh, Mm^Qhh, Mm, Mm^Xm, Hh^_mh, Mm^Xm, Hh^Dr, Khr, Mm^Xm, Mm^Xm, Hh^Qhh, Hh^Qhh, Hh, Gg, Gg, Ww, Wo, Wo, Wo, Wo
Wo, Wo, Wo, Ww, Ww, Gg, Gg, Gs, Gs, Hh, Mm, Hh^Qhh, Hh^Qhh, Mm^Xm, Hh, Chr, Mm, Mm^Xm, Hh, Hh^Vhr, Hh^Qhh, Gg, Gg, Gg, Ww, Ww, Wo, Wo, Wo
Wo, Wo, Wo, Ww, Ww, Gg, Gs, Gg, Gs, Mm, Hh, Hh, Mm, Mm^Qhh, Hh^Qhh, Hh, Hh^Vhr, Hh, Hh^Qhh, Hh^Qhh, Gg, Gg, Gg, Ww, Ww, Ww, Ww, Wo, Wo
Wo, Wo, Wo, Ww, Ww, Gg, Gg, Gs, Hh, Hh, Hh, Hh, Hh, Hh^Qhh, Gs, Hh^Qhh, Hh^Qhh, Gs^Qhhf, Ss^Qhu, Gg, Gg, Gg, Ds, Wwf, Ds, Ww, Ww, Wo, Wo
Wo, Wo, Wo, Wo, Ww, Ww, Gs, Gs, Gs, Ww^Qhu, Ww^Qhu, Hh, Hh^Vhhr, Gs, Gs, Gs, Gs, Ss^Qhu, Ss^Qhu, Gs, Gs, Gs, Wwf, Wwf, Gg, Ww, Ww, Ww, Wo
Wo, Wo, Wo, Wo, Wo, Ww, Gs, Gs^Fdw, Ss^Qhu, Ss^Qhu, Ss^Qhu, Hh, Gs, Gs, Gs, Hh, Gs, Gs, Ss^Qhu, Gs, Gs, Ds, Wwf, Wwf, Gs^Vhr, Gg, Ww, Ww, Wo
Wo, Wo, Wo, Wo, Ww, Ww, Gs^Fdw, Gs^Fdw, Gs, Gs, Gs^Fdw, Gs, Gs, Gs, Ss^Qhu, Hh, Gs, Gs, Ww, Ww, Ww, Wwf, Wo, Ds, Gs, Ww, Ww, Wo, Wo
Wo, Wo, Wo, Wwr, Wwr, Ww, Gs^Fdw, Gs^Fdw, Gs^Fdw, Gs, Gd^Fdw, Gs^Fdw, Gs, Gs, Ss^Qhu, Ss^Qhu, Gs, Gs, Ww, Ww, Ww, Ww, Wo, Wo, Ww, Ww, Ww, Wo, Wo
Wo, Wo, Wwr, Ds, Ww, Ww, Gs^Edp, Gd^Fdw, Gd, Gs, Gd, Gs, Gs, Ss^Qhu, Gs, Gs, Gs, Ww, Wo, Wo, Wo, Wo, Wo, Wo, Ww, Wo, Wo, Wo, Wo
Wo, Wo, Ww, Gs, Ds, Wo, Wwf, Gs^Fdw, Gd, Gd, Gd, Gs, Gs, Ww, Wwr, Gs^Vhr, Gs, Ww, Wo, Wo, Wo, Wo, Wo, Wo, Wo, Wo, Wo, Wo, Wo
Wo, Wo, Ww, Gs, Ww, Wo, Wo, Wwf, Gd, Chr, Chr, Gs, Ww, Ww, Wwr, Gs, Gs, Ww, Wo, Wo, Wo, Wo, Wo, Ww, Ww, Wo, Wo, Wo, Wo
Wo, Wo, Ww, Ww, Gs, Wo, Ww, Wwf, Chw^Qhu, 2 Khr, Ww, Ww, Ww, Wo, Wo, Wwr, Wwr, Wo, Wo, Wo, Wo, Wo, Wo, Wo, Ww, Wo, Wo, Wo, Wo
Wo, Wo, Ww, Gs, Wwr, Wwr, Gd, Wwf, Ds, Chw^Qhu, Ww, Ww, Ww, Wo, Wo, Wwr, Wwr, Wo, Wo, Wo, Wo, Wo, Ww, Ww, Ww, Wo, Wo, Wo, Wo
Wo, Wo, Wo, Ds, Wwr, Wo, Mm, Gd^Edp, Ds, Wwr, Wwr, Wo, Wo, Wo, Ww, Wo, Wo, Ww, Wwr, Wwr, Wwr, Ww, Ds, Wwr, Wwr, Ww, Wo, Wo, Wo
Wo, Wo, Wo, Wwr, Wo, Wo, Ww, Mm, Gs, Wwr, Wwr, Ww, Wo, Wo, Wwr, Wo, Wo, Wo, Wwr, Wwr, Gs^Vhr, Gs, Hh, Hh, Hh, Ww, Wo, Wo, Wo
Wo, Wo, Wo, Wo, Wo, Wo, Wo, Ww, Wwr, Wwr, Wo, Wwr, Wwr, Wo, Wo, Ww, Ww, Wo, Wo, Wo, Ww, Wwf, Gs^Fds, Hh^Fds, Hh, Ww, Ww, Wo, Wo
Wo, Wo, Wo, Wo, Wo, Wo, Wo, Wo, Wo, Wo, Wwr, Ds, Ds, Wwr, Wo, Gs, Ds, Ww, Wo, Wo, Wo, Ww, Gs^Vhr, Gs^Fds, Gg, Ww, Ww, Wo, Wo
Wo, Wo, Wo, Wo, Wo, Wo, Wo, Wo, Wo, Wo, Wo, Wwr, Gs, Wo, Wo, Wwr, Wwr, Wwr, Wo, Wo, Wo, Ww, Ww, Ww, Ww, Ww, Wo, Wo, Wo
Wo, Wo, Wo, Wo, Wo, Wo, Wo, Wo, Wo, Wo, Wo, Wo, Ww, Wo, Wo, Wo, Wo, Wo, Wo, Wo, Wo, Wo, Wo, Wo, Wo, Wo, Wo, Wo, Wo
Wo, Wo, Wo, Wo, Wo, Wo, Wo, Wo, Wo, Wo, Wo, Wo, Ww, Wo, Wo, Wo, Wo, Wo, Wo, Wo, Wo, Wo, Wo, Wo, Wo, Wo, Wo, Wo, Wo
