Wo, Wo, Wo, Wo, Wo, Wo, Wo, Wo, Wo, Wo, Wo, Wo, Wo, Wo, Wo, Wo, Wo, Wo, Wo, Wo, Wo, Wo, Wo, Wo, Wo, Wo, Wo, Wo, Wo, Wo, Wo, Wo, Wo, Wo, Wo
Wo, Wo, Wo, Wo, Wo, Wo, Wo, Wo, Wo, Wo, Wo, Wo, Wo, Wo, Wo, Wo, Wo, Wo, Wo, Wo, Wo, Wo, Wo, Wo, Wo, Wo, Wo, Wo, Wo, Wo, Wo, Wo, Wo, Wo, Wo
Wo, Wo, Wo, Wo, Ww, Wwr, Wwr, Wo, Wo, Wo, Wo, Wo, Wo, Wo, Wo, Wwr, Wwr, Wwr, Wwr, Wo, Wo, Wo, Wo, Wo, Wo, Wo, Wo, Wo, Ww, Ww, Ww, Ww, Ww, Wo, Wo
Wo, Wo, Ww, Ww, Ww, Wwr, Ww, Ww, Ww, Wo, Ww, Ww, Ww, Ww, Ww, Ww, Ww, Ww, Wwr, Wwr, Wo, Wo, Wo, Wo, Wo, Wo, Ww, Ww, Ww, Gs, Gs^Fts, Gs^Fts, Ww, Wo, Wo
Wo, Wo, Ww, Wwr, Wwr, Dd, Ww^Edt, Ww, Ww, Ww, Ww, Hd, Hd, Hd, Ww, Hd, Ww, Ww, Ww, Wwr, Wo, Wo, Wo, Wo, Wo, Wo, Wo, Ww, Gs^Vc, Ss, Ss, Gs^Fts, Ww, Wo, Wo
Wo, Wo, Ww, Wwr, Dd, Dd, Dd, Dd^Edt, Dd, Dd, Dd, Hd, Hd, Md, Md, Md, Hd, Ww, Ww, Wo, Wwr, Wo, Wo, Wo, Wo, Wo, Wo, Ww, Gs, Gs, Ss, Gs^Fts, Ww, Wo, Wo
Wo, Wo, Ww, Gd^Ftd, Dd, Gd^Ftd, Dd, Chr, Chr^Edt, Chr, Dd, Ww, Dd, Md, Mv, Hd, Hd, Gd^Ftd, Ww, Ww, Ww, Ww, Ww, Wo, Wo, Wo, Wo, Ww, Ww, Ww, Gs^Fts, Ww, Wo, Wo, Wo
Wo, Wo, Wo, Ww, Gd^Ftd, Gd^Ftd, Gd^Fdw, Chr, 3 Khr, Chr^Edt, Dd, Dd, Hd, Hd^Vhhr, Md, Md, Hd, Gd^Ftd, Gd^Ftd, Gd^Ftd, Gs^Vh, Ww^Bw/, Ww, Ww, Wo, Wo, Wo, Wo, Ww, Ww, Ww, Ww, Wo, Wo, Wo
Wo, Wo, Wo, Ww, Ww, Ww, Gd^Ftd, Dd^Edt, Dd, Dd, Hd, Gd^Ftd, Md, Mv, Md, Hd, Gd^Ftd, Gd^Ftd, Gd^Fts, Gd^Fmw, Gd^Fmw, Gd^Fmw, Ww, Ww, Ww, Wo, Wo, Ww, Ww, Ww, Ww, Wo, Wo, Wo, Wo
Wo, Wo, Wo, Wo, Ww, Ww, Gd^Ftd, Gd^Ftd, Dd^Vhr, Dd, Md, Hd, Md, Md, Md, Hd, Gd^Ftd, Dd, Gd^Fts, Gs^Fdw, Gd^Fmw, Gd^Fmw, Gs^Fdw, Gd^Fmw, Ww, Wo, Ww, Ww, Gd, Gd, Ww, Ww, Wo, Wo, Wo
Wo, Wo, Wo, Wo, Ww, Ww, Ww, Ww, Gd^Ftd, Hd, Gd^Fts, Hd, Md, Hd^Vhhr, Hd, Hd, Dd, Dd, Dd, Gs^Fdw, Gd^Ftd, Gd^Ftr, Gd^Fmw, Gd^Fmw, Ww, Ww, Ww, Ww, Gs, Gd, Gs^Fts, Ww, Ww, Wo, Wo
Wo, Wo, Wo, Wo, Ww, Ww, Ww, Ww, Gd^Ftd, Gd^Ftd, Dd, Hd, Hd, Gd, Gd^Ftd, Hd, Dd, Dd, Dd, Gd^Fmw, Gd^Ftr, Ss, Gd^Fmw, Gs^Ftd, Gs, Dd, Ww, Ww, Dd, Gs^Fts, Gs^Fts, Dd, Ww, Wo, Wo
Wo, Wo, Wo, Wo, Wo, Wo, Wwr, Ww, Dd, Dd, Gd^Ftd, Dd, Gd^Ftd, Gd^Ftd, Gd^Ftd, Dd, Gd^Ftd, Dd, Gd^Ftd, Gd^Ftd, Gd^Ftr, Gd^Ftr, Gs^Ftr, Gd^Fts, Gs, Ww, Ww, Ww, Ww, Dd, Gd, Dd, Ww, Wo, Wo
Wo, Wo, Wo, Wo, Wo, Wo, Wwr, Wwr, Dd, Gd^Ftd, Gd^Fdw, Rd, Gd^Ftd, Ss, Ss, Gd^Fmw, Gd^Ftd, Gd^Fmw, Gd^Vh, Rd, Gd^Ftd, Gs^Fdw, Gd^Fmw, Gd^Fts, Gs, Rd^Vh, Ww, Ww, Ww, Gd, Ww, Dd, Ww, Wo, Wo
Wo, Wo, Wo, Wo, Ww, Wwr, Wwr, Dd, Dd, Gd^Ftd, Gd^Fdw, Rd, Rd, Gd^Fmw, Rd, Rd, Gd^Fmw, Gd^Ftd, Gd^Fmw, Rd, Gs^Ftd, Gd^Fmw, Gs^Ftd, Gs, Gd^Fmw, Gd^Fmw, Gs, Ww, Ww, Ww, Dd, Ww, Wo, Wo, Wo
Wo, Wo, Wo, Ww, Ww, Gs, Gs, Gs^Ftd, Gs^Ftd, Rd, Rd, Gd^Fmw, Gd^Ftd, Gd^Fmw, Gd^Ftr, Gd^Ftd, Gd^Ftd, Gd^Fdw, Gd^Fmw, Rd, Rd, Rd, Gs^Ftr, Gd, Gd^Fmw, Gd^Fmw, Gs, Gs, Gs, Gs^Ftd, Ww, Ww, Wo, Wo, Wo
Wo, Wo, Ww, Ww, Ww, Gs, Gd^Fts, Gs^Vht, Gd^Fts, Rd, Gd^Fdw, Gd^Ftd, Gd^Ftd, Ss, Gd^Fmw, Gd^Fdw, Gd^Fts, Rd, Rd, Gd^Fmw, Gd^Ftd, Gs^Ftr, Ss, Ss, Gd^Fmw, Rd, Gd^Fmw, Gd^Fmw, Gs^Fts, Gd^Fmw, Gd^Fmw, Ww, Wo, Wo, Wo
Wo, Wo, Ww, Gs, Ww, Gs, Gd^Fts, Gd^Fts, Gd^Fts, Gd^Fts, Rd, Rd, Gd, Gd^Ftd, Gd^Fdw, Gd^Fdw, Gd^Ftd, Rd, Gd, Gs^Fdw, Gd^Fmw, Gd^Ftd, Gd^Ftd, Gs^Ftd, Gd^Vh, Gd^Fmw, Rd, Rd^Edt, Rd, Gd^Fmw, Gs^Ftd, Ww, Wo, Wo, Wo
Wo, Wo, Ww, Gs^Ftd, Ww, Ww, Gs, Gd, Gs^Ftd, Gs^Ftd, Gs^Ftd, Rd, Gd, Gd, Gd^Fts, Gd, Ss, Rd, Gd^Fmw, Gd^Fmw, Gd^Fts, Gd^Fdw, Gd^Fmw, Gd^Fmw, Rd, Gs^Ftd, Gs^Ftd, Rd^Edt, Cer^Edt, Gs^Ftd, Ww, Ww, Wo, Wo, Wo
Wo, Wo, Ww, Gs^Ftd, Gs^Ftd, Ww, Ww, Ww, Ww, Ww, Gs^Ftd, Dd, Gd^Edp, Gd, Gd, Gd, Gd, Rd^Edt, Gd^Fdw, Gd^Fmw, Cer, Cer, Gd^Vh, Gd^Fmw, Rd^Ecf, Rd, Rd^Vh, Gs^Ftd, Gs^Ftd, Ww, Ww, Wo, Wo, Wo, Wo
Wo, Wo, Ww, Gs^Ftd, Gs, Ww, Wo, Wo, Ww, Ww, Dd, Dd, Dd, Dd, Gd, Dd, Gd, Rd^Edt, Gd, Gd, Cer^Edt, Ket, Gs^Ftd, Gd^Edt, Gd^Edt, Gs^Vh, Gs^Ftd, Ww^Bw\, Ww, Ww, Wo, Wo, Wot, Wot, Wot
Wo, Wo, Wo, Ww, Ww, Ww, Wo, Wo, Wwr, Ww, Ww, Ww, Dd, Dd, Dd, Dd, Dd, Dd, Gd, Dd^Edt, Dd, Ww, Gs, Ww, Gs, Ww, Ww, Ww, Wwt, Wo, Wot, Wot, Wot, Wot, Wot
Wo, Wo, Wo, Wo, Ww, Wo, Ww, Wwr, Wwr, Ww, Dd, Dd, Ss, Dd, Ss, Ss, Dd, Dd, Dd, Dd, Dd, Ww, Ww, Ww, Ww, Ww^Bw\, Wwt, Wwt, Wwt, Wwt, Wwt, Wot, Wwt, Wot, Wot
Wo, Wo, Wo, Ww, Ww, Ww, Ww, Ww, Ww, Ww, Ww, Dd, Dd, Dd, Dd, Ss, Dd, Dd, Dd, Ww, Ww, Ww, Wo, Wo, Wo, Wwt, Wwt, Wwt, Ww, Dd, Wwt, Wwt, Wwt, Wot, Wot
Wo, Wo, Wo, Ww, Gs, Gs, Gs^Edp, Gs, Dd, Ww, Ww, Ww, Ss, Ss, Dd, Ss, Dd, Ww, Ww, Ww, Wwr, Wo, Wo, Wo, Wot, Wwt, Wwt, Dd, Dd, Dd, Dd, Dd, Wwt, Wot, Wot
Wo, Wo, Ww, Ww, Gs^Ftd, Gs^Ftd, Gs^Ftr, Gs^Ftd, Dd^Vhr, Dd, Ss, Ss, Dd, Dd, Dd, Dd, Ww, Ww, Wwr, Ww, Wwr, Wwr, Wo, Wot, Wwt, Wwt, Dd, Gs, Gs^Ftd, Gs, Gs^Ftd, Dd, Wwt, Wot, Wot
Wo, Wo, Ww, Ww, Gs, Gs^Ftr, Gd^Ftr, Gd^Ftd, Dd, Ss, Ww, Ss, Ww, Ww, Dd, Dd, Ww, Wwr, Wwr, Wo, Wo, Wo, Wot, Wot, Wwt, Wwt, Dd, Gs, Gs, Gs^Ftd, Gs^Ftd, Dd, Wwt, Wot, Wot
Wo, Wo, Ww, Gs^Ftd, Gd^Ftd, Gs^Ftr, Gd^Ftd, Dd^Edt, Dd, Dd, Ss, Ss, Ww, Ss, Ww, Ww, Wwr, Ww, Wo, Wo, Wo, Wo, Wot, Wot, Wot, Wwt, Wwr, Wwr, Dd, Dd, Dd, Wwt, Wot, Wot, Wot
Wo, Wo, Ww, Gd^Ftd, Gd, Gd^Ftd, Gd^Ftd, Gd^Ftd, Dd, Dd, Dd, Dd, Dd, Ss^Vhs, Dd, Ww, Wo, Wo, Wo, Wo, Wo, Wot, Wot, Wot, Wwt, Wwt, Wwt, Wwr, Wwr, Wwt, Wwt, Wwt, Wot, Wot, Wot
Wo, Wo, Ww, Ww, Chr^Edt, Gd^Ftd, Gd^Edt, Ss, Rd, Rd, Dd, Ss, Dd, Dd, Gs, Ww, Wo, Wo, Wo, Wo, Wot, Wot, Wot, Wot, Wwt, Wwt, Wwt, Wwr, Wwt, Wwt, Wwt, Wwt, Wot, Wot, Wot
Wo, Wo, Wo, Chr, Chr^Edt, Gd^Edt, Gd^Ftd, Rd, Ss, Gd^Ftd, Gd^Vhr, Dd, Dd, Gs, Gs, Ww, Ww, Ww, Wo, Wot, Wot, Wot, Wot, Wwt, Wwt, Dd^Vdr, Wwr, Wwr, Wwt, Wwt, Wot, Wot, Wot, Wot, Wot
Wo, Wo, Ww, 4 Khr, Chr^Edt, Chr, Gd^Ftd, Gs^Ftd, Ss, Ss, Gs^Ftd, Gs, Gs, Gs^Edp, Gd^Fts, Gs, Ww, Ww, Wo, Wot, Wot, Wot, Wwt, Wwt, Dd, Dd, Dd, Dd, Wwt, Wot, Wot, Wot, Wot, Wot, Wot
Wo, Wo, Ww, Gd^Ftd, Gd^Edt, Gd^Ftd, Gd^Ftd, Gd, Gs^Ftd, Gs, Gd, Gd, Gd, Gd^Fts, Gd^Fts, Ww, Ww, Wo, Wo, Wot, Wot, Wwt, Wwt, Ww^Bw\, Dd, Hd, Hd, Md, Wwt, Wwt, Wwt, Wwt, Wwt, Wot, Wot
Wo, Wo, Ww, Dd, Dd, Gd^Edt, Gd, Gs, Gs^Vht, Gs, Gs, Gs, Gd^Fts, Gd^Fts, Ww, Ww, Wo, Wo, Wot, Wwt, Wwt, Wwt, Wwt, Dd, Md, Mv, Md, Md, Dd, Dd, Wwt, Wwt, Wwt, Wot, Wot
Wo, Wo, Ww, Dd, Gs, Gd, Gs, Gs, Ss, Gd^Edt, Gd^Edt, Gs^Edt, Gs^Edt, Ww, Ww, Wo, Wo, Wo, Wot, Wwt, Wwt, Gs, Gs^Vc, Gd^Ftd, Hd, Md, Hd, Hd, Gd^Ftd, Dd, Dd, Wwt, Wwt, Wot, Wot
Wo, Wo, Ww, Dd, Gs, Gs, Gs, Ss, Gd, Gd, Gs^Edp, Gs^Edt, Gs^Edt, Ww, Ww, Wo, Wo, Wo, Wot, Wot, Wwt, Wwt, Gs, Hd, Mm, Md, Hd, Gd^Ftd, Dd, Wwr, Wwt, Wwt, Wot, Wot, Wot
Wo, Wo, Ww, Ww, Wwr, Wwr, Gs^Edt, Gs, Gs^Edt, Gs^Edt, Gd^Edt, Gd, Wwr, Ww, Wo, Wo, Wo, Wo, Wwr, Wot, Wot, Wwt, Wwt, Gs, Gs, Gs, Gs, Dd, Wwr, Wwr, Wot, Wot, Wot, Wot, Wot
Wo, Wo, Wo, Ww, Ww, Wwr, Gs, Gd^Edt, Gd^Edt, Gd^Edt, Gd, Gd, Wwr, Ww, Wo, Wwr, Wwr, Wwr, Wwr, Wwr, Wwr, Wot, Wwt, Wwt, Gs, Ss, Gs, Wwr, Wwr, Wwr, Wwr, Wot, Wot, Wot, Wot
Wo, Wo, Wo, Wo, Ww, Wwr, Wwr, Gd^Edt, Ww, Gd, Wwr, Wwr, Wwr, Ww, Wwr, Wwr, Wo, Wo, Wo, Wo, Wo, Wot, Wwt, Wwt, Gs, Wwt, Wwt, Wwt, Wot, Wot, Wot, Wot, Wot, Wot, Wot
Wo, Wo, Wo, Wo, Wo, Ww, Ww, Ww, Ww, Ww, Ww, Wwr, Ww, Wwr, Wwr, Wwr, Wo, Wo, Wo, Wo, Wot, Wot, Wwt, Wwt, Wwt, Wwt, Wwt, Wot, Wot, Wot, Wot, Wot, Wot, Wot, Wot
Wo, Wo, Wo, Wo, Wo, Wo, Wo, Ww, Wo, Ww, Wo, Wo, Wo, Wwr, Wo, Wo, Wo, Wo, Wo, Wo, Wot, Wot, Wot, Wwt, Wot, Wwt, Wot, Wot, Wot, Wot, Wot, Wot, Wot, Wot, Wot
Wo, Wo, Wo, Wo, Wo, Wo, Wo, Wo, Wo, Wo, Wo, Wo, Wo, Wo, Wo, Wo, Wo, Wo, Wo, Wot, Wot, Wot, Wot, Wot, Wot, Wot, Wot, Wot, Wot, Wot, Wot, Wot, Wot, Wot, Wot
