Xu, Xu, Xu, Xu, Xu, Xu, Xu, Xu, Xu, Xu, Xu, Xu, Xu, Xu, Wog^Ii, Wog^Ii, Wog, Wog, Wog^Ii, Wog, Xu, Xu, Xu, Xu, Xu, Xu, Xu, Xu, Xu, Xu, Xu, Xu, Xu, Xu, Xu, Xu, Xu, Xu, Xu, Xu, Xu, Xu
Xu, Xu, Xu, Xu, Xu, Xu, Xu, Xu, Xu, Xu, Xu, Xu, Xu, Xu, Xu, Wog^Ii, Xu, Wog^Ii, Wog^Ii, Wog^Ii, Xu, Xu, Xu, Xu, Xu, Xu, Xu, Xu, Wog, Xu, Wog, Xu, Xu, Xu, Xu, Xu, Xu, Xu, Xu, Xu, Xu, Xu
Xu, Xu, Xu, Xu, Xu, Xu, Xu, Xu, Xu, Xu, Xu, Xu, Xu, Xu, Xu, Xu, Xu, Xu, Wog^Ii, Wog, Wog, Xu, Xu, Xu, Xu, Xu, Wog, Wog, Wog, Wog, Wwg^Qhu, Wog, Wog, Xu, Xu, Xu, Xu, Xu, Xu, Xu, Xu, Xu
Xu, Xu, Xu, Xu, Xu, Xu, Xu, Xu, Xu, Xu, Xu, Xu, Xu, Xu, Xu, Xu, Xu, Xu, Xu, Wog, Wog, Wog^Ii, Wog, Xu, Wog, Xu, Wog, Wog, Wwg^Qhu, Wwg^Qhu, Chr, Wwg^Qhu, Wwg^Qhu, Wog, Wog^Qhu, Xu, Wwg^_ml, Xu, Xu, Xu, Xu, Xu
Xu, Xu, Xu, Xu, Xu, Xu, Xu, Xu, Xu, Xu, Xu, Xu, Xu, Xu, Xu, Xu, Chr^Dr, Xu, Xu, Wwg, Wwg, Wog, Wwg, Wog, Wog, Wog, Wog, Wog, Wwg^Qhu, Chr^Dr, Kvr, Chr, Uu, Wwg^Qhu, Uu, Wwg^Qhu, Wwg^Qhu, Wwg^Qhu, Wwg^Qhu, Wwg, Wog, Xu
Xu, Xu, Xu, Xu, Xu, Xu, Xu, Xu, Xu, Xu, Xu, Xu, Xu, Chr, Kvr, Uu, Chr^Fetd, Chr^Dr, Ur^Qhu, Ds, Ds^Es, Wwg, Xu, Wog, Xu, Wwg, Wwg^Qhu, Wwg^Qhu, Uh^Qhh, Chr, Uu, Uu^Dr, Rb^Tf, Uu^Fetd, Uh^Qhh, Xu, Xu, Xu, Xu, Wwg^Qhu, Wwg^Qhu, Wog
Xu, Xu, Xu, Xu, Xu, Xu, Xu, Xu, Xu, Xu, Xu, Xu, Uu, Chr, Rb, Rb, Uu, Ur^Qhu, Ur^Qhu, Ds^Es, Uh^Qhh, Wwg, Wwg, Xu, Xu, Xu, Xu, Uh^Qhh, Uh^Qhh, Uu^Fetd, Uu, Tb^Tf, Tb^Tf, Tb^Tf, Uh^Qhh, Uh^Qhh, Xu, Xu, Xu, Xu, Xu, Wwg^Qhu
Xu, Xu, Xu, Xu, Xu, Xu, Xu, Xu, Xu, Xu, Xu, Xu, Uh^Qhh, Uu^Tf, Tb^Tf, Rb^Tf, Re, Uu, Uh^Qhh, Uh^Qhh, Uh^Qhh, Ds, Wwg^Es, Wog, Xu, Xu, Xu, Xu, Xu, Uu^Vud, Xu, Ur^Qhu, Ur^Qhu, Tb^Tf, Rb^Tf, Uh^Qhh, Xu, Xu, Xu, Xu, Xu, Xu
Xu, Xu, Xu, Xu, Xu, Xu, Xu, Xu, Xu, Xu, Xu, Xu, Uh^Qhh, Uh^Qhh, Tb^Tf, Tb^Tf, Uu^Vu, Re, Chr, Xu, Xu, Xu, Xu, Wwg, Xu, Xu, Xu, Xu, Xu, Xu, Xu, Ur^Qhu, Uu^Qhh, Rb^Tf, Xu, Uh^Qhh, Xu^Qhh, Xu, Xu^Qhh, Xu, Xu^Qhh, Xu
Xu, Xu, Xu, Xu, Xu, Xu, Xu, Xu, Xu, Xu, Xu, Xu, Xu, Uh^Qhh, Xu, Ur^Qhu, Ur^Qhu, Ur^Qhu, Xu, Xu, Xu, Xu, Xu, Wog, Wog, Xu, Xu, Xu, Xu, Xu, Xu, Xu, Rb, Uu^Dr, Xu^Qhh, Xu^Qhh, Xu, Xu^Qhh, Xu, Xu^Qhh, Xu, Xu^Qhh
Xu, Xu, Xu, Xu, Xu, Xu, Xu, Xu, Xu, Xu, Xu, Xu, Xu, Xu, Xu, Xu, Uu^Es, Uu^Es, Uu^Qhh, Xu^Qhh, Wwf, Xu, Wwg, Wog, Wwg, Wwg, Wwg, Wwg, Wwg, Wwg, Wwg, Rb^Qhh, Xu, Uue^Qhh, Uhe^Vu, Xu, Xu, Xu, Xu^Qhh, Xu, Xu, Uu^_mh
Xu, Xu, Xu, Xu, Xu, Xu, Xu, Xu, Xu, Xu, Xu, Xu, Xu, Xu, Xu, Xu, Uh^Qhh, Uh^Qhh, Uh^Qhh, Uu^Qhh, Wwf^Es, Wwf, Wwf, Wwg, Wwf^Es, Xu, Xu, Xu, Xu, Wog, Wwg, Xu^Qhh, Xu^Qhh, Uue, Uu, Xu, Xu^Qhh, Xu^Qhh, Uu^Qhh, Xu, Xu, Xu
Xu, Xu, Xu, Xu, Xu, Xu, Xu, Xu, Uh^Qhh, Xu, Uh^Qhh, Xu, Xu, Xu, Xu, Xu, Xu, Xu, Uh^Qhh, Xu^Qhh, Uu^Qhh, Wwf^Es, Uu^Qhh, Wwf, Uu^Qhh, Xu, Xu, Xu, Xu, Xu, Xu, Wwg, Wwg, Uu^Qhh, Xu^Qhh, Uu^Qhh, Wwf, Wwg^Es, Wwg, Xu^Qhh, Xu^Qhh, Xu
Xu, Xu, Xu, Xu, Xu, Xu, Xu, Uu, Chr, Uh^Qhh, Uh^Qhh, Xu, Uh^Qhh, Xu, Uu, Xu, Xu, Xu, Xu, Uh^Qhh, Uh^Qhh, Xu^Qhh, Xu, Xu^Qhh, Xu, Uu, Re, Uu^Vud, Xu, Xu, Xu, Wog, Wwg, Wwg, Wwf, Wwf, Wwf^Es, Uu, Uh^Qhh, Wwg, Wog, Xu^Qhh
Xu, Xu, Xu, Xu, Xu, Xu, Uu, Xu, Kvr, Tb^Tf, Tb^Tf, Uh^Qhh, Rb^Es, Uu^Vud, Uhe, Uhe, Chr^Dr, Xu, Xu, Xu^Qhh, Xu, Xu^Qhh, Uue, Uh^Vu, Uu, Re, Re, Rb, Uu, Xu, Uu^Es, Wwg^Es, Wwg, Wwg, Uu, Uh^Qhh, Uh^Qhh, Uu, Uh^Qhh, Xu, Xu, Wog
Xu, Xu, Xu, Xu, Uue^Tf, Uue^Tf, Uue, Chr, Uu, Chr, Uu^Fetd, Rb, Uue^Qhu, Rb^Es, Uu, Uhe, Rb, Xu, Xu, Xu, Xu, Xu, Xu, Uue, Xu, Xu, Rb, Rb, Uu, Uu^Es, Xu, Uu, Uh^Qhh, Uh^Qhh, Xu, Uh^Qhh, Xu, Xu, Xu, Xu, Xu, Xu
Xu, Xu, Xu, Xu, Xu, Uue^Tf, Uhe, Uu^Tf, Tb^Tfi, Uu^Tf, Uhe^Qhu, Uhe^Qhu, Uhe^Qhu, Uue^Qhu, Xu, Rb, Re^Fetd, Uu, Uue^Es, Uue, Uue, Xu, Rp^Qhu, Uue, Xu, Chr, Kvr, Chr, Uu, Xu, Uu, Uu, Xu, Xu, Xu, Xu, Xu, Xu, Xu, Xu, Xu, Xu
Xu, Xu, Xu, Xu, Xu, Uhe, Uhe, Xu, Xu, Tb^Tf, Uue^Ii, Uhe^Qhu, Xu, Uue^Qhu, Xu, Xu, Xu, Re^Es, Xu, Uu^Es, Xu, Rp^Qhu, Rp^Qhu, Xu, Xu, Xu, Chr^Dr, Chr^Dr, Uu, Uu, Rp^Qhu, Xu, Xu, Xu, Xu, Xu, Xu, Xu, Xu, Xu, Xu, Xu
Xu, Xu, Xu, Xu, Qxu, Qxu, Qxu, Xu, Qxu, Qxu, Qxu^Ii, Qxu^Ii, Qxu^Ii, Qxu, Xu, Xu, Xu, Xu, Uh^Qhh, Xu, Xu, Uu, Uu, Xu, Xu, Xu, Xu, Uu, Xu, Rp^Qhu, Rp^Qhu, Xu, Uh^Qhh, Xu, Xu, Xu, Xu, Xu, Xu, Xu, Xu, Xu
Xu, Xu, Xu, Xu, Qxu, Qxu, Qxu, Qxu, Qxu, Qxu, Qxu^Ii, Qxu^Ii, Qxu, Qxu, Qxu, Xu, Xu, Uh^Qhh, Uu^Es, Uh^Qhh, Uue, Xu, Uh^Qhh, Xu, Xu, Xu, Xu, Xu, Xu, Xu, Uu, Uu, Uh^Qhh, Uh^Qhh, Xu, Xu, Xu, Xu, Xu, Xu, Xu, Xu
Xu, Xu, Xu, Qxu^Ii, Qxu^Ii, Qxu, Qxu^Ii, Qxu, Qxu, Qxu, Qxu, Qxu, Qxu, Qxu, Qxu, Qxu, Rp^Qhu, Xu, Uu^Tf, Xu, Xu, Uue, Xu, Xu, Xu, Xu, Xu, Xu, Xu, Xu, Xu, Xu, Xu, Rb, Rb, Uh^Qhh, Xu, Xu, Xos, Xos, Xos, Xu
Xu, Xu, Qxu^Ii, Qxu^Ii, Qxu, Qxu, Qxu^Ii, Qxu^Ii, Qxu^Ii, Qxu, Xu, Tb^Tf, Tb^Tf, Tb, Uu, Rp^Qhu, Xu, Uu^Vud, Tb^Tf, Uu^Tf, Uu^Es, Xu, Uu^Es, Uu, Ur^Qhu, Uh^Qhh, Uh^Qhh, Xu, Xu, Xu, Xu, Xu, Xu, Isa, Isa, Uu, Isa, Uu, Chr^Dr, Kvr, Rr, Xos
Xu, Xu, Xu, Qxu, Xu, Qxu, Qxu, Rb^Qhu, Rb^Qhu, Xu, Xu, Uu^Tf, Uu^Tf, Uu^Tf, Xu, Xu, Xu, Xu, Xu, Xu, Xu, Uu^Es, Xu, Ur^Qhu, Ur^Qhu, Ur^Qhu, Uu^Es, Uu, Rp^Qhu, Uh^Qhh, Rp^Qhu, Uu^Es, Uu^Es, Uu, Isa, Isa^Ii, Isa, Rr, Isa, Chr, Isa^Efs, Isa^Eb
Xu, Xu, Xu, Xu, Xu, Xu, Uu^Tf, Rb^Qhu, Uu^Es, Xu, Uu, Uu, Tb^Tf, Xu, Tb^Tf, Xu, Xu, Xu, Xu, Xu, Xu, Xu, Rp^Qhu, Rp^Qhu, Xu, Uu^Es, Xu, Rp^Qhu, Rp^Qhu, Rp^Qhu, Uu, Rp^Qhu, Xu, Uh^Qhh, Xu, Xu, Chr, Rr, Isa, Isa^Ii, Rr, Rr^Ii
Xu, Xu, Xu, Xu, Xu, Xu, Uu^Fetd, Uu^Ii, Ur^Qhu, Ur^Qhu, Uh^Vu, Uu^Tf, Uu^Tf, Uu^Es, Uu^Es, Xu, Rp^Qhu, Xu, Xu, Xu, Uu, Rp^Qhu, Rp^Qhu, Xu, Xu, Xu, Xu^Qhh, Xu, Uh^Vu, Uu, Xu, Xu, Xu, Xu, Xu, Xos, Kvr, Chr, Rr^Dr, Isa, Isa, Rr
Xu, Xu, Xu, Xu, Xu, Uu, Chr, Chr^Dr, Uu, Ur^Qhu, Chr, Ur^Qhu, Uu, Uu^Fetd, Xu, Rp^Qhu, Uu, Rp^Qhu, Rp^Qhu, Rp^Qhu, Uh, Xu, Uh^Qhh, Xu, Xu, Xu, Xu, Uh^Qhh, Uh^Qhh, Uh^Qhh, Xu, Xu, Xu, Xu, Xu, Xos, Xos, Rr, Isa, Isa, Isa^Ii, Isa^Ii
Xu, Xu, Xu, Xu, Xu, Xu, Xu, Kvr, Xu, Chr, Chr, Ur^Qhu, Xu, Xu, Xu, Xu, Xu, Xu, Xu, Xu, Xu, Uh^Qhh, Xu, Xu, Xu, Xu, Xu, Xu, Xu, Xu, Xu, Xu, Xu, Xu, Xu, Xu, Xu, Xos, Isa^Efs, Isa, Rr, Isa^Ii
Xu, Xu, Xu, Xu, Xu, Xu, Xu, Xu, Xu, Xu, Xu, Xu, Xu, Xu, Xu, Xu, Xu, Xu, Xu, Xu, Xu, Xu, Xu, Xu, Xu, Xu, Xu, Xu, Xu, Xu, Xu, Xu, Xu, Xu, Xu, Xu, Xu, Xos, Xos, Isa, Xos, Xos
Xu, Xu, Xu, Xu, Xu, Xu, Xu, Xu, Xu, Xu, Xu, Xu, Xu, Xu, Xu, Xu, Xu, Xu, Xu, Xu, Xu, Xu, Xu, Xu, Xu, Xu, Xu, Xu, Xu, Xu, Xu, Xu, Xu, Xu, Xu, Xu, Xu, Xu, Xu, Xos, Xu, Xu
Xu, Xu, Xu, Xu, Xu, Xu, Xu, Xu, Xu, Xu, Xu, Xu, Xu, Xu, Xu, Xu, Xu, Xu, Xu, Xu, Xu, Xu, Xu, Xu, Xu, Xu, Xu, Xu, Xu, Xu, Xu, Xu, Xu, Xu, Xu, Xu, Xu, Xu, Xu, Xu, Xu, Xu
Xu, Xu, Xu, Xu, Xu, Xu, Xu, Xu, Xu, Xu, Xu, Xu, Xu, Xu, Xu, Xu, Xu, Xu, Xu, Xu, Xu, Xu, Xu, Xu, Xu, Xu, Xu, Xu, Xu, Xu, Xu, Xu, Xu, Xu, Xu, Xu, Xu, Xu, Xu, Xu, Xu, Xu
