Wo, Wo, Wo, Wo, Wo, Wo, Wo, Wo, Wo, Ai, Ai, Ai, Ai, Wwr, Aa, Aa^Fma, Aa^Fma, Aa^Fma, Ss, Ss, Gll^Fmw, Gs, Rb, Rb, Rb, Gs, Re, Gs, Ss, Ss, Gs, Re, Gs, Ss^Vhs, Ss, Ss, Gg, Gg, Gg, Gg, Gg^Efm, Gg, Gg, Gg, Gg, Gll^Fmf, Gll^Fmw, Gs^Ftr, Gs^Ftr, Gs^Ftr, Gg, Gg, Gs^Fmw, Gll^Fp, Gll^Ftr, Gg, Gs^Ftr, Gll^Fp, Aa, Aa^Fma
Wo, Wo, Wo, Ww, Ww, Wwr, Ww, Wo, Wo, Ww, Ai, Ai, Ai, Aa, Aa, Aa, Aa, Aa^Fda, Gs, Sm, Rb, Rb, Re, Rb, Re^Vhr, Re, Gs, Gs, Ss, Ss, Ss, Gs, Gs, Gs, Gs, Ss, Gg^Efm, Gg, Gg^Efm, Gg^Efm, Gg, Gg, Re, Re, Gg, Gs, Gg, Gll^Fmw, Gll^Fmw, Gll^Fmw, Gg^Fp, Gg^Fp, Gll^Fmw, Gs^Ftr, Gll^Fmw, Gll^Ftr, Aa^Fma, Gll^Fp, Aa^Fpa, Aa^Fma
Wo, Wo, Wo, Wo, Wo, Wwr, Wwr, Wo, Wo, Wo, Wo, Ai, Ai, Aa, Aa, Aa, Aa, Aa, Sm, Sm, Ss, Re, Aa, Gs, Re, Aa, Aa, Gs, Ss, Ss, Gs, Gs, Gs, Re, Aa, Aa, Aa, Aa, Gg, Gg, Gg, Gll, Aa, Aa, Aa, Aa, Aa, Gll^Fmw, Gs, Gll, Gll, Gll^Fp, Gs^Fp, Gll^Fp, Aa, Aa^Fpa, Aa^Fpa, Aa, Aa, Aa
Wo, Wo, Wo, Wo, Wo, Ww, Ww, Ww, Ww, Wo, Wo, Ww, Ai, Ai, Ai, Aa, Gs, Ss, Ss, Gg, Aa, Ss, Aa, Aa, Aa, Aa, Gg, Gg, Gg, Gs, Gs, Gs, Re, Gs, Aa, Aa, Aa, Aa, Re, Re, Gg, Gg, Aa, Aa, Aa, Aa, Gll^Fmw, Gg, Gs, Gs, Gg, Gs, Gg, Gg, Aa, Aa, Aa, Aa, Aa, Aa
Wo, Wo, Wo, Wo, Wo, Wo, Wo, Ww, Wwr, Ww, Wo, Ai, Wo, Ai, Ai, Ww, Ww^Es, Ss, Aa, Aa, Aa, Aa, Aa, Aa, Ss, Aa, Gg, Gg, Gg, Gg^Fmw, Gg^Fp, Re, Gg, Aa, Aa, Aa, Gg, Gg, Rb, Rb, Gs^Fmw, Gs^Vl, Gs^Fmw, Aa, Hh, Gg^Qhh, Gg^Qhh, Gg^Qhh, Gll^Qhhf, Gs, Gg^Fp, Gg^Fp, Gs, Gs, Gs, Aa, Gs, Gll, Gg^Ve, Gll
Wo, Wo, Wo, Wo, Wo, Wo, Wo, Wo, Wo, Wo, Wo, Ww, Wo, Wo, Wo, Ww, Ww, Aa, Aa, Aa, Aa, Ss, Ai, Cer, 6 Ker, Cer, Sm, Gg, Gg, Gs^Vl, Gg^Fmw, Re, Re, Aa, Gg, Gg, Re, Re, Gg, Gg, Gs^Fmw, Gs^Fmw, Gs^Fp, Gg^Es, Hh, Hh, Hh^Qhh, Gg^Qhh, Ss, Gll^Qhh, Gg^Qhh, Gg, Gll^Fp, Gg, Gll^Fp, Gll^Fp, Gll^Fp, Gll^Fp, Gll^Fmw, Gll^Fmw
Wo, Wo, Wo, Wo, Wo, Wo, Wo, Wo, Wo, Wo, Wo, Wo, Wo, Wo, Wo, Ww, Ww, Ww, Ww, Ai, Ai, Ai, Ai, Ai, Ai, Ss, Cer, Sm, Ss, Gg, Aa, Gg, Gg, Gg, 5 Ker, Cer, Re, Re, Re, Gs, Aa, Gg^Qhhf, Gg^Qhh, Gs, Hh^Es, Hh, Hh^Qhh, Ss, Ss, Ss, Sm, Gs^Qhh, Gs^Qhh, Gll^Qhh, Gll^Qhh, Gll^Fp, Gg^Qhh, Gll^_mh, Gg^Qhh, Gg^Qhh
Wo, Wo, Wo, Wo, Wo, Wo, Wo, Wo, Wo, Wo, Wo, Wo, Wo, Wo, Wo, Wo, Wo, Ww, Ai, Ai, Ai, Ai, Ww, Ai, Ai, Gg, Aa, Aa, Aa, Aa, Aa, Aa, Gg, Cer, Re, Cer, Cer, Re, Aa, Aa, Aa, Aa, Hh^Qhh, Hh^Qhh, Hh^Qhh, Hh^Qhh, Ai, Hh^Qhh, Ai, Ss, Sm, Sm, Ss, Ss, Ss, Gs^Qhh, Sm, Gll^Qhh, Ss, Ss
Wo, Wo, Wo, Wo, Wo, Wo, Wo, Wo, Wo, Wo, Wo, Wo, Wo, Wo, Wo, Wo, Wo, Ai, Ai, Ai, Ai, Ai, Ww, Sm, Ww, Ai, Ai, Aa, Aa, Aa, Aa, Aa, Re, Rb, Chr, Gs^Vhr, Gs, Rb, Re, Aa, Ww, Aa, Sm, Ss, Ww, Ai, Ai, Ai^Es, Ai, Ai, Ww, Sm, Sm, Ss, Sm, Sm, Sm, Sm, Sm, Sm
Ww, Wo, Wo, Wo, Wo, Wo, Wo, Wo, Ww, Wo, Wo, Wo, Wo, Wo, Wo, Wo, Wo, Wo, Wo, Ww, Ww, Ww, Ww, Ww, Ww, Ww, Ww, Ww^Es, Ww, Gg, Ww, Gg, Gs^Vhr, Re, Chr, Chr^Dr, Ww, Ww, Ww, Ww, Ww, Ww, Ww, Ww, Ww, Ww, Ai, Ww, Ww, Ww, Ww, Ww, Ww, Sm, Sm, Ss, Sm, Ss, Ss, Sm
Wo, Ww, Ww, Ww, Ww, Ww, Wo, Wo, Ww, Ww, Ww, Ww, Wo, Wo, Wo, Ww, Ww, Ww, Ww, Ww, Ww, Ww, Ww, Ww, Ds, Ww, Ww, Ww, Wo, Ww, Wo, Chr^Dr, Rb, Re, Re, Ww, Ww, Ww, Ww, Ww, Ww, Ww, Ww, Ww, Ww, Ww, Ww, Ww, Ww, Ww, Ww, Ww, Ww, Sm, Ww, Sm, Sm, Ss, Sm, Sm
Wo, Wo, Ww, Ww, Ww, Ww, Wo, Wo, Ww, Ww, Wwr, Ww, Re, Wwr, Aa^Eff, Ww, Ww, Ww, Ww^Bw\, Ww, Ch, Ww, Wo, Ww, Ww, Ds^Ewsh, Wo, Ww, Ww, Wo, Wo, Wo, Wo^Bw/, Rb, Wo, Wo, Wo, Ww, Ww, Ww, Wo, Ww, Wo, Wo, Wo, Wo, Wo, Ww, Wo, Wo, Wo, Ww, Ww, Ww, Ww, Ww, Ww, Ww, Ww, Wo
Wo, Wo, Ww, Ww, Wo, Ww, Wo, Ww, Ww, Ww, Re, Aa, Aa, Aa, Aa, Aa^Eff, Rb^Eff, Ww^Bw\, Gs, Re^Vhc, Rr^Edt, Ww, Ww, Ww, Ww, Ww, Ww, Ww, Ds, Ww, Ww^Bw/, Wo^Bw/, Wo, Wo, Wo, Wo, Wo, Wo, Wo, Wo, Wo, Wo, Wo, Wo, Wo, Wo, Wo, Wo, Wo, Wo, Wo, Wo, Wo, Wo, Wo, Ww, Ww, Ww, Ww, Ww
Wo, Wo, Wo, Wo, Wo, Wo, Wo, Wo, Wo, Ds, Re, Re, Aa^Vha, Aa, Aa, Rb, Gd^Eff, Gd^Eff, Re, Rr^Edt, Ww^Bsb\, Ww, Ww, Ds, Ds, Ww, Re^Ebn, Re^Vhc, Rr^Edt, Rr, Ch^Edt, Wo, Wo, Wo, Wo^Qhu, Wo^Qhu, Wo^Qhu, Wo^Qhu, Wo^Qhu, Wo, Wo, Wo, Wo, Wo, Wo, Wo, Wo, Wo, Wo, Wo, Wo, Wo, Wo, Wo, Wo, Wo, Wo, Ww, Wo, Ww
Wo, Wo, Wo, Wo, Wo, Wo, Wo, Wo, Wo, Ds, Ds, Re, Ds, Aa, Rb, Gd^Vh, Gd, Gs, Ds, Ww^Edt, Ww, Ww^Bsb\, Re, Ds^Esd, Rb^VjA, Gs^VjB, Rr^Edt, Rr, Hh, Ch, Ch, Ww^Qhu, Wwr^Qhu, Wwr^Qhu, Ms, Hh, Mm^Xm, Wo^Qhu, Wo^Qhu, Wo^Qhu, Wo, Wo, Wo, Wo, Wo, Wo, Wo, Wo, Wo, Wo, Wo, Wo, Wo, Wo, Wo, Wo, Wo, Wo, Wo, Wo
Wo, Wo, Wo, Wo, Wo, Wo, Wo, Wo, Wo, Wo, Ww, Ww, Ds, Ds, Ww^Bw/, Rb, Wo, Ds, Wo, Wo, Ww, Ww, Aa^Fda, Rr, Rr, Rr, Gs^Vhc, Re^VjE, Hh, Mm, Ha, Ms, Ms, Ms, Ms, Ms, Mm, Mm, Wo^Qhu, Wo^Qhu, Wo^_ml, Wo, Wo, Wo, Wo, Wo, Wo, Wo, Wo, Wo, Wo, Wo, Ww, Wo, Wo, Wo, Wo, Wo, Wo, Wo
Wo, Wo, Wo, Wo, Wo, Wo, Wo, Wo, Ww, Ww, Ds^Esd, Ww^Ewf, Ww, Ww, Wo, Wo, Wo, Wo, Ww, Ww, Ha^Fda, Ha^Fda, Aa^Fma, Aa, Rr, Rr, Rr, Rr, Rr, Ha, Rr, Ha, Hh, Hh, Hh, Ha, Ww^Qhu, Wo^Qhu, Wo, Wo, Wo^Qhu, Wo, Wo, Wo, Wo, Wo, Wo, Wo, Wo, Wo, Wo, Wo, Wo, Ww, Ww, Ww, Ww, Wo, Wo, Wo
Wo, Wo, Wo, Wo, Wo, Wo, Wo, Ww, Ww, Ds, Ww, Ds^Esd, Wo, Wo, Wo, Wo, Wo, Ww^Bw\, Ch^Edt, Rr^Vhc, Ch, Ha^Fda, Rr, Rr, Rb^VjA, Rb^VjA, Re^VjB, Re^VjC, Rr, Rr, Gs^Xo, Rr^Vhc, Mm, Mm, Hh, Ww^Qhu, Wo, Wo, Wo^Qhu, Wo^Qhu, Wo, Wo, Ww, Wo, Ww, Wo, Wo, Ww, Ww, Wo, Wo, Wo, Wo, Wo, Wo, Ww, Ww, Ww, Wo, Wo
Wo, Wo, Wo, Wo, Wo, Wo, Wo, Wo, Ww, Ww, Wo, Ww, Wo, Wo, Wo, Wo, Wo, Wo^Bw\, Ch, Kh, Rr, Rr, Rr^Edt, Re^Vhc, Hh, Gs^VjA, Hh^Edt, Gs^VjA, Ch^Edt, Aa, Ha, Ha^Fda, Ha^Fma, Ha^Fda, Ai^Qhu, Ai^Qhu, Wo, Wo^Qhu, Wo, Wo, Ww, Ww, Ww^Qhu, Ww^Qhu, Ww^Qhu, Ww, Ww^Qhu, Ww, Ww, Ww, Wo, Wo, Wo, Wo, Wo, Wo, Wo, Wo, Wo, Wo
Wo, Wo, Wo, Wo, Wo, Wo, Wo, Wo, Wo, Wo, Wo, Wo, Wo, Wo, Wo, Wo^Bw\, Ch^Edt, Kh, Ch, Ch, Rr, Gs^Ebn, Ch^Edt, Rr^Edt, Rr, Hh, Ww, Ch, Ww, Aa, Aa, Aa, Wo^Qhu, Ai^Qhu, Wo, Ai, Wo, Wo, Ww, Ww, Ww^Qhu, Ww^Qhu, Ha, Ha, Gg, Ww^Qhu, Gg^Es, Ww^Qhu, Ww^Qhu, Ww, Ww, Wo, Wo, Wo, Wo, Wo, Wo, Wo, Wo, Wo
Wo, Wo, Wo, Wo, Wo, Wo, Wo, Wo, Wo, Wo, Wo, Wo, Wo, Wo, Ww, Ww^Edt, Ww, Rr^VjB, Wo, Rr^Vhc, Wo, Rr, Ww^Bsb\, Ww, Ww, Ww^Bsb\, Rr, Wo, Wo, Ww, Wo, Wo^Qhu, Wo, Wo, Wo, Wo, Wo, Ww, Ww^Qhu, Ww^Qhu, Hh^Es, Ha, Ha, Ha^Es, Gg, Hh, Hh, Hh, Gg, Ww^Qhu, Ww^Qhu, Wo, Wo, Wo, Wo, Wo, Wo, Wo, Wo, Wo
Wo, Wo, Wo, Wo, Wo, Wo, Wo, Wo, Wo, Wo, Wo, Wo, Wo, Wo, Wo, Wo, Wo, Wo, Wo, Wo, Wo, Ww, Rr^Vhc, Rr, Rr, Re^Ebn, Re^Vhc, Rr^Edt, Rr^Edt, Ch^Edt, Ww, Wo^Qhu, Wo, Wo, Wo, Wo, Ww^Qhu, Ww^Qhu, Hh^Fdw, Hh, Ha^Edt, Ha^Es, Ha, Hh^Fdw, Aa^Fda, Gg, Hh, Hh^Fdw, Hh^Fdw, Gll^Fdw, Gll^Fdw, Ww^Qhu, Ww^Es, Wo, Wo, Wo, Ai, Wo, Wo, Wo
Wo, Wo, Ai, Ai, Ai, Wo, Wo, Wo, Wo, Wo, Wo, Wo, Wo, Wo, Ww, Wo, Wo, Wo, Ww, Wo, Ds, Rr^VjD, Rr^VjE, Aa^Edt, Rr^Vhc, Rr, Rr, Gs^VjE, Ww^Edt, Ww^Bsb\, 4 Ww^Bsb\, Wo, Wo, Wo, Wo, Ww, Ww^Qhu, Gll^Fmw, Gll^Fmw, Gll^Fdw, Aa, Cea, Cea, Aa^Fma, Aa^Fda, Aa^Fma, Gll^Fmw, Hh, Hh, Hh^Fdw, Hh^Fdw, Ww^Qhu, Ai^Qhu, Ww, Ai^Qhu, Wo, Ai, Ai, Wo, Wo
Wo, Wo, Wo, Aa, Ww, Ww, Wo, Wo, Ww, Wo, Ww, Wo, Ai, Wo, Wo, Wo, Ww, Wo, Ww, Ww, Ww, Ds^Esd, Ww^Edt, Ds, Ww, Ch, Ww, Ww^Bsb\, Ww^Dr, Ww^Edt, Ww, Wo^Bsb\, Wo^Bsb\, Wo, Ww^Qhu, Ww, Ww^Qhu, Hh, Gll^Fdw, Gll^Fdw, Ce, Kea, Gd^Fmf, Aa^Fma, Hh, Aa^Fda, Gll^Fdw, Hh^Es, Hh, Hh, Gs, Hh^Es, Hh, Ai^Qhu, Ai^Qhu, Ww^Qhu, Ai^Qhu, Ai^Qhu, Ai^Qhu, Ai^Qhu
Wo, Wo, Wo, Wo, Wo, Wo, Ww, Ww, Ds, Ww, Wwr, Ai, Ai, Ai, Ai, Ai, Ai, Ww, Ww, Ww, Ww, Ww^Edt, Ww, Ww, Ww, Ww, Wo, Wo, Wo, Wo^Bsb\, Wo^Bsb\, Wo, Ww^Edt, Ww^Dr, Re, Ww^Qhu, Re, Hh, Hh, Gg, Gg, Ce^Edt, Gg, Chr^Edt, Rb, Rb, Re, Gg, Re, Hh, Gs, Hh^Es, Hh, Hh, Hh, Ai^Qhu, Ai^Qhu, Ai^Qhu, Aa^Qhu, Ai^Qhu
Wo, Wo, Wo, Wo, Wo, Wo, Wo, Wo, Ww, Ds^Ewsh, Ww, Gs, Gs, Ai, Ai, Ai, Ww, Ww, Ww, Ww, Ww, Ww, Ww, Ww, Ww, Wo, Ww, Wo^Edt, Ww, Ww, Ww, Ww^Bsb\, Re, Gg, Re, Re, Re^Edt, Re, Gll^Fdw, Gll^Fmw, Gg, Gg^Edt, Gg^Edt, Rb, Rb, Rb, Rb, Re, Re, Re^Eff, Gg^Eff, Gg, Gg^Eff, Gg^Vh, Rb, Hh, Gg, Aa^Qhu, Gg, Aa^Qhu
Wo, Wo, Wo, Wo, Wo, Wo, Wo, Wo, Wo, Ww, Ww, Wwr, Aa, Aa, Aa, Ai, Ai, Ww, Ww, Wo, Wo, Ww, Ww, Ww, Ww, Ww, Ww, Ww, Ww, Ww, Ww, Gg, Gs^Edt, Re, Chr, Chr^Dr, Re, Re^Edt, Rb, Gll^Fmw, Re, Gg, Gg, Rb, Rb, Rb, Re, Re, Re, Re, Gg^Eff, Gg^Eff, Rb, Rb, Rb, Rb, Rb, Gg, Gg, Gg
Wo, Wo, Wo, Wo, Wo, Wo, Wo, Wo, Ww, Wo, Wo, Ww, Ww, Aa, Aa, Gs, Gd^Vht, Gs, Gd, Ww, Ww, Ww, Gs, Ww, Ww, Ww^Edt, Ww, Ww, Re^Vhr, Ww, Aa, Re^Dr, Aa^Edt, Re, Re^Edt, Ch, Gs, Rb, Rb, Re, Re, Re, Re, Re, Re, Rb, Rb, Re, Gs^Eff, Gs^Eff, Re, Re, Re, Rb, Rb, Rb, Rb, Rb, Aa, Gg
Wo, Wo, Wo, Wo, Wo, Wo, Wo, Wo, Ww, Ww, Ww, Wo, Wo, Ww, Aa, Aa, Gs^Es, Gs, Gs, Gs, Wwr, Re^Dr, Re, Ch^Edt, Ch, 3 Ch^Kov, Chr^Edt, Aa, Aa^Edt, Aa, Aa, Aa^Edt, Aa^Fma, Aa, Re, Re, Gs, Gs, 2 Ch^Kov, Re, Gg, Re, Re, Re, Rb, Re, Re, Gs^Eff, Gs, Re, Re, Re, Re, Re, Re, Rb, Re, Re, Aa, Aa
Wo, Wo, Wo, Wo, Wo, Wo, Wo, Wo, Wo, Wo, Wo, Wo, Ww, Ww, Ww, Ds, Ww, Wwr, Ww, Wwr, Re^Vhr, Re, Re, Gg, Gg^Edt, Chr, Re, Aa, Aa, Aa^Edt, Aa, Aa, Gll^Fdw, Gll^Fdw, Gd^Edt, Re, Re, Re^Vhr, Ch, Ch^Edt, Gs, Gs, Gs, Gs, Gg^Vhr, Re, Re, Re^Edt, Re, Gg, Gg, Re, Re, Aa, Aa, Aa, Aa, Aa, Aa, Aa
Wo, Wo, Wo, Wo, Wo, Wo, Wo, Wo, Ww, Wo, Wwr, Wo, Ww, Wo, Ww, Ww, Wwr, Ww^Edt, Chr, Ww, Gg, Gg^Edt, Aa, Gs^Ecf, Aa^Edt, Gg^Edt, Rb, Aa, Rb, Re^Vh, Gg, Gll^Fmw, Chr, Re^Edt, Re, Re^Ecf, Gg, Gg, Gs, Gs^Edt, Gg^Edt, Gg^Edt, Gs, Gs^Edt, Rb, Gg, Gs, Re, Re, Re, Re, Gg, Gg, Re, Aa^Eff, Aa, Re, Aa, Aa, Aa
Wo, Wo, Wo, Wo, Wo, Wo, Wo, Ch, Rr, Ww, Gg, Gg, Aa^Fma, Gd, Gll^Fmw, Ww, Aa^Fma, Aa^Edt, Aa^Fma, Aa, Aa, Aa, Aa, Aa, Aa, Re, Re, Rb, Re, Rb, Rb, Gg, Gs, Gs^Vh, Gs, Gs, Aa, Aa, Aa, Gs, Aa, Re, Re, Rb, Rb, Rb, Rb, Gg, Aa, Rb, Rb, Re, Re, Gs, Gs, Aa^Eff, Gs^Vwm, Aa, Aa, Aa
Wo, Wo, Ww, Wo, Wo, Wo, Ww^Bw/, Re^Vhc, Rr, Gg, Gs, Aa, Aa, Aa^Fma, Aa^Fda, Aa^Fma, Aa^Fma, Aa^Fma, Aa^Fda, Aa, Aa, Aa, Aa, Rb, Rb, Rb, Re, Re, Re, Re, Re, Rb, Gs^Eff, Gs, Aa, Aa, Aa, Aa, Aa, Aa, Aa, Aa, Aa, Rb, Re, Re, Rb, Rb, Aa, Aa, Aa, Rb, Re^Edt, Re, Re, Re, Re, Aa^Eff, Aa^Eff, Aa^Eff
Wo, Ww, Ww, Ww, Wo, Wo, Ww, Ww^Bw/, Gs, Rr, Aa, Aa, Aa, Aa^Fma, Aa^Fda, Aa, Aa^Fma, Aa^Fma, Aa^Fda, Aa, Aa, Aa, Aa, Aa, Aa, Re, Re, Re, Re, Re, Gg^Eff, Gs^Eff, Gg^Edt, Aa, Aa, Aa, Aa, Aa, Aa, Aa, Aa, Aa, Aa, Re, Re, Re, Rb, Rb, Aa^Vha, Aa, Gs, Gd, Gs, Re, Re, Re, Re, Re, Aa, Aa^Eff
Ww, Ww, Ww, Ww, Wo, Wo, Ww, Ww, Re, Gs, Gs, Dd^Esd, Ds, Ds, Aa, Aa^Fma, Aa, Aa^Fda, Gg, Gll^Fmw, Gll^Fmw, Aa, Gll^Fdw, Aa, Gd, Gg, Gg, Rb, Gg^Eff, Gg^Vwm, Gg^Eff, Gg, Rb, Rb, Rb, Rb, Aa, Aa, Aa, Aa, Aa, Aa, Aa, Aa, Aa, Aa, Aa^Eff, Aa^Eff, Aa, Rb, Re, Gll^Fdw, Gll^Fmw, Gll^Fdw, Gll^Fdw, Gs, Gll^Fdw, Re, Re, Aa
Ww, Ww, Ai, Wo, Wo, Ww, Ww, Ww, Re, Re, Gs, Gd, Gd, Gs, Aa, Aa, Aa, Gs, Aa, Aa^Fda, Gll^Fdw, Gll^Fmw, Gll^Fdw, Gll^Fmw, Gs, Gs, Gg, Gg^Eff, Re, Re, Re, Gg^Eff, Gg^Eff, Rb, Rb, Rb, Rb, Aa, Rb, Aa, Re, Aa, Aa, Aa, Aa^Eff, Aa^Eff, Aa, Aa, Re, Re, Re^Vh, Re, Rb, Gll^Fmw, Gs, Gll^Fmw, Gll^Fdw, Gs, Gs, Re
Wo, Ai, Ai, Wo, Ai, Ww^Bw\, Re^Vh, Re, Aa, Gs, Ds, Gd, Dd^Esd, Gs, Gd, Aa, Aa, Aa, Aa, Aa^Fda, Gs^Vl, Gll^Fmw, Aa, Gd, Rb, Gs, Re, Re, Re, Re, Re, Re, Rb, Gg^Eff, Gg^Eff, Rb, Rb, Rb, Rb, Rb, Rb, Rb, Rb^Eff, Rb^Eff, Aa, Aa, Aa, Aa, Aa, Re, Aa, Aa, Aa, Rb, Rb, Gs, Aa, Gs, Gll^Fmw, Gs
Ai, Ai, Ai, Ai, Aa, Ww, Aa, Aa, Ds, Ds, Ds^Es, Ds, Dd^Esd, Dd^Esd, Aa, Aa, Aa^Fda, Aa, Aa, Aa, Aa^Es, Aa, Aa, Aa, Aa, Rb, Rb, Re, Rb, Re, Re, Re, Re, Re, Re, Gg, Gg, Rb, Rb, Rb, Rb, Rb^Eff, Rb^Eff, Aa, Aa, Aa, Aa^Vha, Aa, Aa, Aa, Aa, Aa, Aa, Aa, Aa, Aa, Aa, Aa, Aa, Gll^Fmw
Ai, Ai, Ds, Aa, Aa, Aa, Aa, Aa, Ds^Esd, Dd^Esd, Dd, Dd, Dd, Dd^Esd, Aa, Aa, Aa^Fda, Aa^Fda, Aa, Aa, Aa, Aa, Aa, Aa, Aa, Aa, Rb, Rb, Rb, Rb, Rb, Rb, Re, Re, Rb^Gvs, Re, Re^Gvs, Gg, Gg, Rb, Rb, Rb, Rb, Rb^Eff, Aa^Eff, Aa, Rb, Aa, Aa, Aa, Aa, Aa, Aa, Aa, Aa, Aa, Aa, Aa, Rb, Gll^Fmw
