Wo, Wo, Wo, Wo, Wo, Wwr, Wwr, Wo, Wo, Wo, Wo, Ww, Ww, Ds, Ds, Gg, Gs, Gs, Sm, Sm, Ss, Re^Gvs, Gs, Gs, Re, Gs, Gg, Gs, Ss, Ss, Gs, Gs, Gs, Re, Gs, Gs, Gg^Efm, Gg^Efm, Gg, Gg, Gg, Gll, Gll, Gg, Gs, Gs, Gll, Gg^Fmw, Gs^Qhh, Gll
Wo, Wo, Wo, Wo, Wo, Ww, Ww, Ww, Ww, Wo, Wo, Ww, Wo, Ww, Ww, Gg, Gs, Ss, Ss, Gs^Dr, Gs, Ss, Gg, Gg, Gg, Gg, Gg, Gg, Gg, Gs, Gs, Gs, Re, Gs, Gs^Efm, Gs^Efm, Gg^Efm, Gg, Re, Re, Gg, Gg, Gg, Gg, Gg, Gs, Gll^Fmw, Gg^Qhh, Gs^_mh, Gs
Wo, Wo, Wo, Wo, Wo, Wo, Wo, Ww, Wwr, Ww, Wo, Wo, Wo, Wo, Wo, Ww, Ww^Es, Ss, Gg, Gs, Gg, Gg, Gg, Gg, Ss, Gg, Gg, Gg, Gg, Gg^Fmw, Gg^Fp, Re, Gg, Gg^Efm, Gg^Efm, Gg, Gg, Gg, Rb, Rb, Gg^Fmw, Gs^Vl, Gg^Fmw, Gg, Hh, Gg^Qhh, Gg^Qhh, Gg^Qhh, Gll^Qhhf, Gs
Wo, Wo, Wo, Wo, Wo, Wo, Wo, Wo, Wo, Wo, Wo, Ww, Wo, Wo, Wo, Ww, Ww, Gs, Gg, Gg, Gg, Ss, Ss, Ss, Ss, Ss, Sm, Gg, Gg, Gs^Vl, Gg^Fmw, Re, Re, Gg, Gg, Gg, Re, Re, Gg, Gg, Gg^Fmw, Gg^Fmw, Gg^Fp, Gg^Es, Hh, Hh, Hh^Qhh, Gg^Qhh, Ss, Gll^Qhh
Wo, Wo, Wo, Wo, Wo, Wo, Wo, Wo, Wo, Wo, Wo, Wo, Wo, Wo, Wo, Ww, Ww, Ww, Ww, Sm, Sm, Ss, Ss, Ss, Ss, Ss, Ss, Sm, Ss, Gg, Gg, Gg, Gg, Gg, Re, Gg, Rb^Gvs, Rb^Gvs, Rb^Gvs, Gg, Gg, Gg^Qhhf, Gg^Qhh, Gs, Hh^Es, Hh, Hh^Qhh, Ss, Ss, Ss
Wo, Wo, Wo, Wo, Wo, Wo, Wo, Wo, Wo, Wo, Wo, Wo, Wo, Wo, Wo, Wo, Wo, Ww, Ww, Ww, Ss, Ss, Ww, Ss, Sm, Gg, Gg, Gg, Gg, Gg, Gg^Efm, Gg^Efm, Gg, Gg, Re, Gg, Re^Gvs, Rb^Gvs, Rb^Gvs, Rb^Gvs, Rb^Gvs, Gs, Hh^Qhh, Hh^Qhh, Hh^Qhh, Hh^Qhh, Sm, Hh^Qhh, Sm, Ss
Wo, Wo, Wo, Wo, Wo, Wo, Wo, Wo, Wo, Wo, Wo, Wo, Wo, Wo, Wo, Wo, Wo, Wo, Wo, Ww, Ww, Ss, Ww, Sm, Ww, Sm, Sm, Gg, Gg, Gg^Efm, Gg, Gg^Efm, Re, Rb, Chr, Gs^Vhr, Gs, Re^Gvs, Rb^Gvs, Rb^Gvs, Ww, Gg, Sm, Ss, Ww, Sm, Sm, Ww^Es, Ww, Sm
Ww, Wo, Wo, Wo, Wo, Wo, Wo, Wo, Ww, Wo, Wo, Wo, Wo, Wo, Wo, Wo, Wo, Wo, Wo, Ww, Ww, Ww, Ww, Ww, Ww, Ww, Ww, Ww^Es, Ww, Gg, Ww, Gg, Gs^Vhr, Re, Chr, Chr^Dr, Ww, Ww, Ww, Ww, Ww, Ww, Ww, Ww, Ww, Ww, Ww, Ww, Ww, Ww
Wo, Ww, Ww, Ww, Ww, Ww, Wo, Wo, Ww, Ww, Ww, Ww, Wo, Wo, Wo, Ww, Ww, Ww, Ww, Ww, Ww, Ww, Ww, Ww, Ds, Ww, Ww, Ww, Wo, Ww, Wo, Chr^Dr, Rb, Re, Re, Ww, Ww, Ww, Ww, Ww, Ww, Ww, Ww, Ww, Ww, Ww, Ww, Ww, Ww, Ww
Wo, Wo, Ww, Ww, Ww, Ww, Wo, Wo, Ww, Ww, Wwr, Ww, Re^Gvs, Wwr, Re^Eff, Ww, Ww, Ww, Ww^Bw\, Ww, Chr, Ww, Wo, Ww, Ww, Ds^Ewsh, Wo, Ww, Ww, Wo, Wo, Wo, Wo^Bw/, Rb, Wo, Wo, Wo, Ww, Ww, Ww, Wo, Ww, Wo, Wo, Wo, Wo, Wo, Ww, Wo, Wo
Wo, Wo, Ww, Ww, Wo, Ww, Wo, Ww, Ww, Ww, Re^Gvs, Re^Gvs, Re^Gvs, Re^Gvs, Rb^Gvs, Re^Eff, Rb^Eff, Ww^Bw\, Gs, Re^Dr, Rr^Edt, Ww, Ww, Ww, Ww, Ww, Ww, Ww, Ds, Ww, Ww^Dr, Wo^Bw/, Wo, Wo, Wo, Wo, Wo, Wo, Wo, Wo, Wo, Wo, Wo, Wo, Wo, Wo, Wo, Wo, Wo, Wo
Wo, Wo, Wo, Wo, Wo, Wo, Wo, Wo, Wo, Ds, Re^Gvs, Re^Gvs, Rb^Dr, Rb^Gvs, Rb^Gvs, Rb^Gvs, Gd^Eff, Gd^Eff, Re, Rr^Edt, Ww^Bsb\, Ww, Ww, Ds, Ds, Ww, Re^Eb, Re^Dr, Rr^Edt, Rr, Chr^Edt, Wo, Wo, Wo, Wo^Qhu, Wo^Qhu, Wo^Qhu, Wo^Qhu, Wo^Qhu, Wo, Wo, Wo, Wo, Wo, Wo, Wo, Wo, Wo, Wo, Wo
Wo, Wo, Wo, Wo, Wo, Wo, Wo, Wo, Wo, Ds, Ds, Re^Gvs, Ds, Rb, Rb, Gd^Vhr, Gd, Gs, Ds, Ww^Edt, Ww, Ww^Bsb\, Re, Ds^Esd, Rb^VjAr, Gs^VjBr, Rr^Edt, Rr, Hh, Chr^Dr, Chr, Ww^Qhu, Wwr^Qhu, Wwr^Qhu, Mm, Hh, Mm^Xm, Wo^Qhu, Wo^Qhu, Wo^Qhu, Wo, Wo, Wo, Wo, Wo, Wo, Wo, Wo, Wo, Wo
Wo, Wo, Wo, Wo, Wo, Wo, Wo, Wo, Wo, Wo, Ww, Ww, Ds, Ds, Ww^Bw/, Rb, Wo, Ds, Wo, Wo, Ww, Ww, Gg^Fdw, Rr, Rr, Rr, Gs^Vhcr, Re^VjEr, Hh, Mm, Hh, Mm, Mm, Mm, Mm, Mm, Mm, Mm, Wo^Qhu, Wo^Qhu, Wo^_ml, Wo, Wo, Wo, Wo, Wo, Wo, Wo, Wo, Wo
Wo, Wo, Wo, Wo, Wo, Wo, Wo, Wo, Ww, Ww, Ds^Esd, Ww^Ewf, Ww, Ww, Wo, Wo, Wo, Wo, Ww, Ww, Hh^Fds, Hh^Fdw, Gg^Fds, Gg, Rr, Rr, Rr, Rr, Rr, Hh, Rr, Hh, Hh, Cer, 3 Ker, Hh, Ww^Qhu, Wo^Qhu, Wo, Wo, Wo^Qhu, Wo, Wo, Wo, Wo, Wo, Wo, Wo, Wo, Wo
Wo, Wo, Wo, Wo, Wo, Wo, Wo, Ww, Ww, Ds, Ww, Ds^Esd, Wo, Wo, Wo, Wo, Wo, Ww^Bw\, Chr^Edt, Rr^Vhcr, Chr, Hh^Fdw, Rr, Rr, Rb^Dr, Rb^VjA, Re^VjBr, Re^VjCr, Rr, Rr, Gs^Dr, Rr^Vhcr, Mm, Cer, Cer, Ww^Qhu, Wo, Wo, Wo^Qhu, Wo^Qhu, Wo, Wo, Ww, Wo, Ww, Wo, Wo, Ww, Ww, Wo
Wo, Wo, Wo, Wo, Wo, Wo, Wo, Wo, Ww, Ww, Wo, Ww, Wo, Wo, Wo, Wo, Wo, Wo^Bw\, Chr^Dr, 2 Khr, Rr, Rr, Rr^Edt, Re^Vhcr, Hh, Gs^VjAr, Hh^Edt, Gs^Dr, Chr^Edt, Gs, Hh, Hh^Fdw, Hh^Fds, Hh^Fdw, Ww^Qhu, Ww^Qhu, Wo, Wo^Qhu, Wo, Wo, Ww, Ww, Ww^Qhu, Ww^Qhu, Ww^Qhu, Ww, Ww^Qhu, Ww, Ww, Ww
Wo, Wo, Wo, Wo, Wo, Wo, Wo, Wo, Wo, Wo, Wo, Wo, Wo, Wo, Wo, Wo^Bw\, Chr^Edt, Khr, Chr, Chr^Dr, Rr, Gs^Eb, Chr^Edt, Rr^Edt, Rr, Hh, Ww, Chr^Dr, Ww, Gg, Gg, Gg, Wo^Qhu, Ww^Qhu, Wo, Wo, Wo, Wo, Ww, Ww, Ww^Qhu, Ww^Qhu, Hh, Hh, Gg, Ww^Qhu, Gg^Es, Ww^Qhu, Ww^Qhu, Ww
Wo, Wo, Wo, Wo, Wo, Wo, Wo, Wo, Wo, Wo, Wo, Wo, Wo, Wo, Ww, Ww^Edt, Ww, Rr^VjBr, Wo, Rr^Vhcr, Wo, Rr, Ww^Dr, Ww, Ww, Ww^Bsb\, Rr, Wo, Wo, Ww, Wo, Wo^Qhu, Wo, Wo, Wo, Wo, Wo, Ww, Ww^Qhu, Ww^Qhu, Hh^Es, Hh, Hh, Hh^Es, Gg, Hh, Hh, Hh, Gg, Ww^Qhu
Wo, Wo, Wo, Wo, Wo, Wo, Wo, Wo, Wo, Wo, Wo, Wo, Wo, Wo, Wo, Wo, Wo, Wo, Wo, Wo, Wo, Ww, Rr^Dr, Rr, Rr, Gs^Ebn, Re^Dr, Rr^Edt, Rr^Edt, Chr^Edt, Ww^Dr, Wo^Qhu, Wo, Wo, Wo, Wo, Ww^Qhu, Ww^Qhu, Hh^Fds, Hh, Hh^Edt, Hh^Es, Hh, Hh^Fds, Gg^Fds, Gg, Hh, Hh^Fds, Hh^Fds, Gg^Fds
Wo, Wo, Ww, Ww, Wo, Wo, Wo, Wo, Wo, Wo, Wo, Wo, Wo, Wo, Ww, Wo, Wo, Wo, Ww, Wo, Ds, Rr^VjEr, Rr^VjEr, Re^Edt, Rr^Vhcr, Rr, Rr, Gs^VjEr, Ww^Edt, Ww^Bsb\, 6 Ww^Bsb\, Wo, Wo, Wo, Wo, Ww, Ww^Qhu, Gg^Fms, Gg^Fms, Gg^Fds, Gg, Gg, Gg, Gg^Fms, Gg^Fds, Gg^Fms, Gg^Fms, Hh, Hh, Hh^Fds
Wo, Wo, Wo, Ds, Ww, Ww, Wo, Wo, Ww, Wo, Ww, Wo, Ww, Wo, Wo, Wo, Ww, Wo, Ww, Ww, Ww, Ds^Esd, Ww^Edt, Ds, Ww, Chr^Dr, Ww, Ww^Bsb\, Ww^Dr, Ww^Edt, Ww, Wo^Bsb\, Wo^Bsb\, Wo, Ww^Qhu, Ww, Ww^Qhu, Hh, Gg^Fds, Gg^Fds, Gg, Gg, Gg^Fms, Gg^Fms, Hh, Hh^Fds, Hh^Fds, Hh^Es, Hh, Hh
Wo, Wo, Wo, Wo, Wo, Wo, Ww, Ww, Ds, Ww, Wwr, Ww, Ww, Ww, Ww, Ww, Ww, Ww, Ww, Ww, Ww, Ww^Edt, Ww, Ww, Ww, Ww, Wo, Wo, Wo, Wo^Bsb\, Wo^Bsb\, Wo, Ww^Edt, Ww^Dr, Re, Ww^Qhu, Re, Hh, Hh, Gg, Gg, Gg, Gg, Chr^Edt, Rb^Gvs, Rb^Gvs, Re^Gvs, Gg, Re, Hh
Wo, Wo, Wo, Wo, Wo, Wo, Wo, Wo, Ww, Ds^Ewsh, Ww, Gs, Gs, Ww, Ww, Ww, Ww, Ww, Ww, Ww, Ww, Ww, Ww, Ww, Ww, Wo, Ww, Wo^Edt, Ww, Ww, Ww, Ww^Bsb\, Re, Gg, Re, Re, Re^Edt, Re, Gg^Fds, Gg^Fms, Gg, Gg^Edt, Gg^Edt, Rb^Gvs, Rb^Gvs, Rb^Gvs, Rb^Gvs, Re^Gvs, Re^Gvs, Re
Wo, Wo, Wo, Wo, Wo, Wo, Wo, Wo, Wo, Ww, Ww, Wwr, Ds^Esd, Ds, Ds, Ww, Ww, Ww, Ww, Wo, Wo, Ww, Ww, Ww, Ww, Ww, Ww, Ww, Ww, Ww, Ww, Gg, Gs^Edt, Re, Chr, Chr, Re, Re^Edt, Rb, Gg^Fms, Re, Gg, Gg, Rb^Gvs, Rb^Gvs, Rb^Gvs, Re^Gvs, Re^Gvs, Re^Gvs, Re^Gvs
Wo, Wo, Wo, Wo, Wo, Wo, Wo, Wo, Ww, Wo, Wo, Ww, Ww, Ds^Esd, Ds, Gs, Gd^Vht, Gs, Gd, Ww, Ww, Ww, Gs, Ww, Ww, Ww^Edt, Ww, Ww, Re^Vhr, Ww, Re, Re^Dr, Re^Edt, Re, Re^Edt, Chr^Dr, Gg, Rb, Rb, Re, Re, Re, Re, Re, Re, Rb^Gvs, Rb^Gvs, Re^Gvs, Gg^Eff, Gg^Eff
Wo, Wo, Wo, Wo, Wo, Wo, Wo, Wo, Ww, Ww, Ww, Wo, Wo, Ww, Ds, Gd, Gs^Es, Gs, Gs, Gs, Wwr, Re^Dr, Re, Gg, Re, Gs, Chr, Gs, Re^Edt, Re, Gs, Re^Edt, Gg^Fms, Gs, Re, Re, Gg, Gg, Chr, Re, Gg, Re, Re, Re, Rb, Re, Re, Gg^Eff, Gg, Re
Wo, Wo, Wo, Wo, Wo, Wo, Wo, Wo, Wo, Wo, Wo, Wo, Ww, Ww, Ww, Ds, Ww, Wwr, Ww, Wwr, Re^Vhr, Re, Gg, Re, Gg, Re, Re, Re, Gg, Gs^Edt, Re, Re, Gg^Fds, Gg^Fds, Gs^Edt, Re, Re, Re^Vhr, Chr^Dr, Chr, Gs, Gs, Gs, Gs, Gg^Vhr, Re, Re, Re^Edt, Re, Gg
Wo, Wo, Wo, Wo, Wo, Wo, Wo, Wo, Ww, Wo, Wwr, Wo, Ww, Wo, Ww, Ww, Wwr, Ww^Edt, Chr, Ww, Gg, Gg^Edt, Re, Gs^Ecf, Gg^Edt, Gg^Edt, Rb^Gvs, Gg, Rb^Gvs, Re^Dr, Gg, Gg^Fms, Gg, Re^Edt, Re, Re, Gg, Gg, Gs, Gs^Edt, Gg^Edt, Gg^Edt, Gs, Gs^Edt, Rb^Gvs, Gg, Gg, Re, Re, Re
Wo, Wo, Wo, Wo, Wo, Wo, Wo, Ch, Rr, Ww, Gg, Gg, Gg^Fms, Gg, Gg^Fms, Ww, Gg^Fms, Gg^Edt, Gg^Fms, Gg, Re, Re, Re^Gvs, Re^Gvs, Rb^Gvs, Re^Gvs, Re^Gvs, Rb^Gvs, Re^Gvs, Rb^Gvs, Rb^Gvs, Gg, Chr, Gs^Vh, Chr^Kov, Gs, Gs, Gg, Gg, Gs, Re^Gvs, Re^Gvs, Re^Gvs, Rb^Gvs, Rb^Gvs, Rb^Gvs, Rb^Gvs, Gg, Gg, Rb
Wo, Wo, Ww, Wo, Wo, Wo, Ww^Bw/, Re^Vhc, Rr, Gg, Gs, Gs, Gs, Gg^Fms, Gg^Fds, Gg^Fms, Gg^Fms, Gg^Fms, Gg^Fds, Re, Re^Gvs, Re^Gvs, Rb^Gvs, Rb^Gvs, Rb^Gvs, Rb^Gvs, Re^Gvs, Re^Gvs, Re^Gvs, Re^Gvs, Re^Gvs, Rb^Gvs, Gs^Eff, Chr, Chr, Chr, Gg, Gg, Re^Gvs, Re^Gvs, Re^Gvs, Re^Gvs, Rb^Gvs, Rb^Gvs, Re^Gvs, Re^Gvs, Rb^Gvs, Rb^Gvs, Rb^Gvs, Gg
Wo, Ww, Ww, Ww, Wo, Wo, Ww, Ww^Bw/, Gs, Rr, Gd, Gd, Ds, Gg^Fms, Gg^Fds, Gg, Gg^Fms, Gg^Fms, Gg^Fds, Gg, Gg, Rb^Gvs, Rb^Gvs, Rb^Gvs, Gg, Re^Gvs, Re^Gvs, Re^Gvs, Re^Gvs, Re^Gvs, Gg^Eff, Gs^Eff, Gg^Edt, Gs, Rb^Gvs, Gg, Gg, Gg, Re^Gvs, Re^Gvs, Re^Gvs, Re^Gvs, Re, Re^Gvs, Re^Gvs, Re^Gvs, Rb^Gvs, Rb^Gvs, Gg, Gg
Ww, Ww, Ww, Ww, Wo, Wo, Ww, Ww, Re, Gs, Gs, Dd^Esd, Ds, Ds, Gg, Gg^Fds, Gg, Gg^Fms, Gg, Gg^Fds, Gs^Fds, Gg, Gs^Fms, Gg, Gg, Gg, Gg, Rb^Gvs, Gg^Eff, Gg^Vwm, Gg, Gg, Rb^Gvs, Rb^Gvs, Rb^Gvs, Rb^Gvs, Rb^Gvs, Rb^Gvs, Re^Gvs, Re^Gvs, Re^Gvs, Re, Re, Re^Gvs, Re^Gvs, Re^Gvs, Rb^Eff, Rb^Eff, Re^Gvs, Rb^Gvs
