Hh, Hh, Hh, Hh, Hh, Gg, Gg, Gg, Hh, Hh, Gg^Efm, Gg, Gg^Efm, Gg, Rb, Rb, Gg^Eff, Gg^Eff, Rb^Gvs, Rb^Gvs, Rb^Gvs, Rb^Gvs, Re^Gvs, Re^Gvs, Re^Gvs, Re^Gvs, Re^Gvs, Re^Gvs, Re^Gvs, Re^Gvs, Re^Gvs, Gg, Re^Gvs, Gg
Gg, Hh, Gg, Hh, Hh, Gg, Gs^Fms, Hh, Hh, Hh, Hh, Gg, Gg, Rb, Rb, Gg, Gg, Gg^Eff, Gg^Eff, Rb^Gvs, Rb^Gvs, Rb^Gvs, Rb^Gvs, Rb^Gvs, Re^Es, Re^Gvs, Re^Gvs, Re^Gvs, Re^Gvs, Re^Gvs, Re^Gvs, Re^Gvs, Gs^Eff, Re^Gvs
Gg, Gg, Gg, Hh, Ww, Gs^Fms, Gs^Fds, Gs^Fms, Gs^Fms, Hh, Gg, Gg^Es, Gg, Gg, Gg, Re, Re, Gg^Eff, Gg^Eff, Rb^Gvs, Rb^Gvs, Rb^Gvs, Rb^Gvs, Rb^Gvs, Rb^Gvs, Re^Gvs, Re^Gvs, Re^Gvs, Re^Gvs, Re^Gvs, Gs^Eff, Gs^Eff, Re^Gvs, Gs^Eff
Hh, Gg, Gs, Gg^Qhh, Hh^Qhh, Ww, Ww^Ewl, Hh^Fds, Gg, Gs^Fms, Gg, Gs^Efm, Gs^Efm, Gs, Gs^Fms, Gg, Re, Re, Gg, Gg^Eff, Gs^Eff, Rb^Gvs, Rb^Gvs, Rb^Gvs, Gs, Re^Gvs, Gg, Re^Gvs, Gg^Eff, Gg^Eff, Re^Gvs, Re^Gvs, Re^Gvs, Re^Gvs
Gg^Qhh, Hh, Hh, Hh, Hh^Qhh, Ww^Ewl, Ww^Ewf, Ww, Gs^Fds, Gg, Gs^Fds, Gs, Gs^Efm, Gs^Efm, Gs, Gs^Fms, Gs^Fms, Re, Gs, Gs^Efm, Gs^Efm, Gs^Vh, Gg, Gs, Gg, Gg, Gg^Es, Gg, Gg, Gg, Re^Gvs, Rb^Es, Rb^Gvs, Re^Gvs
Gg^Qhh, Hh, Hh, Gs, Gs, Gs^Qhh, Gg^Qhh, Ww, Gg^Es, Gs^Fds, Gs^Fds, Gs^Fds, Gs^Efm, Gs^Efm, Gs^Fms, Gs^Fms, Gg, Re^Es, Re, Gg^Efm, Gs^Efm, Gs^Efm, Rb^Gvs, Rb^Gvs, Rb^Gvs, Rb^Gvs, Rb^Gvs, Gg, Gg, Gg, Gs^Efm, Re^Gvs, Rb^Gvs, Rb^Gvs
Gg^Qhh, Gg, Hh^Fds, Hh, Hh, Hh, Hh, Gg^Qhh, Gs^Fds, Gg, Gg, Gg, Gg, Gs, Gs, Gs, Gs^Fms, Gg, Rb, Gs, Rb^Gvs, Rb^Gvs, Rb^Gvs, Rb^Gvs, Rb^Gvs, Rb^Gvs, Rb^Gvs, Rb^Gvs, Re^Gvs, Rb^Gvs, Gs^Efm, Gs^Efm, Gs^Efm, Rb^Gvs
Hh^Fds, Hh^Fds, Hh^Fds, Hh, Hh, Hh, Hh, Gs^Qhh, Gs^Fds, Gs^Fds, Hh, Gg, Gs, Gs^Fds, Gs^Fds, Gs^Fms, Gs^Fds, Gg, Re, Rb^Gvs, Rb^Gvs, Rb^Gvs, Rb^Es, Rb^Gvs, Rb^Gvs, Re^Gvs, Re^Gvs, Re^Gvs, Re^Gvs, Re^Gvs, Re^Eff, Gs^Vh, Gs, Gs^Efm
Hh^Fds, Hh^Fds, Hh^Fds, Hh^Fds, Gs^Fms, Hh, Hh^Fds, Hh^Qhh, Gg^Qhh, Gs^Fds, Gs^Fds, Hh, Gs^Fds, Gs^Fds, Gs^Fds, Gs^Fds, Gg, Rb, Re, Re, Re, Rb^Gvs, Re, Re^Gvs, Rb, Rb^Gvs, Gg^Eff, Re^Gvs, Rb^Eff, Re^Eff, Rb^Gvs, Re^Gvs, Re^Gvs, Rb^Gvs
Gg^Qhh, Hh^Fds, Hh^Fds, Hh^Fds, Hh^Fds, Hh^Fds, Hh^Fds, Gs^Vl, Gs^Fms, Gg^Qhh, Gs^Qhhf, Gs^Fms, Gg, Gg^Es, Gs^Fds, Gs^Fds, Gg, Re, Gg, Gg^Es, Re^Gvs, Re, Re^Vh, Re, Gg, Rb, Rb, Rb^Eff, Re^Eff, Rb^Gvs, Rb^Gvs, Rb^Es, Re^Gvs, Re^Gvs
Hh^Fds, Hh^Fds, Hh^Fds, Hh^Fds, Hh^Fds, Hh^Fds, Hh^Fds, Hh^Fds, Gs^Fms, Gs^Fms, Gg^Qhh, Gs^Qhhf, Gg^Qhh, Gg^Qhh, Gs^Qhhf, Gg^Qhhf, Gg, Re, Rb^Gvs, Re^Gvs, Rb^Gvs, Re^Gvs, Re^Gvs, Gg, Gs, Rb, Gs, Rb, Gs, Re^Eff, Re^Gvs, Re^Gvs, Rb^Gvs, Re^Gvs
Hh, Hh, Hh, Hh^Fds, Hh^Fds, Hh^Fp, Hh^Fds, Gs^Fms, Gs^Fms, Gs^Fms, Gs^Fms, Gs^Fp, Gg^_mh, Gs^Fds, Gs^Qhhf, Gg, Rb, Rb, Rb^Gvs, Rb^Gvs, Re^Wm, Re^Gvs, Re^Gvs, Rb^Eff, Gg^Eff, Gs^Fmw, Gs^Fms, Gs^Fmw, Gs^Fms, Rb, Re, Re^Gvs, Rb, Rb^Gvs
Hh, Hh, Hh^Fds, Hh, Gs, Gs, Gs^Fds, Gs^Fms, Gs^Qhh, Gs^Qhh, Gg^Qhh, Gg^Qhh, Gg^Qhh, Gg^Qhhf, Gg, Gg^Es, Rb, Rb^Gvs, Re^Gvs, Re^Gvs, Re^Gvs, Re^Gvs, Gg^Eff, Gg^Eff, Gs, Gs^Fmw, Gs^Fds, Gs^Fds, Gs^Fds, Gs, Gg, Re^Es, Rb, Rb
Re^Gvs, Hh^Fds, Gs^Fms, Gs, Gg^Qhhf, Gs, Gs^Qhhf, Gs^Qhh, Gs^Fms, Gs^Fms, Gs^Fds, Gs^Fds, Gs^Fds, Gg, Gll, Re, Rb^Gvs, Gg, Gg, Re^Gvs, Gg, Gg^Eff, Gg^Fms, Gs, Gs^Fds, Gs^Fds, Gs^Fms, Gs, Hh, Gs^Fds, Gs^Fds, Gs^Vh, Rb^Gvs, Re^Gvs
Re^Gvs, Re^Gvs, Gs^Qhh, Gg^Qhhf, Re^Gvs, Gg^Qhh, Rb^Gvs, Re^Gvs, Rb^Gvs, Gs^Fp, Gs, Gs^Fds, Gs^Fms, Gll, Rb^Gvs, Rb^Gvs, Re^Gvs, Re^Gvs, Re^Gvs, Re, Re, Gg, Gs^Fds, Gs^Fds, Gs^Fp, Gs^Fds, Gs^Fms, Hh^Fmw, Hh, Gs^Fds, Gs^Fds, Gg, Gg, Gg
Re^Gvs, Re^Gvs, Re^Gvs, Re^Gvs, Re^Gvs, Re^Gvs, Rb^Gvs, Rb^Gvs, Rb^Gvs, Gs, Gs, Gs, Re, Gll, Rb^Gvs, Rb^Gvs, Re^Gvs, Re^Gvs, Gg, Gg, Re, Re, Rb, Re^Ecf, Re, Re^Vct, Ce, Gs^Fmw, Hh^Fmw, Hh, Hh, Gs^Fds, Gg, Gg
Re^Gvs, Re^Gvs, Rb^Gvs, Re^Gvs, Rb^Gvs, Rb^Gvs, Rb^Gvs, Rb^Gvs, Gg^Vh, Gg^Efm, Gg^Efm, Re, Gs, Rb^Gvs, Rb^Gvs, Rb^Gvs, Re^Gvs, Re^Gvs, Gs^Fms, Gs^Fds, Gs^Fds, Gg, Gs^Fms, Rb, Gs^Fp, Re, 3 Ke, Ce, Hh^Fds, Hh^Fds, Hh, Gg, Gs^Fds, Gg
Hh^Fds, Re^Gvs, Hh, Rb^Gvs, Hh, Rb^Gvs, Rb^Gvs, Rb^Gvs, Re, Re, Gg, Re, Ch, Re^Gvs, Re^Gvs, Rb^Gvs, Gg^Eff, Gg^Eff, Gs^Fms, Gs^Fds, Gs^Fms, Gg^Efm, Gs^Fms, Gs^Fds, Gs^Fms, Ce, Gs, Gs^Fds, Gs^Qhhf, Hh, Hh, Gs^Fds, Gs^Fds, Gg
Hh^Fds, Hh^Fds, Hh^Qhh, Hh^Qhh, Hh^Qhh, Hh^Qhh, Gs, Gs, Gs, Re, Re^Es, Re, Gg^Ebn, Gg^Eff, Gs^Eff, Gs^Eff, Re^Vct, Gs^Fms, Gs^Fds, Gs^Fds, Gg^Efm, Gg^Efm, Gs^Fp, Gs^Fds, Gs^Fms, Gs^Fms, Hh^Qhhf, Hh^Qhhf, Mm^Qhh, Hh^Qhh, Hh^Qhh, Hh, Hh, Gg
Hh^Qhh, Hh^Qhh, Wo, Wo, Wo, Gg^Efm, Wo, Ww, Ch, Ch, Ch, Re, Re, Re, Re, Re, Ch, Ch, Ww, Ww, Ww, Gs^Fds, Hh^Qhhf, Hh^Qhhf, Hh^Qhhf, Hh^Qhh, Hh^Qhh, Hh^Qhh, Mm^Qhh, Mm^Qhh, Mm^Qhh, Hh^Qhh, Hh^Qhh, Hh
Hh^Qhh, Wo, Wo, Wo, Wo, Wo, Ww, Wo, Wwf, 2 Kh, Wwf, Ww, Ww, Re^Vct, Re, Gs^Efm, Ww, Ww, Wo, Wo, Wo, Ww, Gg, Hh^Qhh, Hh^Qhhf, Hh^Qhh, Hh^Qhh, Mm^Qhh, Hh^Qhh, Mm^Qhh, Mm^Qhh, Mm^Qhh, Hh^Qhh, Hh
Wo, Wo, Ww, Wo, Ww, Ww, Ww, Ww, Ww, Wwf, Wwf, Ww, Ww^Ewf, Ww^Ewf, Ch, Gs, Ww, Wo, Ww, Ww, Ww, Ww, Ww, Gs^Fmw, Wo, Wo, Wo, Hh^Qhh, Hh, Hh^Qhh, Hh^Qhh, Hh^Qhh, Hh^Qhh, Hh^Qhh
