Gg^Qhh, Ha^Qhh, Ha^Qhh, Ha^Qhh, Ms^Qhh, Mm^Qhh, Ms^Qhh, Ha^Qhh, Ha^Qhh, Ha^Qhh, Ha^Qhh, Hh^Qhh, Hh, Hh, Hh, Gg^Qhh, Mm^Qhh, Mm^Qhh, Mm^Qhh, Mm^Qhh, Mm^Qhh, Mm^Qhh, Mm^Qhh, Hh, Aa, Aa, Ha, Ha^Qhh, Ha^Qhh, Ha^Qhh, Mm^Qhh, Gg^Qhh, Mm^Qhh, Mm^Qhh, Hh^Qhh, Mm^Qhh, Mm^Qhh, Mm^Qhh, Mm^Qhh
Ha^Qhh, Ha, Ha, Ha, Ms, Ms^Qhh, Ms, Ms^Qhh, Ha^Qhh, Ha^Qhh, Gs, Gg^Qhh, Gg^Efm, Gg^Efm, Gg^Efm, Hh, Hh^Qhh, Mm, Mm^_mh, Mm^Xm, Mm^Xm, Mm^Xm, Mm^Xm, Hh^Qhh, Hh^Qhh, Aa, Aa, Ha, Ha^Qhh, Aa, Hh, Mm^Xm, Mm, Mm^Xm, Mm, Mm, Gg, Hh, Mm^Qhh
Hh^Qhh, Hh, Mm, Ms, Ms^Xm, Ms, Ms, Ha^Qhh, Ha^Qhh, Gg^Efm, Gs^Efm, Hh^Qhh, Hh^Qhh, Gg^Efm, Gg^Efm, Gg^Efm, Gg, Hh^Qhh, Hh^Qhh, Mm, Mm^Xm, Mm^Xm, Mm, Mm, Hh^Qhh, Gs, Aa, Ha, Ha, Hh^Qhh, Hh^Qhh, Mm, Mm, Mm, Hh, Mm, Hh, Mm^Xm, Mm^Qhh
Hh^Qhh, Hh, Mm, Ms, Ms, Ms, Hh, Ha^Qhh, Hh^Qhh, Gg, Gs^Efm, Gg, Hh, Hh^Qhh, Hh^Qhh, Gg, Gs, Hh, Hh, Hh^Qhh, Mm^Qhh, Mm^Xm, Mm^Xm, Mm, Hh^Fdw, Hh^Qhh, Gg, Hh, Hh, Hh, Hh^Qhh, Mm, Mm, Hh, Mm, Hh, Mm, Mm, Mm^Qhh
Mm^Qhh, Mm, Mm^Xm, Ms^Xm, Mm, Mm, Mm, Hh^Qhh, Hh, Hh, Gg, Gs, Hh, Mm, Hh^Qhh, Gs, Gs, Gs, Gs, Hh, Hh, Mm^Qhh, Mm^Xm, Mm^Xm, Hh^Qhhf, Hh^Qhh, Gg, Gs, Gs, Hh, Hh^Qhh, Hh, Hh, Mm, Hh, Mm, Hh^_mh, Hh, Hh^Qhh
Mm^Qhh, Mm^Xm, Mm^Xm, Mm, Mm, Mm, Mm, Hh^Qhh, Hh, Gs, Gg, Hh, Gs, Mm, Hh^Qhh, Hh, Hh, Gs, Gs, Gs, Hh, Hh^Qhh, Mm^Qhh, Mm, Hh^Qhhf, Gll^Fdw, Gll^Fdw, Gs, Gs, Hh, Hh, Hh^Qhh, Mm, Hh, Hh, Hh, Mm, Hh, Mm^Qhh
Ms^Qhh, Mm^Xm, Mm, Mm, Mm, Mm, Hh^Qhhf, Hh^Qhh, Gg, Gs, Gs, Hh, Hh, Mm, Mm, Hh^Qhh, Hh^Qhh, Gg^Vl, Gll^Fdw, Gs, Gg, Hh, Hh, Mm^Qhh, Hh, Gll^Fdw, Gg, Gs, Gs^Efm, Gg, Hh^Fdw, Hh^Qhh, Hh, Hh, Mm, Mm, Mm^Xm, Mm, Mm^Qhh
Ms^Qhh, Ms, Mm, Hh, Hh, Hh^Qhhf, Hh^Fdw, Hh, Gg^Efm, Gs, Hh, Hh, Mm, Mm, Mm, Mm, Hh^Qhhf, Hh^Fdw, Gll^Fdw, Gs^Efm, Gs^Efm, Gs, Gs, Hh, Hh, Hh, Gg, Gs^Efm, Gs^Efm, Gs, Hh^Fdw, Hh^Qhhf, Hh, Mm, Mm^Xm, Mm^Xm, Mm^Xm, Mm^Xm, Mm^Qhh
Ms^Qhh, Ms, Mm^Xm, Mm, Mm, Hh^Qhhf, Hh^Fdw, Gg^Vl, Gg^Efm, Hh, Hh, Mm, Mm, Mm, Mm, Mm, Mm, Hh^Qhhf, Gs^Qhhf, Gs^Efm, Gs, Gg^Efm, Gs^Efm, Gg, Gg^Efm, Hh, Gg^Vl, Gg, Gs, Gg^Efm, Hh, Hh^Qhhf, Hh, Mm, Mm, Mm, Ms^Xm, Ms^Xm, Ms^Qhh
Ms^Qhh, Ms^Xm, Ms^Xm, Mm, Mm, Hh^Qhhf, Hh, Gg, Hh, Hh, Mm, Mm, Mm, Hh, Hh, Mm, Mm, Mm, Hh^Qhhf, Gs, Gg, Gs, Gg, Gg^Efm, Gs, Gg, Gg, Gg, Gg, Gg, Hh^Qhh, Hh^Qhh, Ha, Ha, Ms, Ms, Ms, Ms, Mm^Qhh
Ms^Qhh, Ms^Xm, Mm, Mm, Mm, Hh^Qhhf, Hh, Hh, Hh, Hh, Mm, Mm, Hh, Hh, Hh, Hh, Ms, Ms, Ha^Qhh, Ha, Ha^Qhh, Ss, Ss, Gs, Hh, Gs, Gg, Gll^Fdw, Hh, Hh^Qhh, Mm, Ha, Hh, Ha, Ms, Ms, Ms, Ha, Ha^Qhh
Ms^Qhh, Ms, Ms, Mm, Hh^_mhh, Hh^Qhh, Hh, Hh, Hh, Mm, Mm, Hh, Hh, Mm, Hh, Hh, Hh, Ms, Ms, Ha^Qhh, Mm, Hh^Qhh, Hh^Qhh, Hh, Hh, Gd, Gs, Gll^Fdw, Hh^Qhhf, Hh^Qhh, Ms, Mm, Ha^Fda, Ha, Ms, Ms, Hh, Hh^Fdw, Hh^Fdw
Ms^Qhh, Ms, Ha^Fda, Hh, Hh^Qhhf, Hh^Qhh, Ss, Ss, Mm, Hh, Hh, Hh, Mm^Cov, 3 Mm^Kov, Mm^Cov, Ai, Ai, Mm, Mm, Mm, Mm, Mm^_mh, Hh^Qhh, Hh, Gs, Gg, Gs, Hh, Hh^Qhhf, Ms, Ms, Ms, Ha^Fda, Ha^Fda, Ms, Ha, Ha, Ha, Ha^Qhh
Ha^Qhh, Ha^Fda, Ha^Fda, Ha^Fda, Hh^Qhhf, Ss, Ss, Hh, Mm, Mm, Ms, Hh, Ms, Mm^Cov, Ms, Ai, Hh, Mm, Mm, Mm, Mm, Hh^Vhh, Hh^Qhh, Gs, Gs, Gs, Gll^Fdw, Gll^Fdw, Ha^Qhhf, Ms, Ms, Ms, Hh, Ha^Fda, Hh, Ms, Ms, Ha, Ha^Qhh
Ha^Qhh, Ha, Gs, Gg, Hh^Fdw, Hh^Qhh, Hh^Qhh, Mm, Mm, Hh, Ms, Ms, Ha, Ha, Ms, Ha, Ha, Mm, Mm, Mm, Hh^Qhh, Hh^Qhh, Gs, Gs, Gg, Gs, Gs, Gll^Fdw, Gll^Vl, Ha^Qhhf, Mm, Mm, Hh, Mm, Mm, Mm^Xm, Mm, Ms^Xm, Ms^Qhh
Ha^Qhh, Gs, Gg, Hh, Hh, Mm, Mm^Qhh, Mm, Mm, Ha, Ms, Ms, Ha, Ha, Ha, Ha, Mm, Mm, Hh, Hh, Hh^Qhh, Hh, Gs, Gs, Gg, Gll^Fdw, Gll, Gll^Fdw, Gll, Hh^Qhhf, Hh^Qhh, Mm, Hh, Hh^Fdw, Hh^Fdw, Mm, Mm^Xm, Ms^Xm, Ms^Qhh
Gs^Qhh, Gs, Hh, Hh, Mm, Hh, Hh, Mm^Qhh, Ha, Ha^Vhha, Ha, Ms, Ha, Ha, Ha, Mm, Mm, Mm, Hh^Fdw, Hh, Mm, Hh^Qhh, Gs, Gs, Gs, Gs, Gs, Gs, Gll^Fdw, Gll^Fdw, Hh, Hh^Qhh, Hh^Qhh, Hh, Hh^Qhhf, Mm, Hh, Hh, Gg^Qhh
Hh^Qhh, Hh, Hh, Hh, Hh, Hh, Hh, Hh^Qhh, Hh^Qhh, Hh, Hh, Mm, Mm, Hh, Ha, Ms, Mm, Hh^Fdw, Hh^Qhhf, Mm, Mm, Hh^Qhh, Hh, Gs, Gg, Gs, Gg^Efm, Gs, Gg, Gs, Gs, Hh, Hh^Vhh, Hh^Qhh, Hh^Fdw, Hh^Qhhf, Hh^Qhhf, Hh^Qhh, Hh^Qhh
Hh^Fdw, Hh^Fdw, Hh^Fdw, Hh, Hh, Ss, Hh, Hh, Hh^Qhh, Hh, Hh, Mm, Mm, Mm, Mm, Ms, Mm, Hh^Qhh, Gg^Vh, Hh^Qhh, Hh^Qhh, Hh^Qhh, Gg^Vwm, Gg, Gs, Gg, Gs, Gg^Efm, Gg^Efm, Gg^Efm, Gg^Efm, Gg, Gg, Gg, Hh, Hh, Hh, Hh^Fdw, Gg
Hh^Qhh, Hh^Fdw, Mm, Hh, Mm, Hh, Mm, Hh^Qhh, Hh, Gs, Gll^Fdw, Hh, Mm, Mm, Mm, Mm, Hh^Qhh, Hh^Qhh, Gs, Gg, Gs, Hh^Qhh, Hh, Gs, Aa, Gs, Gs, Gs^Efm, Gs, Gs^Efm, Gs^Efm, Gg^Efm, Gs^Efm, Gg, Gg, Gs, Gs, Gg, Gg
Hh^Qhh, Mm, Mm^Xm, Mm, Mm^Xm, Mm, Mm, Hh^Qhh, Hh, Gs, Hh^Fdw, Hh^Fdw, Hh, Mm, Mm, Hh^Qhh, Hh, Gg, Gs^Efm, Gs, Gs, Aa, Aa, Aa, Gs, Aa, Aa, Gs, Gs, Gs^Efm, Gs, Gs^Efm, Gg, Gs, Gs, Gs, Gs^Efm, Gg^Efm, Gg^Efm
Hh^Qhh, Hh, Mm, Mm^Xm, Mm, Hh, Mm^Qhh, Hh^Qhh, Hh^Fdw, Hh^Fdw, Hh^Fdw, Gs, Hh^Vhh, Mm, Hh^Qhhf, Hh^Qhh, Gg, Gs, Gs^Efm, Gs, Hh, Hh, Aa^Vha, Aa, Hh, Gs, Gs, Gs, Gs, Gs, Gs, Gg, Hh, Hh, Hh, Gg, Gg, Gs^Efm, Gg^Efm
Mm^Qhh, Mm, Mm, Mm, Hh, Mm, Hh^Qhh, Hh^Fdw, Hh^Fdw, Mm, Hh^Fdw, Gg, Gg, Hh^Qhh, Hh, Hh, Gs^Efm, Gs^Efm, Gs, Gg, Hh, Hh, Hh, Hh, Hh, Hh, Hh, Gs, Gs, Gs, Hh, Hh, Hh, Hh, Hh, Hh, Hh, Gg, Gg
Mm^Qhh, Mm^Qhh, Mm^Qhh, Mm^Qhh, Mm^Qhh, Mm^Qhh, Hh^Qhh, Hh^Qhhf, Mm^Qhh, Mm^Qhh, Hh^Qhh, Hh^Qhh, Gg^Qhh, Hh^Qhh, Hh, Gg, Gs, Gs, Gg, Hh, Hh, Gg, Hh, Hh, Hh, Hh, Hh, Hh, Gs, Aa, Hh, Hh, Hh, Hh, Hh, Hh, Hh, Gg, Gg
