Re, Gs, Re, Re, Rb, Re, Rb, Aa, Aa, Aa, Ha, Ha, Ha, Hh, Hh, Gs, Hh^Qhh, Gs^Qhh, Hh^Qhh, Hh^Qhh, Mm^Qhh, Mm^Qhh, Mm^Xm, Mm, Mm^Xm, Hh, Ha, Hh, Ms, Ms, Ms, Hh^Qhh, Ha^Qhhf, Gs^Qhh, Gs, Gs^Fp, Gg^Fp, Gg^Efm, Aa, Gg^Efm, Aa
Gs, Re, Re, Re, Re, Rb, Rb, Aa, Aa, Aa, Aa, Ha, Ha, Hh, Gs, Gs, Gs, Hh^Qhh, Gs^Edt, Chr^Edt, Chr, 3 Khr, Mm, Mm^Xm, Chr^Edt, Ha, Ha^Edt, Ms, Ms, Ms, Ha^Qhhf, Ha^Fma, Ha^Qhhf, Ha^Qhh, Gg, Gs^Fp, Aa, Aa, Aa, Aa, Aa
Gs, Gs, Re, Re, Re, Re, Re, Rb, Rb, Aa, Aa, Aa, Ha, Hh, Hh, Gs, Gs, Hh^Qhh, Hh^Qhh, Gs^_mh, Chr^Edt, Chr, Hh^Qhhf, Mm, Mm, Mm, Hh^Edt, Ms, Ha^Qhh, Ha^Qhhf, Gs, Ha^Qhh, Gs^Efm, Gg, Gg^Efm, Gg^Efm, Aa, Aa, Aa, Aa^Fma, Aa^Fma
Ww, Gs, Gs, Re, Re, Re, Re, Re, Rb, Rb, Aa, Aa, Aa, Aa, Hh, Gs^Edt, Gs, Gs, Gs, Hh^Qhh, Hh^Qhh, Hh^Qhhf, Gs^Fdf, Hh^Qhhf, Hh^Qhh, Hh^Qhh, Hh^Qhh, Hh^Qhh, Gs, Gs, Gg, Gg^Efm, Gg, Gg^Efm, Aa, Aa, Aa, Aa, Aa, Aa^Fpa, Aa^Fma
Ww, Ww, Gs^Vh, Re, Re, Re, Re, Re, Rb, Rb, Rb, Aa, Gg, Aa, Aa, Aa, Gs, Gs, Gs, Hh^Edt, Gs, Hh^Edt, Gs^Vhr, Gs, Gs, Hh, Hh, Gg, Gg^Efm, Gg, Gs, Gg, Hh, Gs, Gs, Aa, Ha^Fpa, Gs, Ha, Aa, Gs
Gg, Ww, Ww, Gs, Re, Re, Rb, Rb, Rb, Rb, Re, Re, Gg, Gs, Gg, Aa, Gs, Gs, Re^Eff, Gs^Edt, Re, Re, Re, Re, Re, Gs, Aa, Gs, Gg^Efm, Gg^Efm, Gg, Gs, Hh, Hh, Mm^Qhh, Hh^Qhh, Ha^Qhh, Ha^Fpa, Ha^Fpa, Ha^Fpa, Ha^Fpa
Gg, Ww, Ww, Ww, Re, Rb, Rb, Rb, Re^Eff, Re, Gg, Gs, Gg, Gs, Gg, Gs, Re^Eff, Re^Eff, Re, Rb^Eff, Rb, Rb, Re, Re, Re, Aa, Aa, Aa, Aa, Gg^Efm, Gg^Efm, Gs, Gs, Hh^Fp, Hh^Fp, Mm^Qhh, Ha^_mhh, Ms^Qhh, Ms^Qhh, Ha^Fma, Ha^Fma
Gg, Gg, Ww, Ww, Gg, Gg^Eff, Gg^Eff, Re^Eff, Gg, Gg, Gg, Gg, Gg, Gg, Gg, Gs, Re^Vh, Re, Re, Rb, Rb, Re, Rb, Re, Re, Re, Aa, Aa, Aa, Gs, Gg, Gg^Efm, Gs^Efm, Hh^Fp, Hh^Fp, Mm^Qhh, Mm, Ms, Ms, Ha^Qhh, Ms^Qhh
Gs, Gg, Ww, Ww, Gg, Gg, Gg, Gs, Gs, Gg, Ch, Gg, Ch, Rp, Rp^Ebn, Rp, Gg, Re, Re, Rb, Re, Re, Rb, Rb, Rb, Re, Re, Hh, Hh, Hh^Fp, Hh^Fp, Gg, Gg^Fp, Gs, Hh, Hh^Qhh, Chr^Qhh, Ms, Ms^Xm, Ms, Ms^Qhh
Gs, Gg, Gg, Ww, Ww, Gg, Gg, Gs, Gs, Gg, Rp, Ch^Vhc, Isa, Isa, Rp, Rp, Cha, Aa, Aa, Re, Re, Re, Re, Rb, Rb, Rb, Re, Hh, Hh, Hh, Mm, Hh^Fmf, Gs, Gg, Gd^Edt, Hhd^Edt, Ha^Qhh, Ms, Cha^Edt, Ms^Qhh, Ms^Qhh
Gs, Gg, Gg, Ww, Ww, Ww, Ww, Gg, Ww, Rp, Rp, Isa, Ch, Ch, Ch, Isa, Cha^Vhca, Aa, Aa, Re, Re, Re, Aa, Rb, Aa, Rb, Rb, Gs^Vh, Hh, Mm, Mm, Hh^Fmf, Hh^Fmf, Gs, Gd, Gd, Hhd, Ms^Qhh, 4 Khr^Qhh, Ms, Ms^Qhh
Gs, Gs, Gs, Gg, Gs, Gg, Gg, Ww, Ww, Ww, Ww, Ww, Ch, Qxua^Xo, 2 Kh, Isa, Isa, Cha, Aa, Aa, Gg, Re, Re, Aa, Aa, Aa, Rb, Rb, Gs, Hh, Mm, Hh, Hh^Fp, Gs^Edt, Gs, Gd^Edt, Gd^Edt, Chr^Edt, Gd, Cha^Qhh, Chr^Qhh
Gs, Gs, Gs, Gs^Efm, Gs^Efm, Gg, Gg, Ww, Ww, Hh, Hh, Ww, Ww, Ch, Isa, Isa, Ch, Isa, Rp, Rp, Gs^Vh, Aa, Aa, Aa, Rb, Aa, Aa, Rb, Rb, Hh^Vhh, Hh^Qhh, Mm, Hh^Edt, Hh^Edt, Hh, Gd^Edt, Hhd, Gd, Gd, Chr^Qhh, Hhd^Qhh
Hh, Gs, Hh, Gs, Gs, Gs^Efm, Gg^Efm, Gg, Gg^Vwm, Ww, Gg, Gg, Ww, Rp, Ch^Vhc, Isa, Rp, Rp^Ebn, Rp^Vhc, Rp, Gs, Gs^Eff, Aa^Eff, Aa, Aa, Aa, Aa, Rb, Rb, Gs, Hh^Qhh, Mm, Mm, Hh^Vhr, Hh, Chr, Gs^Edt, Hhd, Hhd, Hhd, Hhd^Edt
Gs, Hh, Hh, Hh, Gs, Gs^Efm, Gs^Efm, Gg, Gg, Ww, Hh, Hh, Ww, Ch, Ww, Ch, Rp, Gg, Gg, Ch, Ch, Gg, Gg, Aa^Eff, Aa^Eff, Aa, Aa, Aa, Gs^Eff, Gs, Gg, Hh^Qhh, Mm, Hh^Fmf, Hh^Fmf, Hh, Ms, Mm, Mm, Hh, Chr
Hh, Hh, Hh, Hh, Gs, Gs^Efm, Gs, Gg, Gg, Ww, Gg, Hh, Gg, Ww, Gg, Ww, Ww, Gg, Gg, Gs, Gg, Gs, Gg, Gg, Gg, Rb^Eff, Gs^Vwm, Gs^Eff, Gs, Gs, Gg, Hh^Qhh, Mm, Mm, Hh^Fmf, Hh, Ms, Ms, Mm^Xm, Mm, Mm
Hh, Gs, Gs, Gs, Gs, Gs, Gs, Gs^Vh, Gs, Ww, Ww, Gg, Hh, Gg, Gs, Gg, Ww, Gs, Gs, Gs, Gs, Gg, Gg^Efm, Gg, Gs, Gd, Gd, Gs, Gs, Gg, Hh, Hh^Qhh, Mm, Ms, Ha, Ha, Ha, Ms, Ms, Mm^Xm, Ms^Xm
Aa, Aa, Gs, Gs, Gs, Gs, Gs, Gs, Gs, Ww, Ww, Gg, Gg, Hh^Vhh, Gs, Gs, Hh, Ww, Ww, Gs, Gs, Gg^Efm, Gg^Efm, Gg^Efm, Gs^Efm, Gd, Gs^Efm, Gs, Gs^Efm, Gg, Gg, Hh^Qhh, Hh^Qhh, Hh, Ha, Ha, Hh, Ha, Hh^Fmf, Ms, Ms
Ha, Ha, Ha, Ha, Ha, Hh, Gg, Gg, Aa, Gs, Gs, Ww^Qhu, Ww, Gg, Gg, Gs, Hh, Hh, Hh, Ww, Gs, Gg, Gs, Gs, Gs, Gs^Efm, Gs^Efm, Gs^Efm, Gs^Efm, Gg^Efm, Gg, Gs, Gs, Hh^Qhh, Hh^Qhh, Hh, Hh, Hh, Hh^Fmf, Ms, Mm
Ha, Ha, Ha, Ha, Ha, Hh, Aa, Aa, Aa, Gs^Efm, Gs^Vh, Ww^Qhu, Ww^Qhu, Gs, Gg, Gs, Gs, Gs, Hh, Ww, Wwf, Gs, Gs, Gs, Gs, Gs, Gd^Efm, Gs^Efm, Gs^Efm, Gs^Efm, Gs^Efm, Gs, Hh, Gs, Hh^Qhh, Chr, Mm, Mm, Mm, Hh^Fp, Gs^Fp
Ms, Ms, Ms, Ms, Ms, Hh, Ha^Fpa, Aa, Aa, Aa, Gg^Edt, Gg, Gs, Ww^Qhu, Gs, Gs^Efm, Gd^Efm, Gs, Hh, Hh, Aa, Wwf, Wwf, Gs, Ww, Gs, Gd, Gd, Gd^Efm, Gd^Efm, Gd^Efm, Hh, Gs, Hh^Qhh, Hh^_mh, Mm, Mm, Mm, Mm, Hh^Fmf, Hh
Mm^Xm, Ms, Ms, Ms, Ms^Xm, Ms, Ha^Fpa, Aa^Fpa, Gs, Aa, Gg, Gg^Efm, Gs, Ww^Qhu, Ww^Qhu, Gd, Gd, Gd^Efm, Gs, Hh, Aa, Aa, Ha, Ww, Ww^Edt, Ww, Gs^Vc, Gd, Gd, Gd^Efm, Gd^Efm, Gd^Efm, Gd, Hh^Qhh, Hh^Qhh, Mm, Mm, Mm, Mm, Hh, Hh^Esd
Mm^Xm, Mm^Xm, Mm, Ms, Ms, Ms, Ms, Ha, Hh, Gg, Gg, Gs^Edt, Hh, Gs, Hh, Wwf^Qhu, Wwf^Qhu, Gd, Hh, Gs, Hh, Aa, Ha, Gs, Gs, Ww, Ww, Gs, Gd, Gd^Efm, Gd, Gd^Efm, Gd, Gs, Chr^Qhh, Chr, Mm, Mm, Ms, Ha, Ha
Mm, Mm, Mm, Ms, Ms, Mm^Edt, Chr, Mm, Mm, Hh^Edt, Hh, Hh, Mm, Hh, Hh, Hh, Wwf^Qhu, Gs, Hh, Hh^Fmw, Ha^Fma, Ha, Ha, Ha, Gs, Gd, Ww, Ww^Edt, Gd, Gd^Efm, Gs^Efm, Gs, Ha^Qhh, Gd^Edt, Hhd^Qhh, Khr, 5 Kha, Ms^Xm, Ms^Xm, Ha, Ha
Hh, Hh, Hh, Chr^Edt, Hh, Chr^Edt, 7 Khr, Chr^Edt, Mm, Mm, Mm, Mm, Mm, Mm, Hh, Wwf^Qhu, Hh^_ml, Hh, Hh^Fmw, Hh^Fmw, Mm, Mm, Mm, Ha, Gs^Edt, Gd, Gd, Ww, Gd, Gd, Gd, Ha^Qhh, Ha^_mh, Hhd^Qhh, Hhd, Chr, Cha^Edt, Ms^Xm, Ms, Ms, Ha
Mm, Mm, Mm, Mm, Mm, Mm, Mm, Chr^Edt, Mm, Mm, Hh, Mm, Hh, Hh, Wwf^Qhu, Wwf^Qhu, Hh, Hh, Mm, Mm, Mm, Mm, Mm, Chr^Edt, Hh, Gs, Gd, Wwf, Gs, Gs, Gd^Edt, Ha^Qhh, Ms, Ms, Ms, Hhd, Ha, Ms, Ms, Ms, Ms
Hh, Hh, Hh, Hh, Chr^Edt, Mm, Mm^Edt, Mm^Edt, Hh^Edt, Hh^Edt, Gs, Hh, Ha, Wwf^Qhu, Wwf^Qhu, Hh, Mm, Mm, Mm, Mm, Mm, Mm, Chr, 6 Chr^Kov, Chr, Hh, Gs^Edt, Wwf, Gs, Gd^Edt, Chr^Qhh, Cha^Qhh, Ms, Ms, Ms, Ha, Ha^Edt, Ms, Ms, Ms^Xm, Ms
Mm, Mm, Mm, Mm, Mm, Mm, Hh^Fmf, Hh^Fmf, Aa, Aa, Hh, Hh, Ms, Ha, Hh, Wwf^Qhu, Mm, Mm^Xm, Mm, Mm, Hh^Fp, Hh^Fmw, Mm, Mm, Mm, Gs^Edt, Wwf, Wwf, Hh^Qhh, Hh^Qhh, Hh, Cha, Ms, Ms, Ms, Chr^Edt, Ha, Ms, Ms^Xm, Ms, Ms
Hh, Hh, Hh, Hh, Hh, Hh^Fp, Gs, Gs^Fp, Aa, Aa, Ha, Ms, Ms^Xm, Mm, Wwf^Qhu, Wwf^Qhu, Mm, Mm, Mm, Mm, Mm^Xm, Mm^Xm, Mm^Xm, Mm, Mm, Hh, Wwf, Hh^Qhh, Hh^Qhh, Hh, Ms, Ms, Ms^Xm, Ms^Xm, Ms, Ms, Ha, Ms, Ms^Xm, Ms^Xm, Ms^Xm
Gs, Gs, Gs, Gs, Gs, Hh, Gs, Aa, Gs, Ha, Ha, Ms, Ms^Xm, Mm^Xm, Wwf^Qhu, Hh, Hh, Mm, Mm^Xm, Mm^Xm, Mm, Mm^Xm, Mm, Mm, Hh, Hh, Gs, Wwf, Hh^Qhh, Mm, Ms, Ms^Xm, Mm^Xm, Ms^Xm, Mm^Xm, Ms, Hhd, Ms, Mm, Ms^Xm, Mm^Xm
