Re^Gvs, Gs, Re, Re, Rb^Gvs, Re, Rb^Gvs, Re^Gvs, Gs, Gs, Hh, Hh, Hh, Hh, Hh, Gs, Hh^Qhh, Gs^Qhh, Hh^Qhh, Hh^Qhh, Mm^Qhh, Mm^Qhh, Mm^Xm, Mm, Mm^Xm, Hh, Hh, Hh, Mm, Hh, Mm, Hh^Qhh, Gs^Qhhf, Gs^Qhh, Gs, Gs^Fp, Gg^Fp, Gg^Efm, Gg, Gg^Efm, Gg^Efm
Gs, Re^Gvs, Re^Gvs, Re^Gvs, Re^Gvs, Rb^Gvs, Rb^Gvs, Rb^Gvs, Re^Gvs, Gs, Gs, Hh, Hh, Hh, Gs, Gs, Gs, Hh^Qhh, Gs^Edt, Chr^Edt, Chr, 3 Khr, Mm, Mm^Xm, Chr^Edt, Hh, Hh^Edt, Mm, Mm, Mm, Hh^Qhhf, Hh^Fp, Hh^Qhhf, Hh^Qhh, Gg, Gs^Fp, Gg^Efm, Gg^Efm, Gg^Efm, Gg^Efm, Gs
Gs, Gs, Re^Gvs, Re^Gvs, Re^Gvs, Re^Gvs, Re^Gvs, Rb^Gvs, Rb^Gvs, Re, Re, Gs, Hh, Hh, Hh, Gs, Gs, Hh^Qhh, Hh^Qhh, Gs^_mh, Chr^Edt, Chr, Hh^Qhhf, Mm, Mm, Mm, Hh^Edt, Mm, Hh^Qhh, Hh^Qhhf, Gs, Hh^Qhh, Gs^Efm, Gg, Gg^Efm, Gg^Efm, Gg^Efm, Gg^Efm, Gg, Gg^Fp, Gg^Fp
Ww, Gs, Gs, Re^Gvs, Re^Gvs, Re^Gvs, Re^Gvs, Re^Gvs, Rb^Gvs, Rb^Gvs, Re^Gvs, Re, Gs, Gs, Hh, Gs^Edt, Gs, Gs, Gs, Hh^Qhh, Hh^Qhh, Hh^Qhhf, Gs^Fds, Hh^Qhhf, Hh^Qhh, Hh^Qhh, Hh^Qhh, Hh^Qhh, Gs, Gs, Gg, Gg^Efm, Gg, Gg^Efm, Gg, Gg, Gg, Gg^Efm, Gs, Gs^Fp, Gs^Fp
Ww, Ww, Gs^Vh, Re^Gvs, Re^Gvs, Re^Gvs, Re^Gvs, Re^Gvs, Rb^Gvs, Rb^Gvs, Rb^Gvs, Gs, Gg, Gs, Gs, Gs, Gs, Gs, Gs, Hh^Edt, Gs, Hh^Edt, Gs^Vhr, Gs, Gs, Hh, Hh, Gg, Gg^Efm, Gg, Gs, Gg, Hh, Gs, Gs, Gs, Hh^Fp, Gs, Hh, Gs, Gs
Gg, Ww, Ww, Gs, Re^Gvs, Re^Gvs, Rb^Gvs, Rb^Gvs, Rb^Gvs, Rb^Gvs, Re^Gvs, Re, Gg, Gs, Gg, Gg, Gs, Gs, Re^Eff, Gs^Edt, Re^Gvs, Re, Re^Gvs, Re, Re, Gs, Gs, Gs, Gg^Efm, Gg^Efm, Gg, Gs, Hh, Hh, Mm^Qhh, Hh^Qhh, Hh^Qhh, Hh^Fp, Hh^Fp, Hh^Fp, Gs^Fp
Gg, Ww, Ww, Ww, Re^Gvs, Rb^Gvs, Rb^Gvs, Rb^Gvs, Re^Eff, Re^Gvs, Gg, Gs, Gg, Gs, Gg, Gs, Re^Eff, Re^Eff, Re^Gvs, Rb^Eff, Rb^Gvs, Rb^Gvs, Re^Gvs, Re^Gvs, Re^Gvs, Re, Gs, Gg, Gs, Gg^Efm, Gg^Efm, Gs, Gs, Hh^Fp, Hh^Fp, Mm^Qhh, Hh^_mhh, Mm^Qhh, Mm^Qhh, Hh^Fds, Hh^Fds
Gg, Gg, Ww, Ww, Gg, Gg^Eff, Gg^Eff, Re^Eff, Gg, Gg, Gg, Gg, Gg, Gg, Gg, Gs, Re^Vh, Re^Gvs, Re^Gvs, Rb^Gvs, Rb^Gvs, Re^Gvs, Rb^Gvs, Re^Gvs, Re^Gvs, Re^Gvs, Gs, Gs, Gs, Gs, Gg, Gg^Efm, Gs^Efm, Hh^Fp, Hh^Fp, Mm^Qhh, Mm, Mm, Mm, Hh^Qhh, Mm^Qhh
Gs, Gg, Ww, Ww, Gg, Gg, Gg, Gs, Gs, Gg, Ch, Gg, Ch, Rp, Rp^Ebn, Rp, Gg, Re, Re^Gvs, Rb^Gvs, Re^Gvs, Re^Gvs, Rb^Gvs, Rb^Gvs, Rb^Gvs, Re^Gvs, Re, Hh, Hh, Hh^Fp, Hh^Fp, Gg, Gg^Fp, Gs, Hh, Hh^Qhh, Chr^Qhh, Mm, Mm^Xm, Mm, Mm^Qhh
Gs, Gg, Gg, Ww, Ww, Gg, Gg, Gs, Gs, Gg, Rp, Ch^Vhc, Isa, Isa, Rp, Rp, Ch, Gg, Re^Gvs, Re^Gvs, Re^Gvs, Re^Gvs, Re, Rb^Gvs, Rb^Gvs, Rb^Gvs, Re, Hh, Hh, Hh, Mm, Hh^Fp, Gs, Gg, Gd^Edt, Hhd^Edt, Hhd^Qhh, Md, Chr, Mm^Qhh, Mm^Qhh
Gs, Gg, Gg, Ww, Ww, Ww, Ww, Gg, Ww, Rp, Rp, Isa, Ch, Ch, Ch, Isa, Ch^Vhc, Rp, Rp, Re^Gvs, Re^Gvs, Re^Gvs, Re^Gvs, Rb^Gvs, Re^Gvs, Rb^Gvs, Rb^Gvs, Gs^Vh, Hh, Mm, Mm, Hh^Fp, Hh^Fp, Gs, Gd, Gd, Hhd, Md^Qhh, 4 Khr^Qhh, Mm, Mm^Qhh
Gs, Gs, Gs, Gg, Gs, Gg, Gg, Ww, Ww, Ww, Ww, Ww, Ch, Qxua^Xo, 2 Kh, Isa, Isa, Ch, Gg, Gg, Gg, Re^Gvs, Re^Gvs, Rb^Gvs, Rb^Gvs, Rb^Gvs, Rb^Gvs, Rb, Gs, Hh, Mm, Hh, Hh^Fp, Gs^Edt, Gs, Gd^Edt, Gd^Edt, Chr^Edt, Gd, Chr^Qhh, Chr^Qhh
Gs, Gs, Gs, Gs^Efm, Gs^Efm, Gg, Gg, Ww, Ww, Hh, Hh, Ww, Ww, Ch, Isa, Isa, Ch, Isa, Rp, Rp, Gs^Vh, Re, Re^Gvs, Re^Gvs, Rb^Gvs, Rb^Gvs, Rb^Gvs, Rb^Gvs, Rb^Gvs, Hh^Vhh, Hh^Qhh, Mm, Hh^Edt, Hh^Edt, Hh, Gd^Edt, Hhd, Gd, Gd, Chr^Qhh, Hhd^Qhh
Hh, Gs, Hh, Gs, Gs, Gs^Efm, Gg^Efm, Gg, Gg^Vwm, Ww, Gg, Gg, Ww, Rp, Ch^Vhc, Isa, Rp, Rp^Ebn, Rp^Vhc, Rp, Gs, Gs^Eff, Re^Eff, Re^Gvs, Rb^Gvs, Rb^Gvs, Rb^Gvs, Rb^Gvs, Rb^Gvs, Gs, Hh^Qhh, Mm, Mm, Hh^Vhr, Hh, Chr, Gs^Edt, Hhd, Hhd, Hhd, Hhd^Edt
Gs, Hh, Hh, Hh, Gs, Gs^Efm, Gs^Efm, Gg, Gg, Ww, Hh, Hh, Ww, Ch, Ww, Ch, Rp, Gg, Gg, Ch, Ch, Gg, Gg, Re^Eff, Rb^Eff, Rb^Gvs, Re^Gvs, Re^Gvs, Gs^Eff, Gs, Gg, Hh^Qhh, Mm, Hh^Fds, Hh^Fds, Hh, Mm, Mm, Mm, Hh, Chr
Hh, Hh, Hh, Hh, Gs, Gs^Efm, Gs, Gg, Gg, Ww, Gg, Hh, Gg, Ww, Gg, Ww, Ww, Gg, Gg, Gs, Gg, Gs, Gg, Gg, Gg, Rb^Eff, Gs^Vwm, Gs^Eff, Gs, Gs, Gg, Hh^Qhh, Mm, Mm, Hh^Fds, Hh, Mm, Mm, Mm^Xm, Mm, Mm
Hh, Gs, Gs, Gs, Gs, Gs, Gs, Gs^Vh, Gs, Ww, Ww, Gg, Hh, Gg, Gs, Gg, Ww, Gs, Gs, Gs, Gs, Gg, Gg^Efm, Gg, Gs, Gd, Gd, Gs, Gs, Gg, Hh, Hh^Qhh, Mm, Mm, Hh, Hh, Hh, Mm, Mm, Mm^Xm, Mm^Xm
Gs, Gs, Gs, Gs, Gs, Gs, Gs, Gs, Gs, Ww, Ww, Gg, Gg, Hh^Vhh, Gs, Gs, Hh, Ww, Ww, Gs, Gs, Gg^Efm, Gg^Efm, Gg^Efm, Gs^Efm, Gd, Gs^Efm, Gs, Gs^Efm, Gg, Gg, Hh^Qhh, Hh^Qhh, Hh, Hh, Hh, Hh, Hh, Hh^Fds, Mm, Mm
Hh, Hh, Hh, Hh, Hh, Hh, Gg, Gg, Gg^Efm, Gs, Gs, Ww^Qhu, Ww, Gg, Gg, Gs, Hh, Hh, Hh, Ww, Gs, Gg, Gs, Gs, Gs, Gs^Efm, Gs^Efm, Gs^Efm, Gs^Efm, Gg^Efm, Gg, Gs, Gs, Hh^Qhh, Hh^Qhh, Hh, Hh, Hh, Hh^Fds, Mm, Mm
Hh, Hh, Hh, Hh, Hh, Hh, Gs, Gg, Gg^Efm, Gs^Efm, Gs^Vh, Ww^Qhu, Ww^Qhu, Gs, Gg, Gs, Gs, Gs, Hh, Ww, Wwf, Gs, Gs, Gs, Gs, Gs, Gd^Efm, Gs^Efm, Gs^Efm, Gs^Efm, Gs^Efm, Gs, Hh, Gs, Hh^Qhh, Chr, Mm, Mm, Mm, Hh^Fp, Gs^Fp
Mm, Mm, Mm, Mm, Mm, Hh, Hh^Fp, Gg, Gg, Gg^Efm, Gg^Edt, Gg, Gs, Ww^Qhu, Gs, Gs^Efm, Gd^Efm, Gs, Hh, Hh, Gs, Wwf, Wwf, Gs, Ww, Gs, Gd, Gd, Gd^Efm, Gd^Efm, Gd^Efm, Hh, Gs, Hh^Qhh, Hh^_mh, Mm, Mm, Mm, Mm, Hh^Fds, Hh
Mm^Xm, Mm, Mm, Mm, Mm^Xm, Mm, Hh^Fp, Gs^Fp, Gs, Gg^Edt, Gg, Gg^Efm, Gs, Ww^Qhu, Ww^Qhu, Gd, Gd, Gd^Efm, Gs, Hh, Gs, Gs, Hh, Ww, Ww^Edt, Ww, Gs^Vc, Gd, Gd, Gd^Efm, Gd^Efm, Gd^Efm, Gd, Hh^Qhh, Hh^Qhh, Mm, Mm, Mm, Mm, Hh, Hh
Mm^Xm, Mm^Xm, Mm, Mm, Mm, Mm, Mm, Hh, Hh, Gg, Gg, Gs^Edt, Hh, Gs, Hh, Wwf^Qhu, Wwf^Qhu, Gd, Hh, Gs, Hh, Gs, Hh, Gs, Gs, Ww, Ww, Gs, Gd, Gd^Efm, Gd, Gd^Efm, Gd, Gs, Chr^Qhh, Chr, Mm, Mm, Mm, Hh, Hh
Mm, Mm, Mm, Mm, Mm, Mm^Edt, Chr, Mm, Mm, Hh^Edt, Hh, Hh, Mm, Hh, Hh, Hh, Wwf^Qhu, Gs, Hh, Hh^Fp, Hh^Fp, Hh, Hh, Hh, Gs, Gd, Ww, Ww^Edt, Gd, Gd^Efm, Gs^Efm, Gs, Hhd^Qhh, Gd^Edt, Hhd^Qhh, Khr, 5 Khr, Mm^Xm, Mm^Xm, Hh, Hh
Hh, Hh, Hh, Chr^Edt, Hh, Chr^Edt, 7 Khr, Chr^Edt, Mm, Mm, Mm, Mm, Mm, Mm, Hh, Wwf^Qhu, Hh^_ml, Hh, Hh^Fp, Hh^Fp, Mm, Mm, Mm, Hh, Gs^Edt, Gd, Gd, Ww, Gd, Gd, Gd, Hhd^Qhh, Hhd^_mh, Hhd^Qhh, Hhd, Chr, Chr^Edt, Mm^Xm, Mm, Mm, Hh
Mm, Mm, Mm, Mm, Mm, Mm, Mm, Chr^Edt, Mm, Mm, Hh, Mm, Hh, Hh, Wwf^Qhu, Wwf^Qhu, Hh, Hh, Mm, Mm, Mm, Mm, Mm, Chr^Edt, Hh, Gs, Gd, Wwf, Gs, Gs, Gd^Edt, Hhd^Qhh, Md, Md, Md, Hhd^Edt, Hhd^Edt, Mm, Mm, Mm, Hh
Hh, Hh, Hh, Hh, Chr^Edt, Mm, Mm^Edt, Mm^Edt, Hh^Edt, Hh^Edt, Gs, Hh, Hh, Wwf^Qhu, Wwf^Qhu, Hh, Mm, Mm, Mm, Mm, Mm, Mm, Chr, 6 Chr^Kov, Chr, Hh, Gs^Edt, Wwf, Gs, Gd^Edt, Chr^Qhh, Chr^Qhh, Md, Md, Md, Hhd, Hhd^Edt, Mm, Mm, Mm^Xm, Mm
Mm, Mm, Mm, Mm, Mm, Mm, Hh^Fp, Hh^Fp, Gs, Gs, Hh, Hh, Mm, Hh, Hh, Wwf^Qhu, Mm, Mm^Xm, Mm, Mm, Hh^Fp, Hh^Fp, Mm, Mm, Mm, Gs^Edt, Wwf, Wwf, Hh^Qhh, Hh^Qhh, Hh, Chr, Mm, Md, Md, Chr^Edt, Hhd, Mm, Mm^Xm, Mm, Mm
Hh, Hh, Hh, Hh, Hh, Hh^Fp, Gs, Gs^Fp, Gs, Gs, Hh, Mm, Mm^Xm, Mm, Wwf^Qhu, Wwf^Qhu, Mm, Mm, Mm, Mm, Mm^Xm, Mm^Xm, Mm^Xm, Mm, Mm, Hh, Wwf, Hh^Qhh, Hh^Qhh, Hh, Mm, Mm, Mm^Xm, Mm^Xm, Md, Md, Hhd, Mm, Mm^Xm, Mm^Xm, Mm^Xm
Gs, Gs, Gs, Gs, Gs, Hh, Gs, Gs, Gs, Hh, Hh, Mm, Mm^Xm, Mm^Xm, Wwf^Qhu, Hh, Hh, Mm, Mm^Xm, Mm^Xm, Mm, Mm^Xm, Mm, Mm, Hh, Hh, Gs, Wwf, Hh^Qhh, Mm, Mm, Mm^Xm, Mm^Xm, Mm^Xm, Mm^Xm, Md, Hhd, Mm, Mm, Mm^Xm, Mm^Xm
