Rb^Gvs, Gs^Fms, Rb^Gvs, Rb^Gvs, Re, Hh^Qhh, Hh^Qhh, Hh^Qhh, Hh^Qhh, Mm^Qhh, Hh^Qhh, Mm^Qhh, Mm, Mm^Qhh, Mm^Qhh, Hh^Qhh, Hh^Qhh, Mm^Qhh, Mm^Qhh, Mm^Qhh, Mm^Qhh, Mm^Qhh, Mm^Qhh, Mm^Qhh, Mm^Qhh, Mm^Qhh, Hh^Qhh, Mm^Qhh, Mm^Qhh, Mm^Qhh, Mm^Qhh, Hh^Fds, Hh^Fds, Hh^Fds, Gg, Gg, Gs^Fds, Gs^Fds, Gg, Gs^Fds, Gs^Fds, Gs^Fms
Rb^Gvs, Rb^Gvs, Rb^Gvs, Rb^Gvs, Gg, Hh, Hh, Hh^Qhh, Hh, Mm, Hh, Mm, Mm, Mm, Mm, Hh, Hh, Mm, Mm, Mm, Mm, Mm, Mm, Mm, Mm, Mm, Hh^Qhh, Mm^Qhh, Mm^Qhh, Mm^Qhh, Mm^Qhh, Hh^Fds, Hh, Hh^Fds, Gg, Gg, Gs^Fds, Gs^Fds, Gg, Gs^Fds, Gs^Fms, Gs^Fms
Rb^Gvs, Rb^Gvs, Rb^Gvs, Re, Gg, Hh, Hh, Hh^Qhh, Hh^Qhh, Mm, Mm, Mm, Mm, Hh, Mm, Mm, Mm, Mm, Hh, Mm, Mm, Mm, Hh, Mm, Hh, Hh^Qhh, Hh^Vhh, Hh^Qhh, Mm^Qhh, Mm^Qhh, Mm^Qhh, Mm^Qhh, Hh, Hh, Hh, Gg, Gg, Gs^Fms, Gs^Fds, Gs^Fms, Gs^Fds, Gs^Fms
Rb^Gvs, Rb^Gvs, Rb^Wm, Rb^Gvs, Gg, Hh, Hh, Hh, Hh, Hh^Qhh, Hh^Qhh, Hh, Mm, Mm, Mm, Mm, Hh^_mh, Mm, Mm, Mm, Mm, Hh, Mm, Mm, Hh^Qhh, Hh^Qhh, Gg, Hh, Hh, Mm^Qhh, Hh, Mm^Qhh, Mm, Hh, Gg, Gg, Gg, Gs^Fms, Gg, Gg, Gs^Fms, Gs^Fms
Rb^Gvs, Rb^Gvs, Rb^Gvs, Rb^Gvs, Rb^Gvs, Gg, Hh, Hh, Gg, Hh, Hh^Qhh, Hh, Mm, Hh, Mm, Hh, Mm, Hh, Mm, Mm, Mm, Hh, Hh, Hh, Hh^Qhh, Hh, Hh, Hh, Hh^Fds, Hh^Fds, Hh, Hh, Hh, Hh, Hh, Hh, Gg, Gg, Gg, Gg, Gg, Gg
Rb^Gvs, Rb^Gvs, Re^Gvs, Re^Vh, Re^Gvs, Re, Gg^Efm, Gg, Gg, Hh, Hh^Qhh, Hh, Mm, Mm, Mm, Hh, Hh, Mm, Mm, Mm, Mm, Mm, Hh^Qhh, Hh^Qhh, Hh, Hh, Gg, Hh, Gs^Fds, Gs^Fds, Gg, Hh, Hh, Hh, Hh, Gg, Gs^Edt, Gg, Gs, Gg, Gg, Gg
Gg, Rb^Gvs, Re^Gvs, Re^Gvs, Re^Gvs, Rb^Gvs, Rb^Gvs, Rb^Gvs, Gg, Hh, Hh, Hh^Qhh, Mm^Qhh, Mm, Mm, Mm, Mm, Mm, Mm, Mm, Mm, Hh, Hh^Qhh, Hh, Gg, Gg, Gg, Gg, Gg, Gs^Fds, Gs, Gg, Gs, Hh, Gs, Gs, Gs, Ce^Edt, Rr, Gg, Rr, Re
Rr, Rr, Rr, Re^Gvs, Re^Gvs, Rb^Gvs, Rb^Gvs, Rb^Gvs, Rb^Gvs, Gg, Hh^Fms, Hh, Hh, Mm^Qhh, Mm^Qhh, Hh, Hh, Hh, Mm, Mm, Hh, Hh, Hh^Qhh, Hh, Hh, Gg, Gg, Gg, Gs, Gg, Gg^Edt, Gs, Gs, Gs, Gs^Ecf, Ss, Re^Edt, Re, Rb^Edt, Rr^Edt, Gs, Gs
Rb^Gvs, Rb^Gvs, Rb^Gvs, Rr, Rr, Rb^Gvs, Rb^Gvs, Rb^Gvs, Gg, Hh, Hh^Fms, Hh, Hh, Hh, Hh^Qhh, Hh, Hh, Hh, Hh^Qhh, Hh^Qhh, Hh^Qhh, Hh^Qhh, Hh, Hh, Hh, Gg, Gg, Gg, Gg, Gs, Gs, Gs^Edt, Ce^Edt, Ce, Re, Rb, Rb, Rb^Vct, Rb^Ecf, Rb^Vct, Rb, Rb
Re^Gvs, Rb^Gvs, Rb^Gvs, Rb^Gvs, Ce, Rr, Re, Gg, Gg, Hh^Fms, Hh, Hh, Hh, Hh, Hh^Qhh, Hh, Hh^Qhh, Hh^Qhh, Gg^Vh, Hh, Hh, Hh, Gg, Hh, Gg, Gg, Hh, Hh, Hh, Gs, Gs, Gs, Gs, Ce, Rb^Edt, Ce, Ce, Gs, Rb^Vct, Rb, Gg^Edt, Gg
Rb^Gvs, Rb^Gvs, Re^Eff, Gg^Eff, Ce, Ke, Ce, Re, Gg, Gg, Gg, Hh, Gg, Hh, Hh, Hh^Qhh, Hh, Hh, Hh, Gg, Gg, Gg, Gg, Gg, Gg, Gg, Hh, Hh, Gs^Vh, Hh, Gs^Edt, Gs, Rb^Es, Rb, Ce, 2 Ket, Rb, Gs, Ce^Edt, Rb^Vct, Gs^Edt, Gs^Edt
Re^Eff, Re^Eff, Re^Eff, Gg, Gg, Ce, Gg, Re, Re, Gg, Gg, Gg, Gg^Vh, Gg, Hh, Hh, Hh^Qhh, Hh^Qhh, Hh^Qhh, Hh, Hh, Gg, Gg, Gg, Gg, Hh, Hh, Hh, Hh, Gs, Gs, Gs, Rr, Re, Re, Ce, Gs^Edt, Gs^Es, Gg, Gg^Edt, Gg, Gg
Re^Gvs, Re^Gvs, Re^Gvs, Gg^Eff, Gg^Eff, Gg, Gg^Efm, Gg, Gg^Vh, Rr, Re, Gg, Hh, Hh, Hh^Qhh, Hh^Qhh, Mm^Qhh, Mm^Qhh, Hh^Qhh, Hh, Hh, Gg, Gg, Gg, Gg, Gg, Hh, Hh, Gs, Gs, Re, Rr, Gs, Gs, Hh, Gs, Gs^Edt, Gs, Gg, Gs^Fds, Gg, Gg
Re^Gvs, Re^Gvs, Re^Gvs, Rb^Gvs, Rb^Gvs, Gg^Eff, Gg^Eff, Gg^Efm, Gg^Efm, Gg, Re, Gg, Gs^Fms, Hh, Hh, Hh^Qhh, Mm^Qhh, Mm^Qhh, Hh^Qhh, Hh^Qhh, Hh, Hh, Gg, Gg, Gg, Gg, Re, Re, Re, 3 Re, Gg, Gs, Gs, Gs, Hh, Hh, Gs, Gs, Gs^Fds, Gs^Fds, Gs^Fms, Gs^Fms
Re^Gvs, Re^Gvs, Rb^Gvs, Rb^Gvs, Rb, Rb^Eff, Gg, Gg^Efm, Gg, Gg, Gg, Re, Gs^Fms, Hh, Hh, Hh^Qhh, Hh^Qhh, Hh^Qhh, Hh, Hh, Gg, Gg, Re, Re, Re, Re, Gg, Gg, Hh, Hh, Gg, Gg, Gs, Ss^Qhh, Ss, Gs, Gs, Gg, Gs^Fms, Gs^Fms, Gs^Fms, Gs^Fms
Rb^Gvs, Rb^Gvs, Rb^Gvs, Rb, Gs^Fds, Gg, Gg, Gg^Efm, Gg, Hh, Hh, Rr, Rr, Gs^Fms, Gg, Hh, Hh, Hh, Gg, Gg, Re, Re, Gs^Fds, Gs^Fds, Hh, Gg, Hh, Hh, Hh, Hh, Gg, Gg, Gs, Ss^Qhh, Gs, Gs, Gs, Gg, Gg, Gs^Fms, Gs^Fms, Gs^Fms
Rb^Gvs, Rb^Gvs, Gs^Fms, Gs^Fms, Gs^Fds, Gs^Fms, Gg, Gg, Gg, Hh, Gg, Gg, Gg, Re, Rr, Gg, Gg, Gg, Rr, Rr, Hh, Hh, Hh, Hh, Hh, Hh, Hh^Fds, Hh, Hh, Gg, Hh, Gs^Qhh, Hh, Gs^Qhh, Hh^Qhh, Gs, Hh, Gg, Gg, Gg, Gg, Gg
Hh^Qhuf, Hh^Qhuf, Hh^Qhuf, Gg, Hh^Qhu, Gs^Fds, Gs^Fms, Gg, Gg, Gg, Ss^Qhu, Gg, Gg, Gg, Gg, Re, Re, Re, Gg, Gg, Hh, Hh, Gg, Hh, Hh, Hh^Fds, Hh, Hh, Hh, Hh, Hh, Gs^Qhh, Hh^Qhh, Hh, Hh^Qhh, Hh, Hh, Hh, Hh, Hh, Hh, Hh
Hh, Hh, Hh, Hh^Qhu, Hh, Hh^Qhuf, Gs^Qhuf, Gs^Qhuf, Gs^Qhuf, Ss^Qhu, Ss, Ss^Qhu, Gs^Qhuf, Hh^Qhuf, Hh^Qhu, Gg, Re, Gg, Hh, Hh, Hh, Hh, Hh^Qhh, Hh, Gg, Hh, Gg, Hh^Qhh, Hh^Qhh, Hh, Hh, Hh^Qhh, Hh, Hh, Hh^Qhh, Hh, Hh, Hh, Hh, Hh^Fds, Hh^Fds, Hh
Hh, Hh, Hh, Hh, Hh, Hh^Fms, Hh, Gs^Fms, Gs^Fp, Gg, Gs^Fp, Ss, Gs^Fp, Gs^Fms, Hh^Qhu, Gg, Re, Gg, Gg, Hh, Hh^Qhh, Hh^Qhh, Hh, Hh, Gg, Gg, Gg, Hh, Hh, Hh^Qhh, Hh, Hh^Qhh, Hh, Hh^Qhh, Hh^Qhh, Hh, Hh^Qhh, Hh^Qhh, Hh, Hh^Fds, Hh, Hh
Hh, Hh, Hh, Hh, Hh, Hh, Hh, Hh, Hh, Gs^Fp, Hh, Gs^Fp, Hh, Hh, Hh^Qhu, Hh^Qhu, Re, Gg, Gg, Hh, Hh^Qhh, Hh, Hh^Fds, Hh, Hh, Gg, Gg^Vh, Hh, Hh, Hh^Qhh, Hh^Qhh, Hh^Qhh, Hh^Qhh, Hh^_mhh, Hh^Qhh, Hh^Qhh, Gg, Hh, Hh, Hh, Hh, Hh
Hh, Hh, Hh, Hh, Hh, Gg, Gg, Gg, Gg, Hh, Hh, Hh, Gg^Vh, Hh, Hh^Qhuf, Hh^Qhu, Rb, Gg, Gg, Hh, Hh^Qhh, Hh, Hh, Hh, Hh, Hh, Hh, Hh, Hh, Hh, Hh, Hh^Qhh, Gg, Hh^Qhh, Hh, Hh, Hh, Hh, Hh, Gg, Gg, Gg
Hh, Hh, Hh, Hh, Hh, Hh, Gg, Gg, Hh, Hh, Hh, Hh, Gg, Hh, Hh^Qhu, Gg, Rb, Gg, Gg, Hh, Hh, Hh^Qhh, Gs, Hh, Hh, Hh, Hh, Hh, Hh, Hh, Hh, Gg, Hh, Gg, Gs^Fds, Gs^Fds, Hh, Hh, Gg, Gg, Hh, Hh
Hh^Fms, Hh^Fms, Gs^Fms, Hh, Hh, Hh, Hh, Hh, Hh, Hh, Hh^Fds, Hh, Hh, Hh, Hh^Qhu, Gs^Fms, Gg, Rb, Rb, Gg, Gg, Hh^Qhh, Hh, Hh, Gs, Hh, Hh, Hh, Hh, Hh, Hh^Qhh, Hh, Hh, Hh, Hh, Hh, Hh, Hh, Hh, Gg, Hh, Hh
Rb^Gvs, Gg, Gs^Fms, Gs^Fms, Hh, Hh, Hh, Hh, Hh^Qhuf, Hh, Hh, Hh, Hh, Hh, Hh^_ml, Gs^Qhuf, Hh^Qhu, Gg, Gg, Re, Gg, Hh^Qhh, Hh^Qhh, Hh, Hh^Qhh, Hh^Qhh, Hh^Qhh, Hh, Hh^Qhh, Hh^Qhh, Hh, Hh^Qhh, Hh^Qhh, Hh^Qhh, Hh^Qhh, Hh, Gs^_mh, Hh, Hh, Hh, Hh^Qhh, Hh
Rb^Gvs, Rb^Gvs, Re^Gvs, Re, Re, Hh, Gg, Hh^Qhu, Gs^Fds, Gs^Qhuf, Gs^Qhuf, Hh, Hh, Hh, Hh, Hh, Hh^Qhu, Hh^Qhu, Gg, Re, Gg, Hh, Hh, Hh^Qhh, Hh, Hh, Hh, Hh^Qhh, Hh, Gg, Gg, Hh, Hh, Hh, Hh, Hh^Qhh, Hh^Qhh, Hh, Hh, Hh^Qhh, Hh^Qhh, Hh^Qhh
Rb^Gvs, Rb^Gvs, Rb^Gvs, Re^Gvs, Rb^Eff, Gs, Gs, Gg, Gg, Gs^Fds, Hh^Qhuf, Gg, Hh^Qhu, Hh^Qhu, Hh^Qhu, Hh^Qhu, Gs^Vh, Hh^Qhu, Gg, Rb, Re, Rb, Hh, Hh, Hh, Hh, Hh, Gg, Gg, Gg, Gg, Hh, Hh^Vhh, Hh, Hh, Gg, Gg, Hh^Qhh, Hh^Qhh, Hh^Qhh, Hh^Qhh, Hh^Qhh
Rb^Gvs, Rb^Gvs, Rb^Wm, Re^Gvs, Rb^Gvs, Rb^Eff, Gs^Eff, Gg, Gg, Gg, Gg, Hh^Qhu, Gg, Gg, Gg, Hh^Qhu, Gs, Gs, Gg, Rb, Ce, Rb, Ss, Hh, Hh^Fms, Hh^Fms, Gs^Fms, Gg, Gg^Eff, Gg^Eff, Gs^Eff, Gg, Gg, Hh, Hh, Hh, Hh, Hh, Hh, Gg, Hh, Hh^Qhh
Rb^Gvs, Rb^Gvs, Re^Gvs, Re^Gvs, Rb^Eff, Gs^Eff, Gg, Gg, Hh, Hh, Gg, Gg, Gg, Rb^Gvs, Rb^Gvs, Rb, Rb^Gvs, Gg, Gs, Ce, Ke, Rb, Rb, Hh, Hh, Gs^Fms, Gs^Fms, Gg, Rb^Gvs, Rb^Gvs, Ss, Gs^Eff, Gs^Eff, Hh, Hh, Hh, Gg, Hh, Gg, Gg, Hh^Fms, Hh^Fms
Re^Gvs, Re^Gvs, Re^Eff, Rb^Eff, Rb^Gvs, Re^Eff, Rb^Gvs, Rb^Gvs, Rb^Gvs, Rb^Gvs, Gg, Gg, Rb^Gvs, Rb^Gvs, Rb^Gvs, Re, Rb^Gvs, Rb, Gg, Ce, Gg, Ce, Rb, Rb, Rb, Gg^Vh, Gg, Gg, Rb^Gvs, Rb^Gvs, Rb^Gvs, Rb^Gvs, Gg, Gg, Gg, Hh, Gg, Gg, Rb^Gvs, Hh^Fms, Hh^Fms, Hh^Fms
Re^Eff, Re^Eff, Re^Gvs, Rb^Gvs, Rb^Gvs, Rb^Gvs, Rb^Gvs, Rb^Gvs, Rb^Gvs, Rb^Gvs, Re, Re, Rb^Gvs, Rb^Gvs, Re^Gvs, Re^Gvs, Rb^Gvs, Rb, Gg, Gs, Rb, Gg, Gg, Gg, Gg, Rb, Rb, Gg, Re^Gvs, Rb^Gvs, Rb^Gvs, Re^Gvs, Re^Gvs, Gs, Rb^Gvs, Rb^Gvs, Rb^Gvs, Rb^Gvs, Rb^Gvs, Rb^Gvs, Rb^Gvs, Gs^Fms
Gs^Fms, Re^Gvs, Re^Gvs, Rb^Gvs, Rb^Gvs, Rb^Gvs, Rb^Gvs, Rb^Gvs, Hh, Hh, Gg, Re^Gvs, Rb^Gvs, Re^Gvs, Re^Gvs, Re^Gvs, Rb, Rb^Gvs, Rb^Gvs, Re^Gvs, Re^Gvs, Re^Gvs, Gs, Gg, Gg, Rb, Re^Gvs, Re^Gvs, Re^Gvs, Re^Gvs, Rb^Gvs, Rb^Gvs, Gs, Re^Gvs, Re^Gvs, Re^Gvs, Re^Gvs, Re^Gvs, Re^Gvs, Rb^Gvs, Gs^Fms, Rb^Gvs
