Rb, Gs^Fms, Aa, Rb, Aa, Hh^Qhh, Hh^Qhh, Hh^Qhh, Hh^Qhh, Mm^Qhh, Hh^Qhh, Mm^Qhh, Mm, Mm^Qhh, Mm^Qhh, Hh^Qhh, Hh^Qhh, Mm^Qhh, Mm^Qhh, Mm^Qhh, Mm^Qhh, Mm^Qhh, Mm^Qhh, Mm^Qhh, Mm^Qhh, Mm^Qhh, Ha^Qhh, Mm^Qhh, Ms^Qhh, Mm^Qhh, Ms^Qhh, Hh^Fdw, Hh^Fdw, Hh^Fdw, Gg, Gll, Gll^Fdw, Gll^Fdw, Gg, Gll^Fdw, Gll^Fdw, Gll^Fmw
Rb, Rb, Rb, Aa, Aa, Ha, Ha, Hh^Qhh, Hh, Mm, Hh, Mm, Mm, Mm, Mm, Hh, Hh, Mm, Ms, Ms, Ms, Ms, Ms, Mm, Ms, Ms, Ha^Qhh, Ms^Qhh, Ms^Qhh, Ms^Qhh, Ms^Qhh, Hh^Fdw, Hh, Hh^Fdw, Gll, Gll, Gll^Fdw, Gll^Fdw, Gll, Gll^Fdw, Gll^Fmw, Gll^Fmw
Rb, Rb, Rb, Aa, Aa, Ha, Ha, Hh^Qhh, Hh^Qhh, Mm, Mm, Mm, Mm, Hh, Mm, Mm, Mm, Mm, Ha, Ms, Ms, Ms, Hh, Ms, Ha, Ha^Qhh, Hh, Ha^Qhh, Ms^Qhh, Ms^Qhh, Ms^Qhh, Ms^Qhh, Hh, Hh, Hh, Gg, Gg, Gll^Fmw, Gll^Fdw, Gll^Fmw, Gll^Fdw, Gll^Fmw
Rb, Rb, Rb^Wm, Aa, Gg, Hh, Ha, Ha, Ha, Hh^Qhh, Hh^Qhh, Hh, Mm, Mm, Mm, Mm, Hh^_mh, Ms, Ms, Ms, Mm, Hh, Mm, Mm, Ha^Qhh, Ha^Qhh, Gs, Hh, Hh, Ms^Qhh, Hh, Ms^Qhh, Mm, Hh, Gg, Gg, Gll, Gll^Fmw, Gs, Gs, Gll^Fmw, Gll^Fmw
Rb, Rb, Rb, Rb, Rb, Gg, Hh, Hh, Gg, Ha, Hh^Qhh, Hh, Mm, Hh, Mm, Hh, Mm, Hh, Ms, Ms, Mm, Hh, Hh, Ha, Ha^Qhh, Hh, Hh, Hh, Hh^Fdw, Hh^Fdw, Hh, Hh, Hh, Hh, Hh, Hh, Gg, Gll, Gg, Gs, Gs, Gll
Rb, Rb, Re, Re^Vh, Re, Re, Gg^Efm, Gg, Gg, Hh, Hh^Qhh, Hh, Mm, Mm, Mm, Hh, Hh, Ms, Ms, Ms, Ms, Mm, Hh^Qhh, Ha^Qhh, Hh, Hh, Gs, Hh, Gll^Fdw, Gll^Fdw, Gll, Hh, Hh, Hh, Hh, Gg, Gs^Edt, Gg, Gs, Gs, Gs, Gs
Gg, Rb, Re, Re, Re, Rb, Rb, Rb, Gg, Hh, Hh, Hh^Qhh, Mm^Qhh, Mm, Mm, Mm, Ms, Mm, Mm, Ms, Mm, Hh, Hh^Qhh, Hh, Gg^Vhh, Gs, Gg, Gll, Gll, Gll^Fdw, Gs, Aa, Aa, Hh, Gs, Gs, Gs, Ce^Edt, Rr, Gg, Rr, Re
Rr, Rr, Rr, Re, Re, Rb, Rb, Rb, Rb, Gg, Hh^Fmw, Hh, Hh, Mm^Qhh, Mm^Qhh, Hh, Ha, Ha, Mm, Mm, Hh, Hh, Hh^Qhh, Hh, Hh, Gg, Gs, Gg, Gs, Gll, Aa^Edt, Aa, Aa, Aa, Gs^Ecf, Ss, Re^Edt, Re, Rb^Edt, Rr^Edt, Gs, Gs
Aa, Rb, Rb, Rr, Rr, Rb, Rb, Rb, Gll, Hh, Hh^Fmw, Hh, Hh, Hh, Hh^Qhh, Hh, Hh, Ha, Ha^Qhh, Hh^Qhh, Hh^Qhh, Hh^Qhh, Hh, Hh, Hh, Gs, Gg, Gs, Gg, Aa, Aa, Aa^Edt, Ce^Edt, Ce, Re, Rb, Rb, Rb^Vct, Rb^Ecf, Rb^Vct, Rb, Rb
Aa, Aa, Rb, Rb, Ce, Rr, Re, Gg, Gll, Hh^Fmw, Hh, Hh, Hh, Hh, Hh^Qhh, Hh, Ha^Qhh, Ha^Qhh, Gs, Hh, Hh, Hh, Gs, Hh, Gg, Gs, Hh, Hh, Hh, Gs, Aa, Aa, Gs, Ce, Rb^Edt, Ce, Ce, Gs, Rb^Vct, Rb, Gg^Edt, Gg
Aa, Aa, Aa^Eff, Gg^Eff, Ce, Ke, Ce, Re, Gg, Gll, Gg, Hh, Gg, Hh, Hh, Hh^Qhh, Hh, Hh, Hh, Gs, Gs, Gs, Gg, Gg, Gs, Gg, Hh, Hh, Gs^Vh, Hh, Gs^Edt, Gs, Rb^Es, Rb, Ce, 2 Ket, Rb, Gs, Ce^Edt, Rb^Vct, Aa^Edt, Gs^Edt
Aa^Eff, Aa^Eff, Aa^Eff, Aa, Aa, Ce, Gg, Re, Re, Gg, Gg, Gg, Gg^Vh, Gg, Hh, Hh, Hh^Qhh, Hh^Qhh, Hh^Qhh, Hh, Hh, Gs, Gs, Gg, Gg, Hh, Hh, Hh, Hh, Gs, Gs, Gs, Rr, Re, Re, Ce, Gs^Edt, Gs^Es, Gg, Aa^Edt, Aa, Aa
Aa, Aa, Aa, Aa^Eff, Gg^Eff, Gg, Gg^Efm, Gg, Gg^Vh, Rr, Re, Gg, Hh, Hh, Ha^Qhh, Ha^Qhh, Ms^Qhh, Ms^Qhh, Hh^Qhh, Hh, Hh, Gs, Gg, Gg, Gs, Gs, Hh, Hh, Gs, Gs, Re, Rr, Gs, Gs, Hh, Gs, Aa^Edt, Gs, Aa, Aa^Fda, Aa, Aa
Re, Re, Re, Rb, Rb, Gg^Eff, Gs^Eff, Gg^Efm, Gg^Efm, Gg, Re, Gg, Gll^Fmw, Hh, Hh, Ha^Qhh, Ms^Qhh, Ms^Qhh, Ha^Qhh, Hh^Qhh, Hh, Hh, Gg, Gg, Gg, Gg, Re, Re, Re, 3 Re, Gg, Gs, Gs, Gs, Hh, Hh, Aa, Aa, Aa^Fda, Aa^Fda, Aa^Fma, Aa^Fma
Re, Re, Rb, Rb, Rb, Rb^Eff, Gs, Gg^Efm, Gs, Gg, Gg, Re, Gll^Fmw, Hh, Hh, Ha^Qhh, Ha^Qhh, Ha^Qhh, Hh, Hh, Gg, Gg, Re, Re, Re, Re, Gg, Gg, Hh, Hh, Gs, Gg, Gs, Ss^Qhh, Ss, Aa, Aa, Aa, Aa^Fma, Aa^Fma, Aa^Fma, Aa^Fma
Rb, Rb, Rb, Rb, Gll^Fdw, Gs, Gs, Gg^Efm, Gs, Hh, Hh, Rr, Rr, Gll^Fmw, Gg, Hh, Hh, Gg^Vh, Gs, Gg, Re, Re, Gll^Fdw, Gll^Fdw, Hh, Gg^Vh, Hh, Hh, Hh, Hh, Gs, Gs, Gs, Ss^Qhh, Aa, Aa, Gs, Aa, Gll, Gll^Fmw, Gll^Fmw, Aa^Fma
Rb, Rb, Gll^Fmw, Gll^Fmw, Gll^Fdw, Gll^Fmw, Gll, Gs, Gd, Hh, Gs, Gg, Gg, Re, Rr, Gs, Gs, Gs, Rr, Rr, Hh, Hh, Hh, Hh, Hh, Hh, Ha^Fma, Ha, Hh, Gg^Vh, Hh, Gs^Qhh, Hh, Gs^Qhh, Hh^Qhh, Gs, Hh, Gll, Gll, Gll, Gll, Gg
Hh^Qhuf, Hh^Qhuf, Hh^Qhuf, Gll, Hh^Qhu, Gll^Fdw, Gll^Fmw, Gd, Gd, Gs, Ss^Qhu, Gg, Gg, Gs, Gs, Re, Re, Re, Gs, Gs, Hh, Hh, Gg, Hh, Ha, Ha^Fma, Ha, Ha, Ha, Ha, Hh, Gs^Qhh, Hh^Qhh, Hh, Hh^Qhh, Hh, Hh, Hh, Hh, Hh, Hh, Hh
Hh, Hh, Hh, Hh^Qhu, Hh, Hh^Qhuf, Gs^Qhuf, Gs^Qhuf, Gs^Qhuf, Ss^Qhu, Ss, Ss^Qhu, Gs^Qhuf, Hh^Qhuf, Hh^Qhu, Gs, Re, Gg, Hh, Hh^Vhh, Hh, Hh, Hh^Qhh, Hh, Gg, Ha, Aa, Ha^Qhh, Ha^Qhh, Hh, Hh, Hh^Qhh, Hh, Hh, Hh^Qhh, Hh, Hh, Hh, Hh, Hh^Fdw, Hh^Fdw, Hh
Hh, Hh, Hh, Hh, Hh, Hh^Fmw, Hh, Gll^Fmw, Gll^Fp, Gg, Gll^Fp, Ss, Gs^Fp, Gs^Fmw, Hh^Qhu, Gs, Re, Aa, Aa, Hh, Hh^Qhh, Hh^Qhh, Hh, Hh, Gg, Aa, Aa, Hh, Hh, Ha^Qhh, Hh, Hh^Qhh, Hh, Hh^Qhh, Hh^Qhh, Hh, Hh^Qhh, Hh^Qhh, Hh, Hh^Fdw, Hh, Hh
Hh, Hh, Hh, Hh, Hh, Hh, Hh, Hh, Hh, Gll^Fp, Hh, Gs^Fp, Hh, Hh, Gg^Vh, Hh^Qhu, Re, Aa, Aa, Hh, Hh^Qhh, Hh, Hh^Fdw, Hh, Hh, Gs, Gs, Hh, Hh, Ha^Qhh, Hh^Qhh, Hh^Qhh, Hh^Qhh, Hh^_mhh, Hh^Qhh, Hh^Qhh, Gg, Hh, Hh, Hh, Hh, Hh
Hh, Hh, Hh, Hh, Hh, Aa, Aa, Gs, Gs, Hh, Hh, Hh, Gg, Hh, Hh^Qhuf, Hh^Qhu, Rb, Gd, Gd, Hh, Hh^Qhh, Hh, Hh, Hh, Hh, Hh, Hh, Hh, Hh, Hh, Hh, Hh^Qhh, Gs, Hh^Qhh, Ha, Ha, Ha, Ha, Hh, Gs, Gs, Gg
Hh, Hh, Hh, Hh, Ha, Ha, Aa, Aa, Ha, Ha, Hh, Hh, Gg, Hh, Hh^Qhu, Gs, Rb, Gs, Gg, Hh, Hh, Hh^Qhh, Hh, Hh, Aa, Hh, Hh, Hh, Hh, Hh, Hh, Gs, Ha, Gs, Aa^Fda, Ha^Fma, Hh, Hh, Gg, Gs, Hh, Hh
Hh^Fmw, Hh^Fmw, Gll^Fmw, Aa, Ha, Ha, Ha, Ha, Hh, Hh, Hh^Fdw, Hh, Hh, Hh, Hh^Qhu, Gs^Fmw, Gs, Rb, Rb, Gs, Gs, Hh^Qhh, Hh, Aa, Aa, Hh, Hh, Hh, Hh, Hh, Hh^Qhh, Ha, Ha, Ha, Ha, Ha, Ha, Hh, Hh, Gg, Hh, Hh
Rb, Gll, Aa^Fma, Aa^Fma, Ha, Ha, Hh, Hh, Hh^Qhuf, Hh, Hh, Hh, Hh, Hh, Hh^_ml, Gs^Qhuf, Hh^Qhu, Gs, Gg, Re, Gg, Hh^Qhh, Hh^Qhh, Hh, Hh^Qhh, Hh^Qhh, Hh^Qhh, Hh, Hh^Qhh, Hh^Qhh, Hh, Hh^Qhh, Ha^Qhh, Hh^Qhh, Ha^Qhh, Ha, Aa^_mh, Hh, Hh, Hh, Hh^Qhh, Hh
Rb, Rb, Re, Aa, Aa, Ha, Gg, Hh^Qhu, Gll^Fdw, Gs^Qhuf, Gs^Qhuf, Hh, Hh, Hh, Hh, Hh, Hh^Qhu, Hh^Qhu, Gg, Re, Gs, Hh, Hh, Hh^Qhh, Hh, Hh, Hh, Hh^Qhh, Hh, Gs, Gs, Hh, Hh, Hh, Hh, Ha^Qhh, Ha^Qhh, Ha, Ha, Hh^Qhh, Hh^Qhh, Hh^Qhh
Rb, Rb, Rb, Aa, Rb^Eff, Gs, Gs, Gg, Gll, Gll^Fdw, Hh^Qhuf, Gg, Hh^Qhu, Hh^Qhu, Hh^Qhu, Hh^Qhu, Gd^Vh, Hh^Qhu, Gs, Rb, Re, Rb, Hh, Hh, Hh, Hh, Hh, Gg, Gg, Gs, Gs, Hh, Hh^Vhh, Hh, Hh, Gs, Gs, Ha^Qhh, Ha^Qhh, Ha^Qhh, Hh^Qhh, Hh^Qhh
Rb, Rb, Rb^Wm, Re, Rb, Rb^Eff, Gs^Eff, Gg, Gg, Gg, Gg, Hh^Qhu, Gg, Gg, Gg, Hh^Qhu, Gd, Gd, Gs, Rb, Ce, Rb, Ss, Hh, Hh^Fmw, Hh^Fmw, Gll^Fmw, Gll, Gg^Eff, Gg^Eff, Gs^Eff, Gs, Gg, Hh, Hh, Hh, Hh, Hh, Hh, Gg, Hh, Hh^Qhh
Rb, Rb, Re, Re, Rb^Eff, Gs^Eff, Gg, Gg, Hh, Hh, Gg, Gg, Gg, Rb, Rb, Rb, Rb, Gs, Gs, Ce, Ke, Rb, Rb, Hh, Hh, Gll^Fmw, Gll^Fmw, Gg, Rb, Rb, Ss, Gs^Eff, Gs^Eff, Hh, Hh, Hh, Gg, Hh, Gg, Gg, Hh^Fmw, Hh^Fmw
Re, Re, Re^Eff, Rb^Eff, Rb, Re^Eff, Rb, Rb, Rb, Rb, Gg, Gg, Rb, Rb, Rb, Re, Rb, Rb, Gg, Ce, Aa, Ce, Rb, Rb, Rb, Gll^Vh, Gs, Gg, Rb, Rb, Rb, Rb, Gg, Gg, Gg, Hh, Gg, Gg, Rb, Hh^Fmw, Hh^Fmw, Hh^Fmw
Re^Eff, Re^Eff, Re, Rb, Aa, Rb, Aa, Aa, Aa, Rb, Re, Re, Rb, Rb, Re, Re, Rb, Rb, Aa, Aa, Aa, Aa, Gs, Gs, Gs, Rb, Rb, Gs, Re, Rb, Rb, Re, Re, Gs, Rb, Rb, Rb, Rb, Rb, Rb, Rb, Gll^Fmw
Gs^Fms, Re, Aa, Aa, Aa, Aa, Aa, Aa, Ha, Hh, Gg, Re, Rb, Re, Re, Re, Rb, Aa, Aa, Aa, Aa, Aa, Aa, Gg, Gg, Rb, Re, Re, Re, Re, Rb, Rb, Gs, Re, Re, Re, Re, Re, Re, Rb, Gll^Fmw, Rb
