Rb^Gvs, Rb^Gvs, Rb^Gvs, Gd, Gs, Gs, Ch, Ch, Ch, Isa, Isa, Isa, Isa, Isa, Rr, Rr, Rr, Gd, Isa, Gd, Ch, Gd, Re^Gvs, Re^Gvs, Re^Gvs, Rb^Gvs, Rb^Gvs, Re^Gvs, Re^Gvs, Re^Eff, Gd^Eff, Rp, Rr, Rr, Gd, Hhd^Qhh, Hhd^Qhh, Hhd^Qhh, Hhd^Qhh, Gd^Qhh, Gs^Qhh, Gd^Qhh, Hhd^Qhhf, Gd^Qhh, Hhd^Qhhf, Hhd^Qhh, Hhd^Qhhf, Gd^Qhh
Re^Gvs, Rb^Gvs, Rb^Gvs, Rb^Gvs, Re^Eff, Gs, Gd^Edt, Ch^Edt, Ch, Isa, Rr, Rr, Rr, Gs, Gs, Rr, Rb^Ebn, Isa, Isa, Rr^Vhc, Ch^Edt, Gs, Re^Gvs, Re^Gvs, Rb^Gvs, Rb^Gvs, Rb^Gvs, Re^Gvs, Re^Eff, Gd^Eff, Rr, Rr, Rr, Gd, Hhd, Hhd^Qhh, Hhd, Gs, Gs, Hhd, Hhd, Hhd, Hhd^Fdf, Hhd^Fdf, Hhd, Hhd, Hhd^Fdf, Hhd^Qhhf
Re^Gvs, Rb^Gvs, Re^Gvs, Rb^Gvs, Rb^Gvs, Re^Eff, Re^Eff, Gd, Gd, Rr, Gd, Isa, Isa, Gs^Edt, Gs, Isa, Isa, Rr^Edt, Gs^Edt, Isa, Ch^Edt, Ch^Edt, Gd^Edt, Re^Gvs, Rb^Gvs, Rb^Gvs, Rb^Eff, Re^Eff, Rp, Rp, Rr^Es, Rr, Hhd, Gd, Hhd^Qhh, Hhd^Qhh, Hhd^Fdf, Hhd, Hhd^Es, Hhd, Hhd, Hhd^Es, Hhd, Hhd, Hhd^Es, Hhd, Hhd, Hhd^Qhhf
Re^Gvs, Re^Gvs, Re^Gvs, Rb^Gvs, Re^Eff, Re^Eff, Rb^Gvs, Re^Eff, Rb^Gvs, Rr^Vhc, Gd, Isa^Edt, Isa^Edt, Isa, Ch, Rr^Vhc, Ch, Rr, Rr, Gd, Gs, Gs, Re^Gvs, Re^Gvs, Re^Gvs, Rb^Gvs, Gs^Es, Gs^Edt, Rr, Rp, Gd, Gd, Gd, Hhd^Qhh, Gd, Gd^Fdf, Hhd^Fdf, Hhd, Hhd, Hhd, Hhd^Qhh, Hhd, Gs^Vl, Hhd, Hhd, Hhd, Gd^_mh, Hhd^Qhhf
Re^Gvs, Re^Gvs, Re, Re^Eff, Re^Gvs, Re^Gvs, Re^Gvs, Rb^Gvs, Rb^Gvs, Rb^Gvs, Gd, Gd^Edt, Isa, Ch, Ch^Edt, Kh, Ch, Isa, Isa, Rr, Rb^Eff, Re^Gvs, Re^Gvs, Re^Gvs, Re^Gvs, Re^Gvs, Rp, Rr^Edt, Rr^Edt, Rp, Hhd, Hhd, Hhd^Fdf, Hhd^Qhhf, Hhd^Qhh, Hhd^Qhh, Hhd^Qhh, Hhd^Qhh, Hhd^Qhh, Hhd^Qhh, Hhd^Fdf, Hhd^Qhh, Hhd^Qhhf, Hhd^Qhh, Hhd^Qhh, Hhd^Qhh, Hhd^Qhh, Hhd^Qhh
Re^Gvs, Re^Gvs, Gs, Gs, Gs, Re^Gvs, Re^Gvs, Re^Gvs, Re^Gvs, Rb^Gvs, Rb^Gvs, Gs, Re^Gvs, Isa, Isa^Edt, Rr, Rr, Isa, Isa, Isa^Edt, Rb^Gvs, Rb^Eff, Rr^Vhc, Re^Gvs, Gs, Gd, Rp, Rp^Edt, Rr, Hhd, Gd^Es, Hhd, Gd^Edt, Hhd, Hhd, Hhd^Vhh, Hhd^Fdf, Hhd, Hhd, Gs, Gs, Hhd^Fdf, Hhd^Fdf, Hhd^Fdf, Gd, Hhd, Hhd^Edt, Hhd
Re, Gs^Efm, Gs^Efm, Rb^Es, Rb, Gs, Re, Re^Gvs, Re^Gvs, Rb^Gvs, Rb^Gvs, Re^Gvs, Re^Gvs, Gd^Edt, Isa^Edt, Isa, Isa, Rb^Ebn, Rb^Gvs, Rb^Gvs, Re^Gvs, Rb^Gvs, Re^Eff, Re^Eff, Rb^Eff, Gd^Edt, Rp, Rr, Gd, Gd^Edt, Gd, Gd, Gd^Edt, Gd^Edt, Gd, Gd, Gs, Hhd, Re^Ecf, Hhd, Gs, Gs, Gs, Hhd, Gs, Gd^Edt, Gd^Edt, Hhd^Edt
Rr, Rr, Rr, Rp, Rp, Rr, Rr, Re, Re^Eff, Re^Gvs, Re^Gvs, Re^Gvs, Re^Gvs, Re^Gvs, Gd, Isa^Edt, Rr^Vhc, Rb^Gvs, Rb^Gvs, Rb^Gvs, Rb^Gvs, Re^Eff, Rb^Gvs, Rb^Gvs, Rb^Gvs, Rr, Rp^Edt, Rp, Gs^Fdf, Hhd, Gs^Fdf, Hhd, Gs, Gs, Gs^Fdf, Gs, Gs, Gs, Gs, Gs, Gd, Gd^Edt, Gd, Gs, Gs, Gs, Hhd^Fdf, Gd
Gs^Efm, Rr, Gg, Rr, Rp, Gg, Gg^Efm, Rr, Rr, Re^Eff, Re^Eff, Re^Gvs, Re^Gvs, Re^Gvs, Re^Eff, Ch^Edt, Ch^Edt, Ch, Re^Gvs, Rb^Gvs, Re^Gvs, Re^Gvs, Rb^Gvs, Rb^Gvs, Rb^Gvs, Rr^Edt, Rr, Gd, Gll^Fdf, Gs^Fdf, Gll^Fdf, Hhd, Gs, Gs^Fdf, Gll^Qhhf, Hhd^Qhhf, Hhd^Qhh, Hhd, Gs^Es, Gs, Gd, Gd, Gd, Gd, Gs^Edt, Gs^Edt, Hhd, Hhd^Fdf
Gs, Gs, Gs, Gs, Gd^Vh, Rb, Gg, Gg^Efm, Rr, Rr, Rb, Re^Eff, Re^Eff, Re^Eff, Gd, Gd^Efm, Gd^Efm, Re^Gvs, Re^Gvs, Re^Gvs, Rb^Gvs, Rb^Gvs, Rb^Gvs, Rb^Gvs, Re^Gvs, Rp, Rr, Gd, Rr, Gs, Rr, Gs, Hhd, Hhd^Fdf, Hhd, Hhd^Qhh, Hhd^Qhh, Gs, Gs, Gd, Gs, Gd, Gs, Gs, Re^Eff, Re, Re, Re
Gd, Gll^Fdf, Gll^Fdf, Gs, Gll^Fdf, Gs, Gs^Efm, Gg^Efm, Gs^Efm, Rp, Gg, Gg^Efm, Gg^Efm, Gd, Gg, Gs^Efm, Gg^Efm, Gs^Efm, Gg, Rb^Gvs, Rb^Gvs, Rb^Gvs, Rb^Gvs, Rb^Gvs, Gg^Edt, Gs, Rb, Rr, Rp, Rr, Rp^Edt, Rr, Rr, Gd, Gd, Hhd^Fdf, Ch, Hhd, Gs, Gs, Gd, Gd, Re^Eff, Re^Eff, Rb^Gvs, Rb^Gvs, Rb^Gvs, Rb^Gvs
Rb^Gvs, Rb^Gvs, Rb^Gvs, Gll^Fdf, Gll^Fdf, Gs, Re^Eff, Gs^Efm, Gs^Efm, Rp, Rp, Gs^Efm, Gg^Efm, Re, Rb, Gg^Efm, Rb, Gs, Rb, Gs, Gs, Re^Gvs, Gs, Gs, Re, Rb, Gs, Gd, Gs, Gs, Hhd, Rp^Edt, Rp, Rr, Rr, Rr, Rp, Hhd, Rr, Gd^Edt, Gd, Re^Vh, Rb^Gvs, Rb^Gvs, Rb^Gvs, Rb^Gvs, Rb^Gvs, Rb^Gvs
Rb^Gvs, Rb^Gvs, Rb^Gvs, Rb^Gvs, Rb^Gvs, Rb^Gvs, Rb^Gvs, Re^Eff, Re^Eff, Gs, Gs, Rr, Rr, Gs, Rr, Rb, Hhd, Rb, Gs^Vh, Rb, Re, Re, Re, Re, Gs, Rb, Gd^Vh, Gs, Hhd, Hhd, Hhd^Fdf, Gd, Hhd^Edb, Rp, Gs^Edb, Rp^Es, Gs, Rr, Rr, Rr^Edb, Rb^Gvs, Rb^Gvs, Rb^Gvs, Rb^Gvs, Rb^Dr, Rb^Gvs, Ch^Qhux, Ch^Qhux
Rb^Gvs, Rb^Gvs, Rb^Gvs, Rb^Gvs, Rb^Gvs, Rb^Es, Rb^Gvs, Rb^Gvs, Rb^Gvs, Re^Eff, Re^Eff, Gs, Gs, Rr, Re, Rp, Hhd^Qhh, Hhd^Qhh, Hhd^Qhh, Hhd, Hhd, Re, Gs, Gs, Rb^Gvs, Gd, Rb^Gvs, Gd, Hhd, Gll^Qhhf, Gll^Qhhf, Hhd, Hhd, Gd, Gd, Gs, Gs^Eff, Gs^Eff, Rp, Rr, Rr, Rb^Gvs, Rb^Gvs, Rb^Gvs, Ch^Qhux, Rb^Dr, Rb^Edt, Rb
Re^Eff, Rb^Gvs, Re, Rb^Gvs, Rb^Gvs, Rb^Gvs, Re^Gvs, Re^Gvs, Re^Gvs, Rb^Gvs, Rb^Gvs, Re^Eff, Re^Eff, Gs, Gs, Rp, Rr, Hhd^Qhh, Hhd, Hhd^Qhh, Re, Re, Rb^Vh, Rb^Gvs, Rb^Gvs, Rb^Gvs, Rb^Gvs, Gd, Hhd, Hhd^Qhh, Gd, Hhd, Gd, Gd, Gd, Re^Vh, Rb^Gvs, Rb^Gvs, Rb^Gvs, Rp, Rr, Rb^Gvs, Ch^Qhux, Ch^Qhux, Isa, Isa, Isa^Edt, Isa
Gd, Re^Eff, Re^Eff, Re, Re, Rb^Gvs, Rb^Gvs, Rb^Gvs, Rb^Gvs, Re^Gvs, Rb^Gvs, Rb^Gvs, Rb^Gvs, Re^Eff, Re^Eff, Re, Rr, Re, Rp, Re, Re, Re, Rb^Gvs, Rb^Gvs, Rb^Gvs, Re^Gvs, Rb^Gvs, Gd, Gs, Gs, Gs, Gd, Gll^Fmf, Gd, Gll^Fdf, Rb^Gvs, Rb^Gvs, Rb^Gvs, Rb^Gvs, Rb^Gvs, Rp, Rr^Dr, Rr^Dr, Isa^Ebn, Kh, Ch, Ch^Edt, Ch
Gd, Gs, Gd, Re^Eff, Re^Eff, Rb^Gvs, Re^Eff, Re^Gvs, Re^Gvs, Rb^Gvs, Rb^Gvs, Rb^Gvs, Rb^Gvs, Re^Eff, Re^Eff, Gs, Gs^Vh, Rp, Gg^Efm, Rb, Rr, Gs, Rb^Gvs, Rb^Gvs, Rb^Gvs, Re^Gvs, Re^Gvs, Rb^Gvs, Rb^Gvs, Rb^Gvs, Gll^Fdf, Gll^Fdf, Gll^Fdf, Gll^Fdf, Gll^Fdf, Rb^Gvs, Rb^Gvs, Rb^Gvs, Rb^Gvs, Rb^Gvs, Gs^Dr, Rr^Dr, Isa, Kh, Kh, Kh, Ch, Isa
Rb^Gvs, Gd, Gs, Gs, Gs, Re^Eff, Gs, Gs, Rb^Gvs, Re^Gvs, Re^Gvs, Rb^Gvs, Rb^Gvs, Rb^Gvs, Gs, Gs, Gs, Gg^Efm, Gg^Efm, Gg^Efm, Rp, Rr, Re^Eff, Rb^Gvs, Re^Gvs, Rb^Gvs, Re^Gvs, Rb^Gvs, Rb^Gvs, Re^Eff, Re^Eff, Gll^Fmf, Gll^Fdf, Gll^Fmf, Rb^Gvs, Rb^Gvs, Rb^Gvs, Rb^Gvs, Rb^Gvs, Rb^Gvs, Gs^Edt, Ch^Qhux, Isa, Kh, Kh, Ch^Edt, Ch^Ebn, Ch
Rb^Gvs, Rb^Gvs, Rb^Gvs, Gd^Vwm, Rb^Gvs, Rb^Gvs, Rb^Gvs, Gs, Rb^Gvs, Rb^Gvs, Rb^Gvs, Rb^Gvs, Rb^Gvs, Rb^Gvs, Gd, Gs, Gs^Edt, Re^Edt, Re^Ecf, Re, Rr, Rp, Gd^Efm, Re^Eff, Re^Eff, Re^Gvs, Hhd, Rb^Gvs, Gs^Vl, Re^Eff, Gs, Hhd, Hhd^Qhh, Hhd, Hhd, Rb^Gvs, Hhd, Rb^Gvs, Gll^Fdf, Gs^Edt, Gs^Edt, Ch^Qhux, Rb, Isa, Ch, Ch^Edt, Ch^Edt, Isa^Qhh
Rb^Gvs, Rb^Gvs, Re^Es, Rb^Es, Rb^Gvs, Rb^Gvs, Rb^Gvs, Rb^Gvs, Rb^Gvs, Rb^Gvs, Rb^Gvs, Rb^Gvs, Gs, Rb^Gvs, Re^Es, Re^Vh, Isa, Isa^Edt, Isa, Re, Re, Gd, Gs^Efm, Hhd, Hhd^Qhh, Hhd, Hhd^Qhh, Hhd^Fdf, Gll^Fdf, Gll^Fdf, Hhd, Hhd^Qhh, Hhd^Qhh, Hhd^Qhhf, Hhd, Hhd, Gs, Gll^Fmf, Gs, Gs, Ch^Qhux, Ch^Qhux, Rr^Edt, Isa, Ch, Isa, Isa, Isa
Rb^Gvs, Rb^Gvs, Re^Gvs, Re^Gvs, Re^Gvs, Rb^Gvs, Re^Gvs, Re^Gvs, Re^Gvs, Rb^Gvs, Re^Gvs, Gd, Gs, Gs, Isa, Re, Kh, Ch, Ch, Re^Vh, Re, Re, Gll^Fdf, Hhd, Hhd^Qhh, Hhd^Qhh, Hhd^Fdf, Hhd^Fdf, Gs, Gs, Gs^Efm, Hhd, Gll^Fdf, Hhd^Fdf, Gll^Fdf, Hhd, Rb^Gvs, Gs, Gs, Ch^Qhux, Rr^Edt, Rr, Rr, Isa^Edt, Isa^Edt, Isa, Rb, Rr^Vhc
Rb^Gvs, Re^Gvs, Re^Gvs, Re^Gvs, Re^Gvs, Rb^Gvs, Re^Gvs, Re^Gvs, Re^Gvs, Re^Gvs, Re^Eff, Gs, Re, Gs^Edt, Re, Ch^Edt, Isa, Ch^Edt, Isa^Edt, Isa, Rb, Re, Re, Gll^Fdf, Gll^Fdf, Re^Gvs, Gs, Gs^Efm, Gs^Efm, Gs^Efm, Re^Eff, Gs, Gs, Gs, Gs, Gll^Fdf, Rb^Gvs, Rb^Gvs, Rb^Gvs, Ch^Qhux, Rr^Edt, Rb, Isa, Rr, Rb^Edt, Rb, Rr^Vhc, Rb
Rb^Gvs, Re^Gvs, Re^Gvs, Re^Gvs, Re^Gvs, Re^Gvs, Re^Gvs, Re^Gvs, Re^Eff, Re^Eff, Hhd, Re^Wm, Gd^Efm, Gs, Gs, Re, Re^Ecf, Isa, Rb^Edt, Rb^Vh, Rb, Re, Re, Gll^Fdf, Gs, Gll^Fdf, Gs^Edt, Gs, Rb^Eff, Re^Eff, Re^Eff, Re^Es, Re^Gvs, Re, Gll^Fdf, Gs, Rb^Gvs, Rb^Gvs, Rb^Gvs, Ch^Qhux, Ch^Qhux, Rb^Vh, Isa, Isa, Isa^Edt, Isa, Rb, Rr
Gs^Edt, Re^Gvs, Gs, Gs, Gd, Re^Eff, Re^Eff, Re^Eff, Gd^Qhu, Hhd^Qhu, Hhd^Qhu, Gs^Efm, Gs, Gs^Efm, Gd, Re, Rr^Qhu, Re^Edt, Rr^Qhu, Rr^Qhu, Rr, Rr^Edt, Rp^Edt, Re^Edt, Rr, Gs, Gs, Rb^Eff, Rb^Gvs, Rb^Gvs, Rb^Gvs, Re^Gvs, Rb^Gvs, Gll^Fdf, Gll^Fdf, Rb^Gvs, Rb^Gvs, Rb^Gvs, Rb^Gvs, Ch^Qhux, Rb, Isa^Ebn, Rr, Ch, Ch^Edt, Isa, Rr^Vhc, Isa
Gs^Edt, Gs^Edt, Gs^Qhu, Gd^Qhu, Gs^Qhu, Gd^Qhu, Rr^Qhu, Hhd^Qhu, Rr^Edt, Rr, Rr^Es, Rp^Qhu, Rr^Qhu, Rr^Qhu, Rr^Qhu, Rr^Qhu, Rr, Rr^Qhu, Rr, Rr, Rr, Rr, Rr, Rr, Rr, Rr, Rr^Es, Rb, Rb^Gvs, Rb^Gvs, Rb^Gvs, Re^Gvs, Re^Gvs, Rb^Gvs, Rb^Gvs, Rb^Gvs, Rb^Gvs, Re^Dr, Re, Re^Dr, Re^Dr, Re^Vh, Rr, 3 Kh, Rb^Es, Rb, Re^Es, Isa
Rr^Qhu, Gs^Qhu, Rp^Edt, Rr, Rr, Rr, Rr, Rr, Rr, Rr, Rp, Rp, Rp, Rp^Edt, Rp^Edt, Rr, Gs, Gs, Gll^Fdf, Gll^Fdf, Gll^Fdf, Gll^Fdf, Gs, Gs, Gs, Rr, Rr, Rr, Rp, Rb^Gvs, Re^Gvs, Re^Gvs, Rb^Gvs, Re^Gvs, Rb^Gvs, Rb^Gvs, Gd^Eff, Gd^Eff, Gs, Ch^Qhux, Ch^Qhux, Rr, Rb, Ch, Isa, Isa^Es, Isa^Es, Rr
Rr^Qhu, Rp, Rr^Edt, Rp^Edt, Gs, Rr, Gs, Gs, Gs, Gs, Gs, Gs, Gs, Gd, Gd, Gd, Gd, Gd, Gs, Gll^Fdf, Gll^Fdf, Gll^Fdf, Gs, Gll^Fdf, Gll^Fdf, Gd, Ch, Rr, Rr^Edt, Rp, Rr, Re^Gvs, Rb^Gvs, Re^Vh, Gd^Eff, Gd^Eff, Gs, Gs, Gs^Efm, Gs^Edt, Gs^Edt, Ch^Qhux, Xos, Rb, Isa, Isa^Ebn, Rr^Edt, Rr
Rr^Qhu, Rr, Gs, Gs, Gs, Rb^Wm, Rb, Gs, Gd, Gll^Fdf, Gll^Fdf, Gd, Gll^Fdf, Gll^Fdf, Gll^Fdf, Gs, Gs^Efm, Gs, Gll^Fdf, Gll^Fdf, Gll^Fdf, Gs, Rb^Vh, Gll^Fdf, Gs, Gd, Gd, Rp, Rr, Rp^Edt, Rr, Rr, Rr, Rb^Gvs, Rb^Gvs, Gd^Eff, Gs, Gs^Efm, Gs, Gs^Efm, Gs^Edt, Gs^Edt, Rr, Rr^Pr\o, Rr^Pr\o, Rr^Edt, Rb, Rr^Vhc
Gd^Qhu, Gs, Gs, Gs, Rb^Gvs, Rb, Rb^Gvs, Rb, Re^Gvs, Gs, Gs^Vh, Gd, Re^Gvs, Gll^Fdf, Re^Gvs, Rb^Gvs, Rb^Gvs, Rb^Efm, Gs, Gs, Rb^Eff, Rb^Eff, Rb^Gvs, Rb^Gvs, Rb^Gvs, Gs, Re, Gd, Gll^Fdf, Gs^Fdf, Gs, Rr, Gs, Rr, Rr, Rr, Rr^Edt, Rr, Rr, Rr, Re^Edt, Rr, Rr, Rr, Rr^Edt, Rr^Pr\o, Xos, Rb
Gs^Qhu, Gs, Rb, Rb, Rb^Gvs, Rb^Gvs, Re^Gvs, Rb^Gvs, Re^Gvs, Re^Gvs, Rb^Gvs, Re^Gvs, Re^Gvs, Re^Gvs, Rb^Gvs, Rb^Gvs, Rb^Gvs, Rb^Gvs, Re^Eff, Rb^Eff, Re^Gvs, Rb^Gvs, Rb^Gvs, Rb^Gvs, Rb^Gvs, Re, Re, Gd, Gs, Gd, Gd, Gs^Edt, Rr, Rb^Vh, Rb, Rr^Edt, Rr, Rr^Edt, Re, Rr, Rp, Rr, Rr, Re^Edt, Gs^Edt, Gs, Gs^Edt, Ch^Qhux
Gs^Qhu, Rb^_ml, Rb^Gvs, Rb^Gvs, Re^Gvs, Rb^Gvs, Rb^Gvs, Re^Gvs, Re^Gvs, Re^Gvs, Re^Gvs, Re^Ecf, Re^Es, Rb^Gvs, Re^Gvs, Rb^Gvs, Gs^Eff, Gs^Eff, Re, Re^Gvs, Re^Gvs, Re^Gvs, Rb^Gvs, Re, Re, Re, Re^Gvs, Gd, Gd, Gd, Gd^Edt, Gd^Edt, Rr, Rr, Rr^Edt, Rr, Re, Rr, Rb, Rb, Ch, Rr, Gs^Vh, Gll^Fdf, Gll^Fdf, Gs, Gs, Gs
Gs^Qhu, Rb^Gvs, Re^Gvs, Re^Gvs, Re^Gvs, Re^Gvs, Re^Gvs, Re^Gvs, Rb^Gvs, Re^Gvs, Re^Gvs, Re^Gvs, Re^Gvs, Re^Gvs, Re^Gvs, Rb^Gvs, Gd, Gs^Eff, Gd^Eff, Rb^Gvs, Rb^Gvs, Re^Gvs, Re, Re^Wm, Re^Gvs, Re^Gvs, Rb^Gvs, Rb^Gvs, Gd, Re, Ch, Ch, Ch, Rr, Rr, Rr, Gs, Re, Rr, Rb, Rr, Gs, Gs, Gs, Gll^Fmf, Gll^Fdf, Gs, Gs
