Dd^Edt, Hd, Rrd, Dd^Esd, Dd, Ds^Edt, Aa^Esd, Aa, Aa, Aa, Aa, Ds^Edt, Gd^Esd, Gs, Hhd^Esd, Hhd, Hhd^Esd, Gd, Gd, Gd, Hd, Hd, Aa, Aa, Gd, Gd, Gd, Gd, Gd^Dr, Gd, Aa^Esd, Gd, Aa^Esd, Aa^Esd, Aa, Gll^Fdw, Gll^Fdw, Gd, Cer, Gd, Aa, Dd, Gd, Re, Re, Aa^Esd, Aa, Dd, Aa, Aa^Edt
Mdd, Mdd, Hd, Rrd, Rd, Dd, Ds, Aa, Ds^Esd, Aa^Esd, Aa^Esd, Aa, Gd, Hhd^Esd, Gd^Efm, Hhd^Esd, Hhd, Dd^Esd, Dd, Hd, Dd^Esd, Hd^Esd, Aa, Aa, Hd, Ds, Gd^Esd, Gs, Gd, Gs, Gs^Dr, Aa, Aa, Aa^Esd, Aa, Gll^Fdw, Aa, Aa, Cer, Cer, Re, Rb, Rb^Ecf, Re^Vct, Re, Gd, Cer, Cer, Aa, Aa
Mdd, Mdd, Hd, Ds, Rd, Ds, Dd, Gd, Ds^Esd, Ds^Esd, Hd, Dd, Aa, Gd^Efm, Gd^Efm, Gd^Efm, Gd^Efm, Gd^Efm, Gd^Efm, Dd, Aa, Aa, Aa^Efm, Aa, Aa, Hd^Esd, Ds^Esd, Gd, Gd^Esd, Gd^Dr, Gd^Esd, Aa, Aa, Aa, Aa, Aa, Aa, Aa, Aa, Aa, Re, Rb, Re, Re, Aa, Cer, Aa, Ker, Cer, Aa
Hd, Hd, Ds^Esd, Ds, Ds, Rd, Rrd, Dd, Dd, Ds, Hd, Gd, Gd, Aa, Aa, Aa, Aa, Gs^Efm, Aa, Aa, Aa, Aa, Ha, Aa, Aa, Aa, Gll^Fdw, Gd^Esd, Gd, Gd^Esd, Gd, Gll^Fdw, Gll^Fdw, Gll^Fdw, Gll^Fdw, Dd, Dd, Aa, Gd, Re, Gd, Re^Vct, Re, Aa, Gd, Aa, Aa, Cer, Cer, Dd
Ds, Ds, Dd, Ds^Vdr, Ds^Esd, Dd, Dd, Ds, Dd, Gd, Hd, Gd, Gd, Dd, Aa, Aa, Aa^Esd, Aa^Esd, Aa, Aa, Ha^Esd, Ha^Esd, Hhd, Aa, Aa, Gll^Fdw, Gll^Fdw, Gd, Gs, Dd, Gd, Gs, Gll^Fdw, Gll^Fdw, Gll^Fdw, Gll^Fdw, Gd, Gd, Dd, Rb, Rb^Esd, Cer, Ker, Cer, Gd, Cer, Ds, Aa, Ds, Dd
Ds, Dd, Hd, Dd, Ds^Edt, Ds^Esd, Ds, Dd, Hd, Ds, Mdd, Hd, Ds, Gd, Aa, Aa, Aa, Aa, Aa^Esd, Aa^Esd, Aa, Ha, Ds, Hd, Ds, Gd, Gd, Gs, Gd, Gd, Gd, Gll^Fdw, Gd, Gll^Fdw, Gs, Gd, Gd, Gd^Efm, Gd^Efm, Gd, Re, Gd, Cer, Cer, Gd, Ds, Ds, Gd, Cer, Cer
Dd, Dd, Dd, Hd, Ds, Ds^Edt, Ds, Rd, Hd, Hd^Esd, Ds, Hd, Gd, Ds, Ds^Esd, Dd^Esd, Ds, Rd, Ai^Do, Aa, Dd^Ftd, Aa, Hd^Em, Hd^Dr, Ds, Gd, Gs, Dd, Gd, Gll^Fdw, Aa, Gd^Esd, Aa, Aa, Aa, Gd^Efm, Gd^Efm, Gd^Efm, Rb, Re, Gs^Efm, Gd^Efm, Aa, Gd, Aa, Aa^Esd, Aa, Aa, Aa, Cer
Aa, Aa, Aa, Aa, Aa, Aa, Aa, Rd, Rrd, Dd, Ds^Dr, Dd, Dd, Dd, Ai^Do, Ds^Esd, Ds, Dd, Hd, Dd, Ai, Dd, Dd, Hd, Gd, Gd, Aa^Esd, Gs^Esd, Gd, Aa, Aa, Aa^Esd, Aa^Esd, Aa^Esd, Dd, Dd, Dd, Gd, Rb, Rb, Aa^Efm, Aa^Efm, Aa, Aa, Aa, Aa, Aa, Aa, Aa, Aa
Dd, Dd, Dd, Aa, Aa, Aa, Aa, Ds, Ds, Rrd, Ds, Ds, Dd, Aa, Aa, Ds^Edt, Dd, Dd, Dd, Hd, Ai, Ai, Dd^Ftd, Dd, Gd^Esd, Aa, Aa, Aa, Aa, Gll^Fdw, Aa, Aa, Aa, Gd, Gll^Fdw, Gd, Gd, Gs, Gs, Aa^Efm, Aa^Efm, Aa, Aa^Esd, Aa, Ds, Ds^Vdr, Aa, Aa, Aa, Aa
Dd, Ha, Ha, Aa, Aa, Aa, Dd, Dd, Ds^Vdr, Ds, Ds, Rd, Rd, Rd, Aa, Dd, Aa^Esd, Aa, Dd^Esd, Hd^Ftd, Dd^Ftd, Gd, Dd, Ds^Esd, Dd, Dd, Dd, Aa, Aa, Aa, Aa, Dd, Aa, Gd, Gd, Gll^Fdw, Rb, Rb, Gs, Gd, Gd, Gd, Gd, Ds^Esd, Gd, Gd^Esd, Gd^Esd, Aa, Dd, Aa
Aa^Esd, Aa, Aa, Aa, Aa, Aa, Aa, Dd^Esd, Hd^Esd, Ds, Ds^Esd, Ds^Esd, Hd, Rd, Dd, Aa, Dd, Dd, Dd, Dd, Dd^Do, Dd, Dd, Ds^Fdw, Dd, Dd, Dd^Dr, Dd, Dd^Fdw, Aa, Hd, Gd, Gll^Fdw, Aa, Dd, Gs, Rb, Gs, Gd, Gs^Esd, Gs^Dr, Gd^Dr, Gd, Gd, Gs, Gd, Gd, Dd^Esd, Gll^Fdw, Gd
Dd, Aa, Aa, Aa, Aa^Edt, Aa, Dd, Aa, Ha, Ds, Ds^Edt, Hd^Edt, Hd, Hd, Ds, Dd, Dd, Hd, Hd, Dd, Ds, Ds, Co, Aa, Aa^Edt, Aa, Aa, Aa, Aa, Hd, Ds, Gd, Gd, Gd, Re^Edt, Rb, Gd, Gd, Gd, Gd, Gd, Gs, Aa, Aa, Gs^Efm, Gd, Gd^Efm, Aa, Aa, Gd^Esd
Hd, Dd, Dd, Aa^Esd, Aa, Dd^Edt, Aa, Dd, Aa, Hd, Co, Co, Co, Hd, Ds^Vdr, Ds^Edt, Aa, Ds^Vdr, Dd, Dd^Esd, Dd, Ds, Co, Co, Aa^Edt, Aa, Ha, Aa, Aa^Edt, Aa, Co, Co, Co^Edt, Gd, Re, Re^Edt, Gd, Co, Co^Edt, Aa^Edt, Aa, Aa, Aa, Aa^Efm, Aa, Aa^Efm, Aa, Aa, Aa, Aa
Dd, Hd, Dd^Esd, Aa, Ds, Aa, Aa, Hd, Hd, Dd^Edt, Co, Ko, Gd, Co^Edt, Gd, Rrd, Rrd, Aa, Aa, Aa^Esd, Aa, Co, Ds, Urb^Qhu, Urb^Qhu, Co^Edt, Co^Dr, Co, Co^Edt, Gd, Urb^Qhu, Ko, Co, Gd, Urb^Qhu, Re, Urb^Qhu, Gd^Vo, Co^Edt, Aa^Dr, Aa, Aa^Efm, Aa, Aa, Aa, Aa, Aa, Aa, Aa, Aa
Dd, Dd, Dd^Esd, Dd, Dd, Ds, Dd, Dd, Gd, Urb^Qhu, Urb^Qhu, Urb^Qhu, Rb, Re, Re, Gd^Vo, Ds, Rd, Aa^Edt, Aa, Dd, Aa^Edt, Co, Co, Urb^Qhu, Co, Urb^Qhu, Gd^Vo, Re^Vo, Urb^Qhu, Urb^Qhu, Co, Gd, Co, Urb^Qhu, Urb^Qhu, Rb^Edt, Rb, Urb^Qhu, Urb^Qhu, Aa, Aa, Aa^Esd, Aa^Esd, Aa, Aa, Aa, Aa^Esd, Aa, Aa
Rd, Dd, Ds, Dd, Ds^Esd, Ds^Esd, Dd^Esd, Ds, Gd^Edt, Rb^Vo, Rb, Urb^Qhu, Gd, Re, Re^Edt, Re, Gd, Rd, Rb, Aa, Co, Co^Edt, Co, Gd^Vo, Gd, Urb^Qhu, Urb^Qhu, Re, Rb^Edt, Urb^Qhu, Rb^Vo, Ur^Edt, Ur, Urb^Qhu, Urb^Qhu, Re^Ecf, Re, Urb^Qhu, Urb^Qhu, Co^Edt, Co^Edt, Aa, Aa, Aa, Aa, Aa, Aa, Aa, Aa, Aa
Dd, Ds, Ds, Ds, Dd^Esd, Ds^Esd, Co, Dd^Ftd, Dd^Ftd, Dd, Dd, Hd, Hd^Edt, Gd, Re, Rb^Edt, Rb, Rb^Ecf, Rb, Rb, Gd, Gd, Urb^Qhu, Co, Ko, Co, Rb, Rb, Urb^Qhu, Ur^Dr, Ur^Dr, Ur, Ur, Co, Co, Ur, Ur, Ur, Co, Co^Edt, Gd^Vhr, Aa, Aa, Aa, Aa, Aa, Aa, Aa, Aa, Aa
Dd, Dd, Dd, Dd^Esd, Dd^Esd, Dd^Esd, Co, Hd^Em, Wwg, Wwg, Wwg, Dd^Em, Dd^Ftd, Ds, Co^Edt, Co, Gd^Vo, Rb, Gd, Urb^Qhu, Urb^Qhu, Urb^Qhu, Urb^Qhu, Co, Co, Gd, Urb^Qhu, Urb^Qhu, Urb^Qhu, Ur^Dr, Qxu, Qxu^Qhh, Qxu, Ur, Co, Co^Dr, Ur, Gd, Gd, Gd, Aa, Aa, Aa, Aa, Aa, Aa, Aa^Esd, Aa, Gd^Esd, Aa
Rd, Dd, Dd, Dd, Dd, Co^Edt, Co^Edt, Wwg, Wog, Wog, Wwg, Dd^Ftd, Dd^Ftd, Co^Dr, Ko, Ko, Co^Edt, Urb^Qhu, Re, Gd, Gd^Edt, Ur^Qhh, Urb^Qhu, Urb^Qhu, Gd, Gd, Gd^Vo, Urb^Qhu, Ur, Ur, Qxu, Qxua^Qhux, Qxu, Ur^Edt, Ur^Edt, Gd^Vo, Ds^Edt, Co, Co, Gd, Ds^Esd, Gd^Esd, Dd^Esd, Gd, Aa^Esd, Aa, Gs^Dr, Gs, Aa^Dr, Gd^Dr
Aa, Dd, Aa, Dd, Dd, Hd, Hd^Ftd, Dd^Ftd, Wwg, Wog, Wog, Wwg, Dd, Co, Dd, Ko, Co^Edt, Co^Edt, Rb, Rb^Vo, Re^Edt, Re, Rb, Rb, Re^Ecf, Rb^Edt, Co^Edt, Co, Urb^Qhu, Ur, Ur, Qxu^Qhh, Ur, Ur, Urb^Qhu, Ds^Edt, Dd, Co, Gd, Aa, Aa, Aa, Aa^Esd, Gd, Aa^Esd, Aa, Gs, Gd, Aa, Aa^Dr
Aa^Esd, Aa, Aa, Ds, Dd, Dd, Dd, Dd^Ftd, Dd^Em, Wwg, Wwg, Wwg, Dd^Edt, Hd, Hd^Edt, Hd, Hd, Dd, Gd^Vo, Rb^Edt, Gd, Urb^Qhu, Urb^Qhu, Re, Re, Re^Edt, Urb^Qhu, Co, Urb^Qhu, Urb^Qhu, Gd, Ur, Ur, Urb^Qhu, Urb^Qhu, Gd, Dd, Dd^Edt, Aa^Edt, Aa, Dd, Aa, Aa, Aa^Esd, Aa, Gd, Gd, Gd^Dr, Gd, Gd
Aa^Edt, Aa^Edt, Aa, Ds, Ds, Dd, Dd^Edt, Co^Edt, Co^Dr, Dd^Ftd, Hd^Ftd, Ds, Ds^Edt, Hd, Hd, Dd, Co^Dr, Co^Edt, Rd, Gd^Vo, Co, Urb^Qhu, Gd, Co, Gd, Urb^Qhu, Urb^Qhu, Urb^Qhu, Rrd, Urb^Qhu, Co, Ur^Vo, Rb^Vo, Co, Co^Dr, Gd, Gd, Dd^Edt, Dd^Edt, Aa, Gd^Efm, Gd, Gd, Aa, Gd, Gll^Fdw, Ds, Gs, Gd, Gd
Aa, Dd, Aa, Aa, Aa, Ds, Ds^Edt, Ds^Edt, Dd, Dd^Ftd, Hd^Em, Ds^Vdr, Dd, Hd, Hd^Vdr, Dd, Dd, Co^Edt, Ds, Dd^Edt, Dd, Co, Ko, Gd^Vo, Co^Edt, Co^Edt, Aa, Rrd^Edt, Aa^Esd, Rrd, Ds^Esd, Co, Co, Co^Edt, Dd^Edt, Gd, Dd, Gd, Dd, Gd, Gd^Efm, Gs^Efm, Gd^Efm, Gs, Gd, Gd, Dd^Esd, Ds^Esd, Ds, Ds
Aa, Aa, Aa^Esd, Aa, Ds, Ds, Ds, Dd, Dd, Dd, Aa, Dd, Aa, Aa, Aa, Hd, Dd^Esd, Rrd, Ds^Edt, Dd^Edt, Gd, Co^Edt, Ds, Dd, Coa, Aa, Aa, Aa, Aa^Esd, Aa^Esd, Dd^Vdr, Dd^Dr, Dd, Dd, Dd^Vdr, Dd, Gd, Gs, Gs, Gs^Efm, Gd^Efm, Gs^Efm, Gs^Efm, Gd, Gs, Dd, Dd^Esd, Dd^Esd, Aa, Ds
Ds^Dr, Ds, Ds^Esd, Ds^Esd, Ds, Ds, Dd, Ds, Ds, Hd, Hd^Esd, Aa, Dd^Do, Aa, Rd, Rd, Rd, Dd^Edt, Dd, Ds, Gd, Ds^Dr, Aa, Aa, Aa, Aa, Aa, Aa, Aa, Aa^Esd, Dd, Dd, Ds, Ds^Edt, Ds, Gd, Dd^Edt, Gd, Dd^Edt, Gd^Efm, Gd, Gd, Gs^Efm, Gs, Gd^Esd, Gd, Gd, Aa^Esd, Ds^Esd, Ds
Hd^Dr, Ds^Dr, Ds, Ds, Ds^Dr, Ds^Esd, Ds^Esd, Dd, Dd, Dd, Aa, Aa, Dd, Dd, Dd, Dd, Gd, Gd, Gs, Ds^Esd, Dd^Esd, Ds^Vdr, Dd^Edt, Ds^Edt, Ds, Aa, Dd, Ds, Aa, Dd, Hd, Gd, Dd, Gd, Ds, Gd, Dd, Dd^Edt, Dd, Gd, Gd, Gd^Esd, Gs, Gd^Efm, Gd^Efm, Gd^Esd, Gd, Gd, Ds^Esd, Gd
Hd, Dd, Dd, Ds, Ds, Ds^Edt, Ds^Edt, Ds, Dd, Dd, Dd^Esd, Dd^Esd, Dd, Rrd, Dd, Ds, Ds, Gs, Gs, Ds^Esd, Ds, Dd, Dd, Dd, Ds, Ds, Dd, Ds, Ds, Dd, Dd, Hd, Dd^Esd, Ds, Ds, Dd^Vdr, Dd^Edt, Dd, Gd, Gd, Gd, Gd^Esd, Gs^Esd, Gs^Efm, Gd^Efm, Gd, Ds, Ds, Gs, Gd
Dd, Hd, Hd, Dd, Dd, Ds, Ds, Ds, Ds, Dd, Dd, Ds^Vdr, Dd, Rrd, Dd, Ds, Ds, Ds, Hd, Ds, Gd, Dd, Gd, Dd, Ds^Fdw, Dd^Esd, Dd^Edt, Ds, Rrd, Gd, Gd, Dd, Dd^Esd, Gd, Dd, Ds, Dd^Edt, Dd^Edt, Gd, Dd, Dd, Dd, Gd, Gd, Gd, Gd^Vhr, Gs, Gd, Gd, Gs
Dd, Dd, Hd, Hd, Hd, Dd, Ds, Ds, Rrd, Ds, Ds, Ds, Rd, Dd, Dd, Dd^Dr, Dd, Ds, Gd, Hd^Esd, Gd, Gd, Gd^Esd, Gll^Fdw, Gd, Dd^Edt, Dd, Dd, Ds, Rrd, Rd, Dd, Gd, Gd^Esd, Gd, Gd, Gd, Gs, Ds, Dd, Dd, Gd, Gs, Gs, Gd, Gd, Gd, Gs^Dr, Dd, Gs
Dd, Dd^Vdr, Dd, Dd, Aa, Dd, Rd, Rd, Dd, Rrd, Rrd, Rd, Ds, Dd, Dd, Ds^Esd, Ds, Gd, Gd, Dd, Gs, Gs, Gs, Gd^Esd, Gll^Fdw, Gd, Dd, Gd, Gll^Fdw, Gd, Dd, Gd, Gs^Esd, Ds, Gd^Esd, Gs^Esd, Aa, Aa, Aa, Gd, Dd, Aa, Gs^Esd, Gd^Esd, Dd, Dd, Dd, Dd, Gs, Rd
Aa, Dd, Aa, Dd, Aa, Dd, Rd, Dd, Dd^Esd, Ds, Ds, Ds, Gs^Dr, Gs, Gd^Esd, Aa, Aa^Esd, Gs^Esd, Gll^Fdw, Gll^Fdw, Gll^Fdw, Gs, Dd, Gd, Gll^Fdw, Gll^Fdw, Gs^Efm, Gs, Gs^Efm, Gs, Gd, Gd^Dr, Gs^Efm, Gd, Gs, Aa, Dd, Aa, Aa, Gs, Aa, Aa^Esd, Aa^Esd, Aa^Esd, Gd, Dd, Aa, Dd, Gs, Ds
Aa, Aa, Aa, Aa, Dd, Rd, Dd, Dd, Dd, Hd^Esd, Ds, Ds^Esd, Gd, Gs^Dr, Gd, Aa, Gs, Aa, Aa, Gll^Fdw, Gd, Gd, Gd, Dd, Gd, Gll^Fdw, Gs^Efm, Gd^Efm, Gd^Efm, Gs^Efm, Gd^Dr, Gd, Gd, Gs^Efm, Gd, Gs, Gd, Dd, Gd, Aa, Rd, Aa, Dd, Aa, Ds, Dd, Dd, Ds, Ds, Ds
