Aa, Aa, Ha, Aa, Ha, Aa, Aa, Aa, Ha, Aa, Ha^Fpa, Aa^Fpa, Ha^Fpa, Ha, Ms, Ms, Ms, Ms, Ha^Fpa, Ha, Ha^Fpa, Aa, Aa, Aa, Aa, Ha, Ha, Aa, Aa, Aa, Ha^Es, Ms, Ms, Ms, Ms, Ms, Ha
Ha, Ha, Ha, Ha, Ha, Ha, Aa, Aa, Aa, Ha, Aa, Ha^Fma, Ha^Fma, Ha^Fpa, Aa, Ha, Ha, Ha^Fpa, Aa, Ha^Fpa, Aa^Fpa, Ha^Fpa, Ha, Aa, Ha, Aa^Esa, Aa, Ha, Ha, Aa, Ha, Ha^Esa, Ha, Ha, Ha^Edb, Ha^Esa, Ha
Aa, Ha^Esa, Ha^Esa, Aa, Ha, Ha, Ha^Fma, Aa, Ha, Aa, Aa, Aa^Fpa, Aa^Esa, Ha, Ha, Ha, Aa, Ha^Esa, Aa, Aa, Aa^Feta, Ha^Fpa, Ha^Fpa, Ha^Qhh, Ha^Es, Ms, Ms, Ha^Es, Ms, Ha, Ha^Edb, Aa, Ha, Ha^Edb, Ha^Edb, Ha, Ms
Aa, Aa, Ha, Ha, Ha, Ha^Fma, Ha^Fma, Ha^Fpa, Ha^Fpa, Ha, Ha, Aa, Aa, Aa^Esa, Aa, Aa, Ha, Aa, Ha^Fma, Aa^Fpa, Aa^Fpa, Aa^Fpa, Aa, Aa^Fpa, Ha^Qhh, Ms, Ms, Ms, Ms, Ms, Ha^Esa, Ha^Esa, Ha^Edb, Ha^Esa, Ha^Esa, Ha, Ha
Aa, Aa^Esa, Aa, Ha, Ha, Ha, Aa, Ha^Fpa, Aa, Ha, Ha, Hhd, Hhd^Vhhr, Gd, Aa, Aa, Aa^Fpa, Ha^Fma, Ha^Fma, Ha^Fpa, Aa^Fpa, Aa^Fpa, Aa^Fpa, Aa^Fpa, Ha^Qhh, Ha, Ms, Ms, Ms, Ms, Ms, Ha, Ms, Ha, Ha, Ha^Es, Ms
Ha, Aa, Aa, Aa, Aa, Ha, Ha, Ha, Ha, Aa, Ha, Ha, Aa, Ha, Aa, Aa, Aa^Fpa, Ha^Fpa, Aa, Aa, Aa^Fpa, Aa^Fpa, Ha, Ha, Ha^Vca, Ha^Qhh, Ha^Qhhf, Ha, Ha^Qhhf, Ms, Ms, Ms, Ms^Xm, Ms, Ms, Ms, Ms
Ha^Fpa, Ha^Fma, Ha, Ha, Aa, Ha^Vca, Ha, Ha, Ha, Aa, Ha, Ha, Ha^Fma, Ha^Fpa, Aa, Aa^Fpa, Ai^Qhu, Ai^Qhu, Ai^Qhu, Ai^Qhu, Ai^Qhu, Aa^Fpa, Aa, Aa, Aa, Ha^Fma, Ha, Ha^Qhhf, Ha^Fma, Ms^Qhh, Ms, Ms, Ms, Ms, Ms, Ms^Xm, Ms
Aa, Ha^Fma, Ha^Fma, Ha, Ha, Aa, Aa, Aa, Aa, Aa, Aa^Fma, Ha, Aa, Aa^Esa, Aa, Aa, Ai^Qhu, Ai, Ai, Ai^Esa, Ai, Ai^Qhu, Ai^Qhu, Ai^Qhu, Ai^Qhu, Aa, Aa, Aa, Aa, Ha^Qhh, Ha, Ms, Ha^Vca, Ms^_mh, Ha, Ms, Ms
Aa^Fpa, Aa, Aa, Ha, Ha, Ha^Esa, Ha, Ha, Ha, Aa, Aa^Fma, Aa^Fma, Aa^Fma, Aa, Ha, Aa, Ha, Ha^Qhu, Ha^Qhu, Ai, Ha^Fma, Ai, Ai^Esa, Ai^_ml, Ai^Qhu, Ai^Qhu, Aa, Ha, Ha, Ha^Qhh, Ha^Qhh, Ha^Qhh, Ha^Qhh, Ha^Fma, Ms, Ms, Ms
Aa, Aa^Fpa, Aa^Fpa, Ha, Aa, Aa^Esa, Aa, Ha, Hhd^Es, Aa, Aa, Aa^Fma, Aa^Fma, Aa^Vha, Ha, Ha, Hh, Ha, Ha, Ha^Qhu, Ha^Qhu, Ha^Fma, Ha^Fpa, Ai, Ai^Qhu, Aa, Ha, Ha, Ha^Fma, Ha^Fma, Ha, Ha, Aa, Ha^Qhhf, Ms^Xm, Ms, Ms^Qhh
Re, Aa^Fpa, Aa, Aa, Aa^Esa, Aa^Esa, Aa, Aa, Aa, Gs^Fmw, Aa^Fma, Aa, Gd^Es, Aa^Fma, Aa^Fma, Gs^Fmw, Aa, Ha, Ha, Ha, Ha^Qhu, Ha^Fpa, Ha^Fpa, Ai^Esa, Ai^Qhu, Aa, Aa, Ha^Fma, Ha^Fpa, Ha^Fma, Aa^Fpa, Aa^Fpa, Aa^Feta, Ha^Qhhf, Ha^Fma, Ha, Ms^Qhh
Aa, Re^Es, Aa, Aa, Rb, Aa^Esa, Re, Aa, Aa, Aa, Aa^Fma, Aa, Aa, Aa^Fma, Aa, Gs, Gs^Es, Gs^Efm, Aa^Qhu, Aa^Qhu, Aa^Fpa, Ha, Ha^Fpa, Ha^Fpa, Aa^Qhu, Ai^Qhu, Aa^Fma, Aa^Fpa, Aa^Fma, Aa, Aa, Aa^Fpa, Ha^Qhhf, Aa^Qhhf, Ms, Ha, Aa^Qhh
Aa^Es, Aa, Aa^Fpa, Rb, Aa, Aa, Rb^Es, Re^Es, Re, Aa, Aa, Aa, Gs, Aa^Fma, Aa, Aa, Re, Aa, Aa^Qhu, Rb, Rb^Qhu, Rb^Qhu, Aa^Qhu, Ha^Qhu, Aa, Aa^Fma, Aa^Vca, Aa^Esa, Aa, Ha, Aa, Ha, Ha^Qhhf, Ha^Fpa, Ms, Ms^Xm, Ms^Qhh
Aa^Fpa, Aa, Aa^Fpa, Aa^Fpa, Aa, Aa, Aa, Rb, Aa, Re, Aa, Gd, Gs^Esa, Aa, Aa, Aa, Gd, Ce, Ce^Qhu, Aa, Aa^Qhu, Aa, Aa, Aa, Aa^Fpa, Aa, Ha, Aa, Ha^Qhh, Aa, Ha^Qhh, Ms^Qhh, Ms, Ha^Fpa, Ms^Xm, Ms, Ms^Qhh
Aa, Aa^Fpa, Aa, Aa^Fpa, Ha^Fpa, Aa^Esa, Aa, Aa^Esa, Aa^Esa, Aa, Gs^Efm, Rb, Aa, Aa, Aa, Gd^Ecf, Rb, Ket^Qhu, Rb^Vct, Rb, Aa^Qhu, Gd, Aa, Aa, Aa^Fma, Aa^Fpa, Ha^Qhhf, Ha^Qhh, Ms, Ha^Qhh, Ms, Ms, Ms, Ms, Ms, Ms^Xm, Ms^Qhh
Gd, Aa, Aa^Fpa, Aa^Fpa, Aa, Ha^Fpa, Ha, Hhd, Aa, Aa, Gs, Aa, Aa, Re, Aa, Rb, Re^Es, Aa, Aa^Esa, Rb^Qhu, Aa, Ha, Ha, Ha, Ha, Ha^Qhhf, Ha^Fma, Ms, Ha, Ms^Xm, Ms^Xm, Ms^Xm, Ms^Xm, Ha, Ms, Ms, Ms^Qhh
Gd, Gll^Fp, Aa^Fpa, Aa, Aa, Hhd, Ha, Hhd, Aa, Aa^Fpa, Aa, Gd^Efm, Aa, Gs, Aa, Aa, Aa, Aa, Aa, Aa, Aa, Aa^Es, Aa, Ha^Esa, Ha, Ha^Qhh, Ha^Qhh, Ms, Ms, Ha, Ha, Ms^Xm, Ha, Ms, Ms, Ms^Xm, Ms^Qhh
Aa^Esa, Aa, Aa, Aa, Aa^Fpa, Aa, Ha^Vca, Ha, Ha^Qhu, Aa^Fpa, Aa, Aa, Aa, Ha^Fpa, Hh, Aa^Esa, Hh^Qhh, Gs, Aa^Fma, Re, Aa, Rb^Es, Rb, Ha^Es, Ha, Aa, Ha, Ms^Qhh, Ha^Qhh, Ms^Xm, Ms, Ms^Xm, Ms^Xm, Ha, Ms^Xm, Ms^Xm, Ms^Qhh
Ha^Fpa, Aa, Ha^Fpa, Aa, Aa^Fpa, Aa, Aa, Aa, Ha^Qhu, Aa, Aa^Qhu, Gs^Es, Aa^Fma, Ha^Fpa, Ha^Qhh, Ha^Qhh, Ms^Xm, Ha^Qhhf, Ha^Qhhf, Re, Aa, Aa, Aa^Esa, Aa, Aa, Aa, Re, Aa^Vaa, Ha^Qhh, Ms, Ms^Qhh, Ms, Ha, Ms, Ms^Xm, Ms^Xm, Ms^Qhh
Ha, Ha, Ha^Fpa, Ha^Fpa, Aa^Fpa, Aa^Es, Aa, Aa, Aa, Aa^Qhu, Aa, Aa, Aa, Aa, Ha^Qhh, Ms, Ms, Ms, Ms, Ha^Qhh, Ha^Qhh, Aa, Aa, Aa^Esa, Re, Re^Es, Re, Ha, Ha, Ha^Qhhf, Aa^Fpa, Ha^Qhhf, Ms^Qhh, Ms^Xm, Ms, Ha^Fpa, Ha^Qhhf
Aa, Aa, Ha^Fpa, Ha^Feta, Ha^Fpa, Ha, Aa, Aa, Aa, Aa, Aa, Aa^Esa, Aa^Esa, Ha^Qhh, Ha^Qhh, Ha^Qhh, Ms, Ms^_mh, Ms^Fma, Ms, Ha^Qhh, Hhd, Gs, Aa, Aa, Aa, Aa^Esa, Aa, Re, Aa^Fpa, Aa^Fpa, Ha^Fpa, Ms^Qhh, Ms, Ms, Ms, Ms^Qhh
Ha^Qhuf, Ha^Qhuf, Ha^Qhu, Ha^Qhuf, Ha^Qhuf, Ha^Qhu, Ha^Qhu, Aa, Ha^Qhu, Ha, Ha^Qhu, Aa, Aa^Esa, Aa, Aa, Ha^Qhh, Ha^Qhh, Ha^Qhhf, Ha^Qhhf, Ha^Qhh, Aa, Gd, Hh^Qhu, Gs, Ha^Qhu, Ha^Esa, Ha^Qhu, Ha, Re, Aa, Aa, Ha^Qhh, Ms^Xm, Ha^Vca, Ha, Ms, Ms^Qhh
Ms^Xm, Ms^Xm, Ms^Xm, Ms, Ha, Ha, Ha^Esa, Ha^Qhu, Ms, Ha^Qhu, Ha^Esa, Aa^Qhu, Aa^Esa, Aa^Vha, Aa, Aa, Aa, Aa, Ha, Aa^Fpa, Ha^Qhuf, Ha^Qhuf, Ms^Xm, Ha^Qhu, Ms, Ms^Qhu, Ha, Ha^Qhu, Aa, Rb^Es, Rb, Ms^Qhh, Ms^Qhh, Ms^Qhh, Ms^Qhh, Ms^Xm, Ms^Qhh
Ms, Ms, Ha, Ms, Ha, Ha^Esa, Aa, Ha, Uhe^Edb, Ms^Xm, Ms^Xm, Ha^Qhu, Ha^Qhu, Aa, Aa^Fpa, Gs, Aa, Ha^Fpa, Ha^Qhu, Ha^Qhu, Ms, Ms, Ms, Ms, Ha^Fma, Ha, Ms, Ha^Qhu, Ha^Qhu, Rb, Aa, Rb, Aa^Esa, Ha, Ms^Xm, Ha^Qhh, Ha^Qhh
Ms, Ms, Ms, Ha, Aa^Esa, Uue^Esa, Aa^Edb, Aa, Aa^Edb, Uhe^Edb, Ms^Xm, Ms, Ha, Aa^Qhu, Aa^Fpa, Aa^Fpa, Ha^Qhuf, Ha^Qhuf, Ms^Esa, Ms, Ha^Vhhr, Ms, Ha, Aa, Ha^Fma, Ha, Ms, Ms^Xm, Ms^Qhu, Aa, Ha^Fpa, Aa, Ha^Esa, Aa^Esa, Uue^Edb, Ms^Xm, Xur
Ms, Ms, Ms, Ha, Uue, Uue^Edb, Aa^Edb, Aa^Edb, Ha, Ms, Ms^Xm, Ms^Xm, Ms, Aa^Qhu, Ha^Qhuf, Ha^Qhuf, Ms, Ha^Fma, Ms, Ms, Md, Hhd, Hh, Ha, Md, Ms, Ha, Ms, Ms, Ms^Qhu, Ms^Qhu, Ha^Fpa, Ms, Ha^Edb, Uu, Uhe^Qhh, Xur
Ha, Ms, Ms, Ms, Ms, Ha^Edb, Uue^Esa, Uue, Ha, Ms, Ms^Xm, Ha, Ms^Xm, Ha, Ha^_ml, Ha^Fpa, Ms, Ms, Ms, Ms, Hh, Hh, Ms, Md, Ms, Md, Ms, Ms, Ms^Xm, Ms^Xm, Ms^Xm, Ms^Qhu, Xur, Xur, Xur, Uue^Edb, Uhe^Qhh
