Aa, Aa, Ha, Hhd, Hhd, Aa, Gd, Gd, Ha, Aa, Ha^Fpa, Aa^Fpa, Ha^Fpa, Ha, Ms, Ms, Ms, Ms, Ha^Fpa, Ha, Ha^Fpa, Aa, Aa, Aa, Aa, Ha, Ha, Aa, Aa, Aa, Ha^Es, Ms, Ms, Ms, Ms, Ms, Ha
Ha, Ha, Ha, Ha, Ha, Hhd, Gd, Gd, Aa, Ha, Aa, Ha^Fma, Ha^Fma, Ha^Fpa, Aa, Ha, Ha, Ha^Fpa, Aa, Ha^Fpa, Aa^Fpa, Ha^Fpa, Ha, Aa, Ha, Aa^Esa, Aa, Ha, Ha, Aa, Ha, Ha^Esa, Ha, Ha, Ha^Edb, Ha^Esa, Ha
Gs, Ha^Esa, Ha^Esa, Aa, Ha, Ha, Ha^Fma, Aa, Ha, Aa, Aa, Aa^Fpa, Aa^Esa, Ha, Ha, Ha, Aa, Ha^Esa, Aa, Aa, Aa^Feta, Ha^Fpa, Ha^Fpa, Ha^Qhh, Ha^Es, Ms, Ms, Ha^Es, Ms, Ha, Ha^Edb, Aa, Ha, Ha^Edb, Ha^Edb, Ha, Ms
Gs, Gs, Hhd, Hhd, Hhd, Ha^Fma, Ha^Fma, Ha^Fpa, Ha^Fpa, Ha, Ha, Aa, Aa, Aa^Esa, Aa, Aa, Ha, Aa, Ha^Fma, Aa^Fpa, Aa^Fpa, Aa^Fpa, Aa, Aa^Fpa, Ha^Qhh, Ms, Ms, Ms, Ms, Ms, Ha^Esa, Ha^Esa, Ha^Edb, Ha^Esa, Ha^Esa, Ha, Ha
Gd, Gd^Esa, Gd, Hhd, Ha, Ha, Aa, Ha^Fpa, Aa, Ha, Hh, Hhd, Hhd^Vhhr, Gd, Gd, Aa, Aa^Fpa, Ha^Fma, Ha^Fma, Ha^Fpa, Aa^Fpa, Aa^Fpa, Aa^Fpa, Aa^Fpa, Ha^Qhh, Ha, Ms, Ms, Ms, Ms, Ms, Ha, Ms, Ha, Ha, Ha^Es, Ms
Ha, Gd, Aa, Aa, Aa, Ha, Ha, Hh, Hh, Aa, Hh, Hh, Aa, Ha, Aa, Aa, Aa^Fpa, Ha^Fpa, Aa, Aa, Aa^Fpa, Aa^Fpa, Ha, Ha, Ha^Vca, Ha^Qhh, Ha^Qhhf, Ha, Ha^Qhhf, Ms, Ms, Ms, Ms^Xm, Ms, Ms, Ms, Ms
Ha^Fpa, Ha^Fma, Ha, Ha, Aa, Ha^Vca, Ha, Hh, Ha, Aa, Ha, Hh, Ha^Fma, Ha^Fpa, Gs, Aa^Fpa, Ai^Qhu, Ai^Qhu, Ai^Qhu, Ai^Qhu, Ai^Qhu, Aa^Fpa, Gd, Gd, Gd, Ha^Fma, Ha, Ha^Qhhf, Ha^Fma, Ms^Qhh, Ms, Ms, Ms, Ms, Ms, Ms^Xm, Ms
Aa, Ha^Fma, Ha^Fma, Ha, Ha, Aa, Aa, Aa, Gs, Gs, Aa^Fma, Ha, Aa, Aa^Esa, Gs, Gs, Ai^Qhu, Ai, Ai, Ai^Esa, Ai, Ai^Qhu, Ai^Qhu, Ai^Qhu, Ai^Qhu, Aa, Rb, Gd, Gd, Ha^Qhh, Ha, Ms, Ha^Vca, Ms^_mh, Ha, Ms, Ms
Aa^Fpa, Aa, Aa, Ha, Ha, Ha^Esa, Hhd, Hhd, Hhd, Gs, Aa^Fma, Aa^Fma, Aa^Fma, Aa, Ha, Aa, Ha, Ha^Qhu, Ha^Qhu, Ai, Ha^Fma, Ai, Ai^Esa, Ai^_ml, Ai^Qhu, Ai^Qhu, Rb, Hhd, Hhd, Ha^Qhh, Ha^Qhh, Ha^Qhh, Ha^Qhh, Ha^Fma, Ms, Ms, Ms
Aa, Aa^Fpa, Aa^Fpa, Ha, Aa, Aa^Esa, Aa, Hhd, Hhd^Es, Gs, Gs, Gd^Fmw, Gd^Fmw, Aa^Vha, Hh, Hh, Hh, Ha, Ha, Ha^Qhu, Ha^Qhu, Ha^Fma, Ha^Fpa, Ai, Ai^Qhu, Rb, Ha, Hhd, Ha^Fma, Ha^Fma, Ha, Ha, Aa, Ha^Qhhf, Ms^Xm, Ms, Ms^Qhh
Re, Aa^Fpa, Gd, Aa, Aa^Esa, Aa^Esa, Aa, Aa, Gs, Gs^Fmw, Aa^Fma, Gd, Gd^Es, Aa^Fma, Aa^Fma, Gs^Fmw, Aa, Hhd, Hhd, Hhd, Ha^Qhu, Ha^Fpa, Ha^Fpa, Ai^Esa, Ai^Qhu, Rb, Aa, Ha^Fma, Ha^Fpa, Ha^Fma, Aa^Fpa, Aa^Fpa, Aa^Feta, Ha^Qhhf, Ha^Fma, Ha, Ms^Qhh
Aa, Re^Es, Aa, Gd, Rb, Aa^Esa, Re, Aa, Gs, Gs, Gs^Fma, Aa, Gs, Aa^Fma, Aa, Gs, Gs^Es, Gs^Efm, Gd^Qhu, Aa^Qhu, Aa^Fpa, Ha, Ha^Fpa, Ha^Fpa, Rb^Qhu, Ai^Qhu, Aa^Fma, Gd^Fp, Gd^Fp, Aa, Aa, Aa^Fpa, Ha^Qhhf, Aa^Qhhf, Ms, Ha, Aa^Qhh
Aa^Es, Aa, Aa^Fpa, Rb, Gd, Gs, Rb^Es, Re^Es, Re, Gs, Gs, Gs, Gs, Aa^Fma, Gs, Gs, Re, Gd^Efm, Gd^Qhu, Rb, Rb^Qhu, Rb^Qhu, Aa^Qhu, Ha^Qhu, Rb, Aa^Fma, Aa^Vca, Gd^Esa, Gd, Ha, Gd, Ha, Ha^Qhhf, Ha^Fpa, Ms, Ms^Xm, Ms^Qhh
Aa^Fpa, Aa, Aa^Fpa, Aa^Fpa, Aa, Gs, Gs, Rb, Aa, Re, Aa, Gd, Gs^Esa, Gs, Gs, Gs, Gd, Ce, Ce^Qhu, Aa, Gs^Qhu, Gs, Gs, Rb, Aa^Fpa, Aa, Ha, Aa, Ha^Qhh, Aa, Ha^Qhh, Ms^Qhh, Ms, Ha^Fpa, Ms^Xm, Ms, Ms^Qhh
Aa, Aa^Fpa, Aa, Aa^Fpa, Ha^Fpa, Aa^Esa, Aa, Aa^Esa, Aa^Esa, Aa, Gs^Efm, Rb, Re^Es, Re, Aa, Gd^Ecf, Rb, Ket^Qhu, Rb^Vct, Rb, Aa^Qhu, Gd, Gd, Gd, Aa^Fma, Aa^Fpa, Ha^Qhhf, Ha^Qhh, Ms, Ha^Qhh, Ms, Ms, Ms, Ms, Ms, Ms^Xm, Ms^Qhh
Gd, Aa, Gll^Fp, Aa^Fpa, Aa, Ha^Fpa, Hhd, Hhd, Gd, Aa, Gs, Gd^Efm, Gd^Efm, Re, Aa, Rb, Re^Es, Gs, Aa^Esa, Rb^Qhu, Aa, Ha, Ha, Ha, Ha, Ha^Qhhf, Ha^Fma, Ms, Ha, Ms^Xm, Ms^Xm, Ms^Xm, Ms^Xm, Ha, Ms, Ms, Ms^Qhh
Gd, Gll^Fp, Gll^Fp, Gs, Gs, Hhd, Hhd, Hhd, Gd, Gd^Fp, Gs^Efm, Gd^Efm, Aa, Gs, Gs, Gd, Aa, Aa, Aa, Aa, Rb, Aa^Es, Aa, Ha^Esa, Ha, Ha^Qhh, Ha^Qhh, Ms, Ms, Ha, Ha, Ms^Xm, Ha, Ms, Ms, Ms^Xm, Ms^Qhh
Aa^Esa, Aa, Aa, Gs, Gs^Fp, Aa, Ha^Vca, Hhd, Hhd^Qhu, Gd^Fp, Gd, Gs^Efm, Aa, Ha^Fpa, Hh, Gs^Esa, Hh^Qhh, Gs, Aa^Fma, Re, Re, Rb^Es, Rb, Ha^Es, Ha, Aa, Ha, Ms^Qhh, Ha^Qhh, Ms^Xm, Ms, Ms^Xm, Ms^Xm, Ha, Ms^Xm, Ms^Xm, Ms^Qhh
Ha^Fpa, Aa, Ha^Fpa, Aa, Aa^Fpa, Gs, Gs, Aa, Hh^Qhu, Gs, Aa^Qhu, Gs^Es, Aa^Fma, Ha^Fpa, Ha^Qhh, Ha^Qhh, Ms^Xm, Ha^Qhhf, Ha^Qhhf, Re, Aa, Rb, Aa^Esa, Aa, Aa, Aa, Re, Aa^Vaa, Ha^Qhh, Ms, Ms^Qhh, Ms, Ha, Ms, Ms^Xm, Ms^Xm, Ms^Qhh
Ha, Ha, Ha^Fpa, Ha^Fpa, Aa^Fpa, Gs^Es, Gs, Aa, Aa, Gs^Qhu, Aa, Aa, Aa, Aa, Hh^Qhh, Ms, Ms, Ms, Ms, Ha^Qhh, Hhd^Qhh, Aa, Aa, Aa^Esa, Re, Re^Es, Re, Ha, Ha, Ha^Qhhf, Aa^Fpa, Ha^Qhhf, Ms^Qhh, Ms^Xm, Ms, Ha^Fpa, Ha^Qhhf
Aa, Aa, Ha^Fpa, Ha^Feta, Ha^Fpa, Ha, Aa, Aa, Aa, Aa, Aa, Aa^Esa, Aa^Esa, Hh^Qhh, Hh^Qhh, Md, Ms, Ms^_mh, Ms^Fma, Md, Hh^Qhh, Hhd, Gs, Aa, Aa, Gs, Gs^Esa, Gs, Re, Aa^Fpa, Aa^Fpa, Ha^Fpa, Ms^Qhh, Ms, Ms, Ms, Ms^Qhh
Ha^Qhuf, Ha^Qhuf, Ha^Qhu, Ha^Qhuf, Ha^Qhuf, Hh^Qhu, Hh^Qhu, Aa, Hhd^Qhu, Hhd, Hhd^Qhu, Aa, Gs^Esa, Gd, Gs, Ha^Qhh, Hhd^Qhh, Ha^Qhhf, Ha^Qhhf, Hh^Qhh, Aa, Gd, Hh^Qhu, Gs, Ha^Qhu, Ha^Esa, Ha^Qhu, Ha, Re, Aa, Aa, Ha^Qhh, Ms^Xm, Ha^Vca, Ha, Ms, Ms^Qhh
Ms^Xm, Ms^Xm, Ms^Xm, Ms, Hhd, Hhd, Hhd^Esa, Hhd^Qhu, Ms, Ha^Qhu, Ha^Esa, Aa^Qhu, Gs^Esa, Gs^Vh, Gs, Gd, Gs, Aa, Ha, Aa^Fpa, Ha^Qhuf, Ha^Qhuf, Ms^Xm, Ha^Qhu, Ms, Ms^Qhu, Ha, Ha^Qhu, Aa, Rb^Es, Rb, Ms^Qhh, Ms^Qhh, Ms^Qhh, Ms^Qhh, Ms^Xm, Ms^Qhh
Ms, Ms, Ha, Ms, Ha, Hhd^Esa, Aa, Hhd, Uhe^Edb, Ms^Xm, Ms^Xm, Ha^Qhu, Ha^Qhu, Gs, Gd^Fp, Gs, Gd, Ha^Fpa, Ha^Qhu, Ha^Qhu, Ms, Ms, Ms, Ms, Ha^Fma, Ha, Ms, Ha^Qhu, Ha^Qhu, Rb, Aa, Rb, Aa^Esa, Ha, Ms^Xm, Ha^Qhh, Ha^Qhh
Ms, Ms, Ms, Ha, Aa^Esa, Uue^Esa, Aa^Edb, Aa, Aa^Edb, Uhe^Edb, Ms^Xm, Ms, Ha, Aa^Qhu, Gd^Fp, Gd^Fp, Ha^Qhuf, Ha^Qhuf, Ms^Esa, Ms, Hhd^Vhhr, Md, Hh, Aa, Ha^Fma, Ha, Ms, Ms^Xm, Ms^Qhu, Aa, Ha^Fpa, Aa, Ha^Esa, Aa^Esa, Uue^Edb, Ms^Xm, Xur
Ms, Ms, Ms, Ha, Uue, Uue^Edb, Aa^Edb, Aa^Edb, Ha, Ms, Ms^Xm, Ms^Xm, Ms, Aa^Qhu, Ha^Qhuf, Ha^Qhuf, Ms, Ha^Fma, Ms, Ms, Md, Hhd, Hh, Hh, Md, Ms, Ha, Ms, Ms, Ms^Qhu, Ms^Qhu, Ha^Fpa, Ms, Ha^Edb, Uu, Uhe^Qhh, Xur
Ha, Ms, Ms, Ms, Ms, Ha^Edb, Uue^Esa, Uue, Ha, Ms, Ms^Xm, Ha, Ms^Xm, Ha, Ha^_ml, Ha^Fpa, Ms, Ms, Ms, Md, Hh, Hh, Ms, Md, Ms, Md, Ms, Ms, Ms^Xm, Ms^Xm, Ms^Xm, Ms^Qhu, Xur, Xur, Xur, Uue^Edb, Uhe^Qhh
