Gg, Gg, Gg, Gg, Gs^Fp, Gg, Gll, Gg, Gg, Gg, Gg, Gg, Gll^Fp, Gg, Gg, Gg, Re, Gg, Gll^Fp, Gg, Gg, Gg, Gg, Gg
Gll^Ft, Gll, Gs^Ft, Gg^Es, Gg, Gll^Fp, Gll^Fp, Gll, Gg, Gg^Es, Gll, Gll, Gll^Fp, Gll^Fp, Gs, Re, Re, Gg, Gg, Gll^Fp, Gll^Fp, Gs^Fp, Gll^Fp, Gs^Ft
Gll^Fp, Gll^Ft, Gll^Fp, Gll, Gg, Gs^Fp, Gll^Fp, Gll^Fp, Gg, Gg, Gs^Fp, Gll^Ft, Gll, Gll^Fp, Gs, Gs^Es, Rb, Gg, Gg, Gll^Ft, Gll^Fp, Gll^Ft, Gll^Es, Gg^Es
Gg, Gll^Fp, Gll^Fp, Gll^Ft, Gg^Es, Gg, Gll^Ft, Gll^Fp, Gg, Gll, Hh^Fp, Hh^Ft, Hh^Es, Gg, Gg, Rb, Gs, Gs^Efm, Gg, Gs^Ft, Gll^Ft, Gll^Fp, Gll^Fp, Gg^Es
Gs^Ft, Gs^Ft, Gll^Fp, Gll^Fp, Gg, Gll, Gll^Fp, Gs^Fp, Gg, Gs^Ft, Hh, Hh, Hh, Hh^Es, Gs, Gs, Gs^Efm, Gg^Efm, Gs^Fp, Gg, Gll^Fp, Gll^Fp, Gll^Ft, Gll
Gll^Ft, Gll, Gll, Gg, Gs^Fp, Gll^Fp, Gll^Fp, Gll^Fp, Gll^Fp, Gll, Gg, Hh^Es, Hh, Gg, Re, Gs^Efm, Gg^Efm, Gg^Ve, Gll^Fp, Gll^Fp, Gll^Fp, Gll^Fp, Gll^Fp, Gll
Gg, Gll^Ft, Gll^Fp, Gll^Ft, Gll^Fp, Gll^Fp, Gll, Gll^Ft, Gll^Fp, Gll^Fp, Gll^Fp, Gg, Hh, Gs, Rb, Gs^Efm, Gg^Efm, Gs^Fp, Gll^Ft, Gll^Ft, Gll^Ft, Gll^Ft, Gll, Gs^Fp
Gg, Gll^Ft, Gs^Ft, Gll^Ft, Gll^Fp, Gll^Ft, Gll^Fp, Gll^Fp, Gs^Fp, Gll^Fp, Gll^Fp, Gg, Rb, Rb, Gll^Fp, Gg^Efm, Gg, Gg, Gg, Gll, Gll, Gll^Es, Gg, Gg
Gs^Ft, Gg, Gll, Gll, Gll, Gll, Gll, Gll^Fp, Gll^Fp, Gg, Gg, Gg, Gg, Rb, Gll^Fp, Gll^Fp, Gll^Fp, Gg^Efm, Gg^Efm, Gg, Gll^Fp, Gg, Gll^Em, Gll^Fp
Gll^Ft, Gll, Gs^Ft, Gg, Gll^Ft, Gg^Es, Gg, Gg, Gs, Gg^Efm, Gs^Efm, Re, Gg^Ve, Gs^Ft, Gs^Ft, Gll^Fp, Gll^Fp, Gg, Gg^Efm, Gll, Gs^Ft, Gll^Fp, Gll^Fp, Gll^Fp
Gll^Ft, Gll^Ft, Gll^Ft, Gll^Ft, Gll^Ft, Gll, Gll^Ft, Gs, Gs^Efm, Gs^Efm, Gs^Efm, Rb, Rb, Gll^Fp, Gll^Ft, Gll^Ft, Gll^Fp, Gll^Fp, Gll^Fp, Gg, Ss^Qhu, Gll^Fp, Sm^Qhu, Gll^Fp
Gg, Gg, Xuf, Gll^Ft, Gs^Ft, Gll^Ft, Gll^Ft, Gll, Gg, Gs^Efm, Gs^Efm, Gs, Re, Gll^Fp, Gll^Ft, Gg, Gll^Fp, Gll^Fp, Gll^Emf, Gll^Emf, Ss^Qhu, Ss^Qhu, Sm^Qhu, Gll^Fp
Xur, Xuf, Xuf, Xur, Xur, Xuf, Xuf, Gll^Ft, Gg^Ve, Gs^Efm, Gs, Re, Re, Gg, Gll, Gll, Gll, Gll^Fp, Gll^Ve, Gll^Emf, Hh, Ww^Qhu, Ww^Qhu, Sm^Qhu
Xur, Xur, Uhe^Qhh, Tb^Tfi, Ur^Qhu, Xur, Xuf, Rb, Re, Re, Gll^Fp, Gll, Gg, Gg^Es, Gll^Fp, Gll^Ft, Gll, Gg^Es, Gll, Gll^Em, Hh, Hh^Es, Wwr^Qhu, Ww^Qhu
Xuf, Uhe^Qhh, Uhe^Qhh, Ur^Qhu, Xur, Ur^Qhu, Uu^Ii, Rb^Pw\o, Xuf, Gg, Gll^Fp, Gll^Fp, Gg, Rb, Rb^Emf, Ss^Qhu, Sm^Qhu, Gd^Fetd, Gll, Hh^Fp, Hh^Es, Wwr^Qhu, Ss^Qhu, Wwr^Qhu
Xuf, Xuf, Uu^Vov, Xur, Xuf, Uu^Em, Uhe^Qhh, Xur, Xuf, Gs^Ft, Gg, Gll^Fp, Gg^Em, Re, Rb, Ss^Qhu, Ss^Qhu, Sm^Qhu, Gg^Es, Hh^Fp, Hh, Hh^Es, Gg, Gs^Ft
Xuf, Xur, Uu^Ii, Uu^Em, Rb^Ftp, Rb^Ftp, Xuf, Xur, Xuf, Gg, Gll^Fp, Gg, Gs^Ft, Gll, Gg, Rb, Gg, Gg, Gg, Gg^Ve, Gg, Gll, Gll, Gg
Xur, Uhe^Qhh, Xur, Uhe^Qhh, Xur, Xur, Xuf, Gg, Gll^Fp, Gll^Fp, Gg, Gs^Ft, Gll^Ft, Gll, Gll, Gg, Gs^Ft, Re, Gll, Gg^Es, Gll^Fp, Gll^Em, Gll^Emf, Gll
Xuf, Xuf, Xuf, Xuf, Xuf, Xur, Ss^Qhu, Gg, Gll^Em, Gll, Gs^Ft, Gll^Ft, Gd^Fetd, Gll^Ft, Gll^Ft, Gll^Fp, Gs^Ft, Rb, Rb, Gll, Gll^Ft, Gll^Emf, Gs^Ft, Gll^Ft
Xur, Xuf, Gll^Fp, Gll, Gs^Ft, Ss^Qhu, Ss^Qhu, Gg, Gg, Gll^Ft, Gs^Ft, Gll^Ft, Rb, Gll^Em, Rb, Gs^Ft, Gll, Rb, Gll^Fp, Gll^Ft, Gll, Ss, Ss, Ss
Gll^Ft, Gs^Ft, Gg, Gs^Ft, Gll^Ft, Wwr^Qhu, Wwr^Qhu, Sm^Qhu, Gg^Es, Gll^Em, Gg, Gg^Dr, Cvr^Dr, Gll, Re, Rb, Gll^Ft, Gll^Ft, Gll^Ft, Gs^Ft, Ww^Wkf, Gg, Ww, Ww
Gll^Ft, Gll^Ft, Gll^Fp, Gll^Ft, Gll^Fp, Gll^Ft, Gll^Ft, Ss^Qhu, Gll^Fp, Gg, Gg^Dr, 2 Kvr, Gll^Fp, Gs^Ft, Gs^Ft, Gg^Dr, Ww^Wkf, Gll^Ft, Ww, Ww^Wkf, Ww, Ww^Wkf, Ww, Ww
Gg, Gs^Ft, Gg, Gll^Fp, Gll, Gll^Em, Gg^Es, Gll^Ft, Gg, Gg, Gll^Ft, Gll^Ft, Gll^Ft, Gs^Ft, Ww^Wkf, Ww^Wkf, Ww^Wkf, Ww, Ww, Ww, Ww, Ww, Wo, Wo
Ww, Ww^Wkf, Ww, Ww^Wkf, Ww^Wkf, Gg, Gs^Ft, Gg, Ww, Gll^Fp, Ww^Wkf, Ww, Ww, Ww^Wkf, Ww^Wkf, Ww^Wkf, Ww, Ww, Wo, Wo, Wo, Wo, Wo, Wo
Ww, Ww, Ww, Ww^Wkf, Ww, Ww^Wkf, Ww, Ww, Ww, Ww^Wkf, Ww^Wkf, Ww, Ww, Ww, Wo, Wo, Wo, Ww, Wo, Wo, Wo, Wo, Wo, Wo
Ww, Wo, Wo, Wo, Wo, Ww, Ww, Ww, Ww, Ww, Wo, Ww, Ww, Wo, Wo, Wo, Wo, Wo, Wo, Wo, Wo, Wo, Wo, Wo
