Xor, Xu, Xu, Xu, Xu, Xu, Xu, Xu, Xu, Xu, Xu, Xu, Xu, Xu, Xu, Xu, Xu, Xu, Xu, Xu, Xu, Xu, Xu, Xu, Xu, Xu, Xu, Xu, Xu, Xu, Xu, Xu, Xu, Xu, Xu, Xu
Urb^Es, Xor, Xor, Xu, Xor, Xu, Xu, Xu, Xu, Xu, Xu, Xu, Xu, Xu, Xu, Xu, Xu, Xu, Xu, Xu, Xu, Xu, Xu, Xu, Xu, Xu, Xu, Xor, Xor, Xu, Xu, Xu, Xor, Xu, Xu, Xu
Urb^Br\, Urb, Urb^Dr, Xor, Xor, Xor, Xor, Xu, Xor, Xu, Xor, Xor, Xor, Xu, Xor, Xu, Xu, Xu, Xor, Xu, Xor, Xu, Xor, Xor, Xor, Xu, Xor, Xor, Xor, Xor, Xor, Xor, Xor, Xor, Xu, Xu
Xor, Urb^Br\, Urb^Br\, Urb, Urb^Es, Xor, Wwf^Qhu, Xor, Xor, Xor, Xor, Xor, Uhe, Uhe^Dr, Uhe, Xu, Xu, Xu, Xor, Xor, Urb, Xor, Xor, Xor, Xor, Xor, Xor, Xor, Xor, Xor, Cud^Xo, Xor, Xor, Xor, Xor, Xu
Xor, Xor, Xor, Urb^Br\, Urb^Br/, Urb^Dr, Wwf^Qhu, Wwf^Qhu, Wwg^Qhu, Xor, Wwg^Qhu, Wwg^Qhu, Wwg^Qhu, Wwg^Qhu, Xor, Xu, Xor, Xu, Xor, Xor, Xor, Urb^Pr/, Urb^Es, Urb^Vud, Wwf, Xor, Xor, Xor, Urb^Eb, Urb^Xo, Xor, Urb^Xo, Cud^Dr, Cud, 2 Kud, Xor
Xor, Xor, Urb^Dr, Urb^Br/, Urb, Urb, Xor, Wwf^Qhu, Wwf^Qhu, Wwg^Qhu, Wwg^Qhu, Wwg^Qhu, Xor, Xor, Xor, Xu, Xor, Xor, Xor, Xor, Xor, Urb^Vud, Urb, Urb^Es, Wwf, Wwf^Dr, Xor, Xor, Xor, Xor, Wwf^Edt, Urb^Dr, Urb, Cud, Cud^Xo, Cud^Xo
Urb^Br/, Urb^Br/, Urb^Es, Urb, Cud^Xo, Xor, Xu, Xor, Xor, Urb^Vud, Urb^Dr, Wwg^Qhu, Wwg^Qhu, Xor, Cud^Xo, Xu, Xor, Wwf, Wwf^Pr/, Xor, Urb, Urb, Cte^Edt, 3 Kte^Edt, Cte, Xor, Xor, Xor, Wwf^Dr, Wwf, Wwf, Urb^Edt, Urb^Dr, Urb^Xo, Xor, Urb^Xo
Urb, Urb^Es, Xor, Xor, Xu, Xu, Xu, Xu, Xu, Xor, Xor, Urb, Urb^Es, Wwg^Qhu, Wwg^Qhu, Xor, Xor, Xor, 4 Kte^Edt, Wwf, Wwf, Urb, Wwf, Cte, Wwf, Wwf^Edt, Wwf^Edt, Urb^Pr\, Urb^Pr\, Urb, Urb, Urb, Xor, Xor, Urb^Eb, Urb^Edt
Xor, Xor, Xu, Xu, Xu, Xu, Xu, Xu, Xu, Xu, Xor, Xor, Xor, Wwg^Qhu, Wwg^Qhu, Wwg^Qhu, Wwg^Qhu, Cte^Ii, Cte^Edt, Xor, Wwf^Edt, Wwf^Edt, Xor, Wwf^Dr, Wwf, Wwf, Wwf^Dr, Urb^Edt, Urb, Urb^Pr\, Xor, Xor, Xor, Xor, Xor, Xu
Xu, Xu, Xu, Xu, Xu, Xu, Xu, Xu, Uhe, Uhe^Dr, Urb^Edt, Xor, Xor, Xor, Wwg^Qhu, Wwf^Qhu, Wwg^Qhu, Wwg^Qhu, Wwg^Qhu, Wwg^Qhu, Qxu, Wwf, Urb, Urb, Xor, Wwf, Wwf, Wwf, Xor, Urb, Urb, Xor, Urb^Br\, Urb^Vud, Urb^Br\, Xor
Xu, Xu, Xu, Xu, Xu, Xu, Xu, Xu, Xu, Urb^Dr, Xor, Uue^Pr/o, Uue^Edt, Xor, Urb^Es, Urb^Edt, Wwf^Qhu, Wwg^Qhu, Qxu, Qxu, Qxu, Qxu, Qxu, Urb^Edt, Urb^Ii, Urb, Xor, Urb, Cte, Urb, Xor, Urb^Edt, Urb^Br/, Urb^Br\, Urb^Dr, Urb^Br\
Xu, Xu, Xu, Xu, Xu, Xu, Xu, Xu, Xu, Xor, Xor, Uue, Wwf^Edt, Urb^Edt, Xor, Urb, Qxu, Qxu, Qxu, Qxu^Ii, Qxu^Ii, Qxu, Qxu^Ii, Qxu^Ii, Qxu^Ii, Urb^Ii, Urb^Ii, Urb, Xor, 5 Kte, Cte, Urb^Dr, Urb, Urb^Edt, Cud^Xo, Urb^Br\
Xu, Xu, Xu, Xu, Xu, Xu, Xu, Xu, Xu, Xor, Wwf^Dr, Wwf, Xor, Wwf, Urb, Urb, Xor, Qxu, Qxu, Qxu^Ii, Qxu, Qxu, Qxu, Qxu, Qxu, Qxu, Qxu^Ii, Urb^Ii, Urb, Cte, Urb^Edt, Urb^Edt, Xor, Xor, Xor, Xor
Xu, Xu, Xu, Xu, Xu, Xu, Xu, Xu, Xu, Xor, Wwf, Wwf, Wwf^Dr, Wwf, Urb^Dr, Urb, Urb, Wwf, Xor, Qxu, Qxu^Ii, Qxu, Qxu, Qxu, Qxu, Qxu, Qxu, Qxu, Urb^Edt, Urb, Xor, Urb^Edt, Uhe^Qhh, Xu, Xu, Xor
Xu, Xu, Xu, Xu, Xu, Xu, Xu, Xu, Xu, Xor, Xor, Wwf, Urb^Edt, Urb^Es, Urb^Ii, Urb, Xor, Wwf, Wwf^Edt, Wwf^Ii, Xor, Qxu, Qxu, Qxu^Ii, Qxu, Qxu, Urb, Urb, Urb^Dr, Urb, Uue^Qhu, Urb, Xor, Xor, Xu, Xu
Xu, Xu, Xu, Xu, Xu, Xu, Xu, Xu, Xor, Xor, Xor, Urb^Edt, Uue^Qhu, Urb, Urb, Urb^Edt, Urb^Edt, Wwf^Edt, Xor, Wwf, 6 Kte, Cte, Uue^Dr, Qxu, Urb, Urb^Es, Xor, Urb, Urb, Urb, Urb, Xor, Xu, Xu, Xu, Xu
Xu, Xu, Xu, Xu, Xu, Xu, Xu, Xor, Xor^Vud, Xor, Urb^Dr, Urb^Edt, Uue^Qhu, Uue^Qhu, Urb^Vud, Urb, Xor, Urb, Urb^Edt, Wwf^Edt, Xor, Cte^Edt, Urb^Edt, Urb^Edt, Urb, Urb^Es, Urb, Urb, Cud^Xo, Urb, Urb, Urb, Uhe^Dr, Xor, Xor, Xu
Xu, Xu, Xu, Xu, Xor, Xu, Xor, Xor, Uu^Vud, Urb^Br/, Urb, Urb, Xor, Xor, Xu, Xor, Xor, Xor, Urb, Urb, Urb, Urb, Xor, Urb, Urb, Urb^Ii, Urb, Xor, Xor, Xor, Xor, Uhe, Uhe^Qhh, Xu, Xu, Xu
Xu, Xu, Xu, Xor, Xor, Xor, Uhe^Qhh, Uue^Dr, Uue^Es, Urb, Urb, Xor, Xor, Xu, Xor, Xor, Urb^Vud, Urb^Dr, Urb, Urb^Edt, Xor, Xor, Xu, Xor, Xor, Urb^Edt, Urb^Edt, Urb^Edt, Urb, Xor, Xor, Xu, Xor, Xu, Xu, Xu
Xu, Xu, Xor, Xor, Xu, Xu, Uue^Dr, Uhe, Urb, Urb^Es, Urb, Cud^Dr, Xor, Xor, Xor, Xor, Urb^Edt, Urb, Uue^Qhu, Urb^Vud, Urb^Pr/, Xor, Xor, Xu, Xu, Xor, Xor, Urb, Urb, Urb^Edt, Urb, Xor, Uue^Dr, Xor, Xu, Xu
Xor, Xor, Uue^Dr, Uue^Br/, Uhe^Qhh, Xu, Xor, Xor, Xor, Urb^Es, Urb^Edt, Xor, Xor, Xu, Uhe^Dr, Uue^Es, Xor, Xor, Xor, Uue^Pr/, Uue, Uue, Xor, Xu, Xu, Xu, Xu, Cud^Dr, Xor, Urb^Edt, Urb^Es, Uue^Vud, Uhe^Qhh, Uue^Dr, Xor, Xu
Urb^Br/, Urb^Br/, Uhe, Uue^Dr, Xor, Xor, Xor, Xor, Xor, Urb^Edt, Urb^Edt, Xor, Xu, Uhe^Dr, Uhe^Qhh, Xu, Xu, Xu, Xu, Xor, Xor, Xor, Xu, Xu, Xu, Xu, Xor, Xor, Urb, Urb, Urb^Es, Urb^Es, Xor, Xor, Xu, Xu
Urb, Urb^Es, Xor, Xor, Xor, Xor, Cud^Xo, Xor, Urb, Urb^Edt, Urb, Xor, Xor, Xu, Xu, Xu, Xu, Xu, Xu, Xu, Xu, Xu, Xu, Xu, Xu, Xor, Xor, Uue^Dr, Uue^Es, Urb, Urb, Xor, Xor, Xor, Xor, Xu
Xor, Urb, Urb, Xor, Xor, Xor, Urb^Edt, Urb, Urb^Es, Urb, Xor, Xor, Xor, Xu, Xu, Xu, Xu, Xu, Xu, Xu, Xu, Xu, Xu, Xu, Xu, Xu, Uhe^Qhh, Uue^Dr, Uue^Br/, Urb^Br\, Urb^Dr, Urb, Urb, Xor, Xor, Xor
Xor, Xor, Xor, Urb, Urb^Es, Urb, Urb^Edt, Urb, Urb^Pr/o, Xor, Xor, Xor, Xor, Xu, Xu, Xu, Xu, Xu, Xu, Xu, Xu, Xu, Xu, Xu, Xu, Xu, Xu, Uue^Br/, Xu, Xor, Xor, Urb^Br\, Urb^Br\, Urb^Es, Urb, Xor
Xor, Xor, Urb^Es, Urb^Es, Urb^Es, Urb, Xor, Xor, Xor, Urb, Urb, Urb^Eb, Xor, Xor, Xor, Xu, Xu, Xu, Xu, Xu, Xu, Xu, Xu, Xu, Xu, Xu, Xu, Xu, Xu, Xu, Xu, Cud^Xo, Xor, Urb^Br\, Urb^Br\, Urb
Urb, Urb, Urb, Urb, Xor, Xor, Xu, Xor, Xor, Urb^Dr, Xor, Urb, Urb^Es, Urb^Dr, Xor, Xor, Xor, Xu, Xu, Xu, Xu, Xu, Xu, Xu, Xu, Xu, Xu, Xu, Xu, Xu, Xu, Xu, Xu, Xor, Xor, Urb^Br\
Urb, Urb^Es, Xor, Xor, Xor, Xu, Xu, Xu, Xu, Xor, Xor, Xor, Xor, Urb^Dr, Urb, Xor, Xor, Xu, Xu, Xu, Xu, Xu, Xu, Xu, Xu, Xu, Xu, Xu, Xu, Xu, Xu, Xu, Xu, Xu, Xor, Xor
