Xu, Xu, Xu, Xu, Xu, Xu, Xu, Xu, Xu, Xu, Xu, Uhe^Qhh, Uhe^Qhh, Ur^Qhu, Ur^Qhu, Xu, Xu, Xu, Uu^Em, Qxu, Qxu, Qxu, Ur^Qhu, Ur^Qhu, Rb, Uu, Uu^Em, Rb^Em, Rb^Em, Rb
Xu, Xu, Xu, Xu, Xu, Xu, Xu, Xu, Xu, Xu, Xu, Xu, Uhe^Qhh, Uhe^Qhh, Uu^Em, Rb^Em, Rb, Xu, Uue^Qhu, Qxu, Uue^Qhu, Qxu, Uu, Uu, Rb, Rb^Vu, Uu^Es, Uu^Es, Uu^Es, Rb
Xu, Xu, Xu, Xu, Xu, Xu, Xu, Xu, Xu, Xu, Xu, Xu, Xu, Xu, Uhe^Qhh, Uu^Vu, Uhe^Qhh, Rb, Uu^Em, Uue^Qhu, Uue^Qhu, Uue^Qhu, Rb, Uu, Xu, Xu, Qxu, Uu^Es, Qxu, Uu
Xu, Xu, Xu, Xu, Xu, Xu, Xu, Xu, Qxu, Xu, Xu, Xu, Xu, Xu, Uhe^Qhh, Uhe^Qhh, Uhe^Qhh, Uhe^Qhh, Uu, Uue^Qhu, Qxu, Rb, Rb, Uu^Es, Rb, Xu, Qxu, Qxu, Qxu, Qxu
Xu, Xu, Xu, Xu, Xu, Xu, Xu, Qxu, Qxu, Xu, Xu, Xu, Xu, Xu, Xu, Uhe^Qhh, Uu^Em, Uu^Em, Uue^Qhu, Uue^Qhu, Qxu, Uu^Vu, Rb^Es, Rb^Es, Rb^Es, Cte, Cte, Uue^Qhu, Rb^Vu, Qxu
Xu, Xu, Xu, Xu, Xu, Xu, Xu, Xu, Xu, Qxu, Xu, Xu, Xu, Xu, Xu, Uu, Qxu, Uu^Em, Qxu, Uue^Qhu, Qxu, Qxu, Uu^Vud, Uu, Uu, 2 Kte, Qxu, Tb^Tf, Tb^Tf, Xu
Xu, Xu, Xu, Xu, Xu, Uu^WebS, Uu^WebS, Xu, Xu, Qxu, Qxu, Xu, Uu^WebS, Xu, Uu^Es, Uu, Qxu, Qxu, Qxu, Qxu, Qxu, Qxu, Uu, Uu, Qxu, Rp^Qhu, Rp^Qhu, Qxu, Uue^Qhu, Xu
Xu, Qxu, Qxu, Xu, Uu, Uhe^Qhh, Uu, Uhe^Qhh, Uhe^Qhh, Qxu, Qxu, Xu, Rb^Qhu, Rb^Qhu, Uu^Edt, Uu^Es, Xu, Xu, Xu, Qxu, Xu, Uu^Vud, Uu, Qxu, Uhe, Qxu, Uhe^Qhh, Uu, Uu^Es, Uu^Es
Xu, Xu, Xu, Qxu, Qxu^Bs/, Ur^Qhu, Ur^Qhu, Uu^Es, Uu^Es, Rb^Qhu, Rb^Qhu, Uu^Es, Rb^Qhu, Rb^Qhu, Qxu, Uu^Es, Uu^Es, Xu, Qxu, Xu, Xu, Uh^Qhh, Rb^Es, Uu^Qhh, Qxu, Qxu, Uu^Vu, Uhe^Qhh, Xu, Uu^Vu
Xu, Xu, Uu^Vud, Uue^Qhu, Uue^Qhu, Qxu, Qxu, Qxu, Qxu, Rb^Qhu, Qxu, Qxu, Qxu, Qxu, Qxu, Qxu, Ur^Qhu, Xu, Ur^Qhu, Qxu, Qxu, Xu, Rb, Rb^Es, Uu, Uu^Es, Xu, Xu, Xu, Xu
Xu, Xu, Xu, Uue^Qhu, Xu, Xu, Xu, Qxu, Xu, Qxu^Bp|, Uu^Edt, Qxu, Qxu, Qxu, Qxu, Qxu, Qxu, Ur^Qhu, Qxu, Qxu^Bs\, Uu, Rb^Es, Uu^Vu, Xu, Xu, Uu, Ur^Qhu, Uu^WebS, Xu, Xu
Xu, Xu, Xu, Uu^Es, Xu, Uu^WebS, Uhe^Qhh, Xu, Xu, Rb, Rb^Edt, Uue^Qhu, Qxu, Qxu, Qxu, Qxu, Qxu, Qxu, Qxu, Qxu, Uu^Es, Uu^Es, Uue^Qhu, Xu, Uu^Vu, Xu, Ur^Qhu, Ur^Qhu, Xu, Xu
Xu, Uhe^WebS, Uhe^Qhh, Uu^Es, Uu^Es, Uu^Em, Uhe^Qhh, Uhe^Qhh, Xu, Xu, Rb^Es, Qxu, Qxu, Qxu, Qxu, Qxu, Qxu, Qxu, Qxu, Qxu, Uue^Qhu, Uue^Qhu, Uue^Qhu, Uue^Qhu, Qxu, Qxu, Ur^Qhu, Xu, Uu^WebS, Xu
Xu, Uhe^Qhh, Xu, Xu, Uu^Es, Uue^Qhu, Uue^Qhu, Xu, Xu, Uh^Qhh, Ur^Qhu, Rb^Es, Uu^Edt, Uu^Vu, Qxu, Qxu, Qxu, Qxu, Qxu, Qxu, Qxu, Qxu, Qxu, Qxu^Bs\, Ur^Qhu, Qxu, Qxu, Uu, Qxu, Xu
Xu, Xu, Qxu, Qxu, Ur^Qhu, Xu, Uue^Qhu, Xu, Uh^Qhh, Ur^Qhu, Ur^Qhu, Qxu, Qxu, Qxu, Qxu, Qxu, Qxu, Qxu, Uue^Qhu, Qxu, Qxu, Qxu, Qxu, Qxu, Ur^Qhu, Ur^Qhu, Rb^Es, Qxu^Bs|, Uu^Vu, Qxu
Xu, Xu, Qxu, Qxu, Ur^Qhu, Xu, Uu^Vu, Uue^Qhu, Rb, Ur^Qhu, Uu^Edt, Ur^Qhu, Qxu, Qxu, Qxu, Qxu, Qxu, Qxu, Tb^Tf, Uue^Qhu, Qxu, Qxu, Qxu, Qxu, Tb^Tf, Tb^Tf, Tb^Tf, Rb^Es, Xu, Uu
Xu, Qxu, Qxu, Qxu, Qxu, Ur^Qhu, Uu^Edt, Rb, Rb^Em, Rb^Em, Rb^Es, Rb^Edt, Uue^Qhu, Uue^Qhu, Qxu, Qxu, Qxu, Tb^Tf, Qxu, Qxu, Uue^Qhu, Uu^Vud, Uh^Qhh, Qxu, Qxu, Tb^Tf, Rb^Em, Rb^Es, Uhe^Qhh, Xu
Xu, Xu, Qxu, Qxu, Uue^Qhu, Tb^Tf, Tb^Tf, Ur^Qhu, Ur^Qhu, Ur^Qhu, Qxu, Rb^Edt, Uue^Qhu, Uue^Qhu, Qxu, Uue^Qhu, Xu, Qxu, Qxu, Uue^Qhu, Rb^Es, Uh^Qhh, Uh^Qhh, Qxu, Xu, Qxu, Rb^Es, Rb^Es, Uu, Uu
Uue^Qhu, Uu, Uu, Uue^Qhu, Uue^Qhu, Tb^Tf, Uu^Tf, Ur^Qhu, Qxu, Qxu, Qxu, Qxu, Qxu, Rb, Rb^Em, Rb^Es, Xu, Xu, Xu, Qxu, Rb^Es, Rb^Es, Rb^Es, Xu, Xu, Uh^Qhh, Rb, Uhe^Qhh, Uhe^Qhh, Uhe^Qhh
Uue^Qhu, Uue^Qhu, Uhe^Qhh, Rb^Edt, Rb^Edt, Rb^Edt, Uu, Ur^Qhu, Qxu, Qxu, Qxu, Qxu, Uue^Qhu, Rb, Uue^Qhu, Rb^Es, Rb^Es, Xu, Rb, Qxu^Bp/, Qxu, Xu, Tb^Tf, Rb, Rb, Rb, Uhe^Qhh, Uhe^Qhh, Xu, Xu
Xu, Uhe^Qhh, Uhe^Qhh, Rb^Em, Rb^Em, Qxu, Qxu, Qxu, Ur^Qhu, Ur^Qhu, Qxu, Qxu, Uue^Qhu, Uue^Qhu, Xu, Tb^Tf, Uh^Qhh, Uu^Vu, Uh^Qhh, Xu, Xu, Qxu, Xu, Uu^WebS, Xu^WebS, Tb^Tf, Xu, Xu, Xu, Xu
Xu, Xu, Uu, Ur^Qhu, Ur^Qhu, Uu, Uu^Edt, Qxu^Bs/, Qxu, Uu^Edt, Uu^Em, Uue^Qhu, Xu, Xu, Xu, Uu^WebS, Uu^WebS, Uh^Qhh, Xu, Xu, Xu, Xu, Xu, Xu, Xu, Xu, Xu, Xu, Xu, Xu
Uh^Qhh, Uu^Edt, Ce, Ur^Qhu, Ur^Qhu, Ce^Edt, Ce, Qxu, Qxu, Qxu, Uh^Qhh, Uh^Qhh, Xu, Xu, Xu, Xu, Xu, Xu, Xu, Xu, Xu, Xu, Xu, Xu, Xu, Xu, Xu, Xu, Xu, Xu
Xu, Ce^Edt, 1 Ke^Edt, Rb, Rb, Ke^Edt, Xu, Qxu, Qxu, Uue^Qhu, Uu^WebS, Uu^WebS, Xu, Xu, Xu, Xu, Xu, Xu, Xu, Xu, Xu, Xu, Xu, Xu, Xu, Xu, Xu, Xu, Xu, Xu
Uh^Qhh, Ce, Uu^Edt, Rb, Xu, Xu, Xu, Xu, Xu, Xu, Xu, Xu, Xu, Xu, Xu, Xu, Xu, Xu, Xu, Xu, Xu, Xu, Xu, Xu, Xu, Xu, Xu, Xu, Xu, Xu
Uh^Qhh, Uh^Qhh, Uu^Edt, Uu^Edt, Ce^Xo, Xu, Xu, Xu, Xu, Xu, Xu, Xu, Xu, Xu, Xu, Xu, Xu, Xu, Xu, Xu, Xu, Xu, Xu, Xu, Xu, Xu, Xu, Xu, Xu, Xu
Xu, Ce^Xo, Xu, Ur^Qhu, Ce^Edt, Ce^Xo, Xu, Xu, Xu, Xu, Xu, Xu, Xu, Xu, Xu, Xu, Xu, Xu, Xu, Xu, Xu, Xu, Xu, Xu, Xu, Xu, Xu, Xu, Xu, Xu
Xu, Xu, Ur^Qhu, Ur^Qhu, Uu, Uu, Xu, Xu, Xu, Xu, Xu, Xu, Xu, Xu, Xu, Xu, Xu, Xu, Xu, Xu, Xu, Xu, Xu, Xu, Xu, Xu, Xu, Xu, Xu, Xu
