Uhe^Qhh, Uhe^Qhh, Xur, Uue, Uue, Uhe^Qhh, Xur, Xur, Xu, Gg, Ms^Xm, Gg, Ha, Ms, Ms, Gg, Ms, Ms, Ms, Ms, Ms, Ms, Ms, Ha, Ha, Aa, Ms, Aa, Ms^Xm, Aa, Ms^Xm, Ms^Xm, Ha, Ha, Ha, Ms^Xm, Ms^Xm, Aa, Ms^Xm, Aa, Ha, Ha
Uue, Uu, Xur, Xur, Ke, Uu, Ha, Xur, Ms^Xm, Ms^Xm, Ha, Ms^Xm, Ms^Xm, Ms, Ms, Ms, Ms, Ms, Ms, Ms, Ms, Ms, Ha^Fma, Ha, Ai, Aa, Ha, Ms, Ms, Ms^Xm, Ms^Xm, Ms, Ms^Xm, Ms^Xm, Ms, Ms, Ms, Ms^Xm, Ms^Xm, Ms^Xm, Ms^Xm, Ha
Uhe^Qhh, Uue, Uu, Ha, Cea, Cea^Esa, Aa, Ha^Esa, Aa, Ms^Xm, Ha^Fma, Ms, Ms, Ms, Ms, Ms^Xm, Ms, Ms, Ms, Ms, Aa, Ha^Esa, Ai, Ai, Ai, Ai, Ai, Ha, Ha^Fpa, Ms, Ms, Ms^Xm, Ms^Xm, Ha, Ms^Xm, Ha, Ms^Xm, Ms^Xm, Ms, Ms, Ms, Ms^Xm
Xur, Xur, Ha, Aa, Re, Aa, Ha, Aa, Ms, Ha, Ha^Esa, Ha^Fma, Aa, Ms, Ms, Ms, Ms^Xm, Ms, Ms, Ms, Ha, Ai, Ai, Ai, Ai, Wwg, Wwg, Ha, Ha^Fma, Ms, Ms, Ms, Ms, Ms^Xm, Ms, Ms^Xm, Ms, Ms^Xm, Ms^Xm, Ms, Ha^Fma, Ha^Fma
Xur, Xur, Ms, Aa, Aa^Esa, Re, Rb, Ha^Esa, Ha^Esa, Ms, Ms^Xm, Ha^Fpa, Aa, Ha^Esa, Ha^Fma, Ms^Xm, Ms^Xm, Ms, Ms, Ha^Fpa, Ha^Fma, Ha, Ai, Ai, Ai, Ai, Ai, Ai, Ai, Ha^Fpa, Aa, Ha, Ha, Ms, Ha^Dr, Ms, Ha, Ms, Ha^Esa, Ha, Ha^Esa, Aa
Ms^Xm, Ms^Xm, Ms, Ha, Aa, Re, Aa, Aa, Ha^Esa, Ms, Ms, Ms, Ms, Aa, Ms, Ms, Ms^Xm, Ms, Ms^Xm, Ms, Ms, Ha, Ha^Vha, Ha, Ha, Ai, Ai, Ai, Wwg, Ai, Ai, Ha^Vha, Aa, Aa, Aa, Ha, Aa, Ha, Ms, Ms, Ms, Ha
Ms^Xm, Ms, Ha^Esa, Aa, Re, Re, Ha, Aa, Aa, Aa, Ha, Ms, Ms, Ha, Ms, Ms^Xm, Ms^Xm, Ms^Xm, Ms, Ms^Xm, Ms, Ms^Xm, Ms^Xm, Ms^Xm, Ms^Xm, Ha^Fma, Ha^Fpa, Aa^Esa, Aa, Ai, Aa, Aa, Ha^Dr, Aa, Ha, Ha, Ms, Ms, Ms^Xm, Ms, Ms, Ms
Ms^Esa, Ha, Ms, Ha, Aa, Aa, Ha^Esa, Ha, Ha, Aa, Ha^Fma, Ms, Ms, Aa, Ha, Ms^Xm, Ms^Xm, Ha, Ms, Ms^Xm, Ms, Ms, Ha^Fpa, Ms, Ha, Ms, Ha, Aa, Ha, Ha, Ms, Chr^Dr, Chr^Kov, Ha, Ms, Ms, Ms, Ms^Xm, Ms, Ms^Xm, Ms^Xm, Ms^Xm
Ha, Ha, Ms, Ha, Aa, Re, Re, Ms, Ms^Xm, Ha, Ha^Fma, Ha, Aa^Vha, Ha, Ms^Xm, Ms^Xm, Ms^Xm, Ms^Xm, Ms, Ms, Ha, Ha^Esa, Ha, Aa^Fpa, Aa^Fma, Ha, Aa, Aa^Fma, Ha^Fpa, Ms, Ha, Ms, Ms, Ms, Ms, Ms, Ms, Ms, Ms^Xm, Ms^Xm, Ms^Xm, Ms^Xm
Ms, Ms, Ha, Ha, Aa, Rb, Ha^Fpa, Ms, Ms, Ms, Ms, Ha^Fpa, Ha^Fma, Ms^Xm, Ms^Xm, Ms^Xm, Ms^Xm, Ms, Ha, Ha, Ha^Esa, Ha, Aa, Aa, Aa^Esa, Aa, Aa, Aa^Esa, Aa, Aa, Aa^Fpa, Ha^Esa, Aa, Ha, Aa, Ha, Aa, Ms, Ha, Ms, Ms, Ha
Ms, Ms, Ha, Aa^Esa, Ha, Rb, Aa, Ha^Fma, Aa, Ms, Ms, Ha, Ms^Xm, Ms^Xm, Ms^Xm, Ms^Xm, Ha, Ha, Aa, Cea, Cea^Esa, Aa, Aa, Aa, Gd, Gd, Aa^Fpa, Aa, Aa, Aa^Fpa, Aa, Aa, Aa, Aa, Aa, Aa, Ss, Aa^Esa, Ha, Ms^Xm, Ha, Ms
Ms, Ha^Fma, Aa, Aa, Ms, Ha^Esa, Aa, Aa^Fpa, Rb, Ha^Fpa, Ha, Ms, Ms^Xm, Ms^Xm, Ms^Xm, Ms, Ha^Edt, Cea, Cea^Edt, Aa, Aa^Edt, Aa, Aa, Gd, Gs, Aa, Aa, Aa, Aa, Aa, Gd, Gd, Ai, Aa^Vha, Gd, Gd, Aa, Ss, Ss^Em, Ss, Ss, Ha
Aa, Aa^Esa, Ha, Aa, Ms, Ms, Ha, Rb, Rb, Aa, Ha, Ms, Ms^Xm, Ms^Xm, Ha, Ms, Ha, 2 Kea^Edt, Cea^Esa, Aa, Aa, Aa, Aa, Aa^Esa, Gs, Aa, Gs, Gd, Sm^Qhu, Gd, Sm^Qhu, Ai, Ss, Ai, Ss^Em, Gd, Gs, Aa, Ss, Sm^Qhu, Sm^Qhu, Sm^Qhu
Aa^Fma, Ha, Ha^Fpa, Ms, Ms^Xm, Ms, Ha^Fma, Aa, Rb, Ha^Esa, Ms, Ms^Xm, Ms^Xm, Ms, Ha, Ha^Vhha, Ha, Aa^Esa, Aa, Aa, Aa, Gd, Gd, Gd, Gs, Gd, Gs, Wwg^Qhu, Wwrg^Qhu, Wwrg^Qhu, Gd, Gd, Gd^Em, Ss, Gd, Ss, Gs, Aa, Wwg^Qhu, Sm^Qhu, Ss, Sm^Qhu
Ms, Ha^Fpa, Ms^Xm, Ms, Ms^Xm, Ms, Ms, Aa^Fma, Aa, Ha, Ms, Ms^Xm, Ms, Ms^Xm, Ms, Ha^Esa, Ha, Cea^Edt, Ha, Aa, Re, Gd^Vhr, Gs, Aa, Aa, Gd, Gs, Gs, Gs, Gd, Aa, Gd, Gd, Gd, Ss, Gs, Sm^Qhu, Gs, Ss, Wwg^Qhu, Gd, Gd
Ms, Ms, Ms^Xm, Ms^Xm, Ms, Ms, Ha^Fpa, Aa^Fma, Aa^Esa, Ms, Ms^Xm, Ms^Xm, Ms^Xm, Ms, Ha, Ha, Aa, Ha, Ha, Rb, Aa, Aa, Aa^Esa, Aa, Aa, Gs, Ha, Aa, Aa, Aa, Aa, Gs, Gs, Gd, Gd, Ss^Em, Ai, Wwrg^Qhu, Wwrg^Qhu, Ss, Ss^Em, Sm^Qhu
Ms, Ms^Xm, Ms^Xm, Ms^Xm, Ms, Ms, Ha, Aa^Fma, Rb, Ms, Ms, Ms^Xm, Ha, Ms, Ha, Aa^Esa, Aa, Aa, Re, Aa, Aa, Aa, Aa, Aa, Aa, Ha, Ha^Vhha, Ha, Ha, Aa^Esa, Gd, Aa, Gs, Gs, Gd, Aa, Ai, Sm^Qhu, Sm^Qhu, Ss, Ss, Sm^Qhu
Ms, Ms, Ms, Ms, Ms, Ha, Aa, Rb, Aa, Ha, Ms, Ms^Xm, Ms^Xm, Ha, Ha^Esa, Aa, Aa, Rb, Aa, Aa, Gd, Aa, Gd, Aa, Gs, Aa, Aa, Aa, Gd, Gd, Gd, Gs, Ss, Gd^Em, Aa, Gd^Vhr, Aa, Ai, Aa, Ss, Chs, Ss
Ms, Ms, Ms, Ms, Ha^Fma, Aa^Fpa, Aa^Fma, Rb, Ha, Ha, Ms, Ms^Xm, Ms, Ha, Ha, Aa, Rb, Rb, Gd^Em, Gd, Aa, Aa, Gd^Fdw, Gd^Fdw, Aa, Gs, Gd, Gd, Ss, Gd^Em, Wwg^Qhu, Gd, Ss^Em, Ai, Ai, Aa, Aa, Aa^Esa, Aa, Chr^Edt, Chs, Gd
Ha, Ha^Esa, Ha, Ha, Aa^Vha, Aa^Fma, Aa, Aa, Ms, Ms, Ms^Xm, Ms^Xm, Ms, Ha^Fma, Aa^Fpa, Gd, Re, Re, Gs, Gd, Aa, Gd, Aa, Aa^Fdw, Aa, Gd, Aa, Gd, Ss, Ss, Wwg^Qhu, Sm^Qhu, Sm^Qhu, Ai, Ss, Sm^Qhu, Sm^Qhu, Aa, Chr, Chr^Kov, Ss, Ss^Edt
Ms, Ms, Gd, Aa, Re, Rb, Aa, Ha^Esa, Ms, Ms^Xm, Ms^Xm, Ms, Ha^Fma, Ha^Fpa, Aa^Fpa, Aa^Fpa, Gs, Gs, Aa, Aa, Aa, Aa, Ai, Aa, Ss^Vhs, Aa, Aa, Aa, Aa^Esa, Gd, Gd, Ss^Vhs, Ss, Ss, Ss, Sm^Qhu, Sm^Qhu, Aa, Urb^Qhu, Urb^Qhu, Urb^Qhu, Ss
Ms, Ha, Aa, Gd, Re, Re, Aa^Fpa, Ha^Fma, Ha^Fma, Ms, Ha, Ha, Aa, Aa, Re, Re, Aa, Aa, Aa, Aa^Esa, Aa, Ai, Wwrg^Qhu, Gd, Ss, Ss, Aa, Aa, Aa, Gd^Em, Aa, Ss, Gd^Fdw, Ss, Ss, Ss, Rp^Dr, Chr, Chs, Aa, Chs, Ss
Ha, Aa, Ss, Rb, Rb, Aa^Fpa, Rb, Aa^Fma, Ha^Fpa, Ms, Ha^Esa, Aa, Aa, Re, Rb, Aa, Aa, Aa, Aa^Esa, Aa, Ai, Wwrg^Qhu, Wwg^Qhu, Wwrg^Qhu, Wwg^Qhu, Wog^Qhu, Gd, Gd, Wwrg^Qhu, Wwrg^Qhu, Gd^Em, Gd, Gd, Aa, Chr, Rp^Dr, Chr, 4 Khr, Chs^Edt, Rp^Dr, Ss, Wwrg^Qhu
Ha, Aa^Esa, Ss, Ss, Gd, Rb, Rb^Dr, Gd, Aa, Ha, Ha^Vca, Aa, Aa, Rb, Gs, Gd, Ss, Aa, Gd, Ai, Ai, Sm^Qhu, Sm^Qhu, Wwg^Qhu, Wog^Qhu, Wog^Qhu, Ss, Gd, Ss, Wwrg^Qhu, Aa^Esa, Aa, Aa, Chr^Edt, Chr^Kov, Aa, Ss, Chr^Edt, Sm^Qhu, Chs, Rp^Dr, Chr^Dr
Gd, Aa, Ai, Ss, Ss, Ss, Gd, Rb, Re, Ha, Rb, Re, Aa, Aa, Gs, Gs, Ss, Ss, Sm^Qhu, Sm^Qhu, Wwrg^Qhu, Ss, Ss, Sm^Qhu, Sm^Qhu, Ss, Ss^Em, Ss, Sm^Qhu, Gd, Aa, Aa, Aa^Esa, Chr^Dr, Ss, Wwrg^Qhu, Wwg^Qhu, Sm^Qhu, Sm^Qhu, Sm^Qhu, Ss, Chr^Edt
Ss, Ai, Ai, Ss, Gs, Gs, Chr, Re, 3 Khr, Cha^Dr, Chr, Rb, Gd, Aa, Ss, Ss, Ss^Em, Ss, Ss, Sm^Qhu, Ss^Em, Wwrg^Qhu, Ss, Ss, Sm^Qhu, Ss, Sm^Qhu, Sm^Qhu, Wwg^Qhu, Gs^Em, Gs, Aa^Esa, Ss, Aa, Gd^Fdw, Ss, Ss, Ss, Sm^Qhu, Ss^Em, Ss, Ss
Ss, Ss, Ss, Ss, Aa, Chr^Dr, Cha^Dr, Urb^Qhu, Urb^Qhu, Chr, Chr^Dr, Gs, Gs, Gd, Ss, Ss, Ss, Ss, Ss, Ss, Ss, Wwrg^Qhu, Wwrg^Qhu, Wwrg^Qhu, Ss, Ss, Sm^Qhu, Sm^Qhu, Ss, Gs, Chs, Chs, Chs, Sm^Qhu, Sm^Qhu, Sm^Qhu, Sm^Qhu, Chs, Sm^Qhu, Sm^Qhu, Ss, Ss
