Uhe^Qhh, Uhe^Qhh, Xur, Uue, Uue, Uhe^Qhh, Xur, Xur, Xu, Gg, Ms^Xm, Gg, Ha, Ms, Ms, Gg, Ms, Ms, Ms, Ms, Ms, Ms, Ms^Qhh, Ha, Ha, Aa, Ms, Aa^Qhh, Ms^Qhh, Aa^Qhh, Ms^Qhh, Ms^Qhh, Ha^Qhh, Ha^Qhh, Ha^Qhh, Ms^Qhh, Ms^Qhh, Aa^Qhh, Ms^Qhh, Aa^Qhh, Ha^Qhh, Ha^Qhh
Uue, Uu, Xur, Xur, Ke, Uu, Ha, Xur, Ms^Xm, Ms^Xm, Ha, Ms^Xm, Ms^Xm, Ms, Ms, Ms, Ms, Ms, Ms, Ms, Ms^Qhh, Ms^Qhh, Ha^Fma, Ha, Ai, Aa, Ha, Ms, Ms^Qhh, Ms^_mhh, Ms^Qhh, Ms^_mhh, Ms^Xm, Ms^Xm, Ms, Ms, Ms, Ms^Xm, Ms^Qhh, Ms^_mhh, Ms^Qhh, Ms^Qhh
Uhe^Qhh, Uue, Uu, Ha, Cea, Cea^Esa, Aa, Ha^Esa, Aa, Ms^Xm, Ha^Fma, Ms, Ms, Ms, Ms, Ms^Xm, Ms, Ms, Ms^Qhh, Ms^Qhh, Aa, Ha^Esa, Ai, Ai, Ai, Ai, Ai, Ha, Ha^Fpa, Ms^Qhh, Ms, Ms^Qhh, Ms^Qhh, Ha^Qhh, Ms^Qhh, Ha^Qhh, Ms^Qhh, Ms^Qhh, Ms, Ms^Qhh, Ms, Ms^Xm
Xur^Qhh, Xur, Ha, Aa, Re, Aa, Hhd, Aa, Ms, Ha, Ha^Esa, Ha^Fma, Aa, Ms, Ms, Ms, Ms^Xm, Ms, Ms^Qhh, Ms, Ha, Ai, Ai, Ai, Ai, Wwg, Ai, Ha, Ha^Fma, Ms, Ms, Ms, Ms, Ms^Xm, Ms, Ms, Ms, Ms^Xm, Ms^Xm, Ms, Ha^Fma, Ha^Fma
Xur^Qhh, Xur^Qhh, Ms^Qhh, Aa, Aa^Esa, Re, Rb, Ha^Esa, Ha^Esa, Ms, Ms^Xm, Ha^Fpa, Aa, Ha^Esa, Ha^Fma, Ms^Xm, Ms^Xm, Ms, Ms^Qhh, Ha^Fpa, Ha^Fma, Ha, Ai, Ai, Ai, Ai, Ai, Ai, Ai, Ha^Fpa, Aa, Ha, Ha, Ms, Ha^Dr, Ms, Ha, Ms, Ha^Esa, Ha, Ha^Esa, Aa
Ms^Qhh, Ms^Xm, Ms^Qhh, Ha, Aa, Re, Aa, Aa, Ha^Esa, Ms, Ms, Ms, Ms, Aa, Ms, Ms, Ms^Xm, Ms, Ms^Xm, Ms^Qhh, Ms^Qhh, Ha, Ha^Vha, Ha, Ha, Ai, Ai, Ai, Ai, Ai, Ai^Qhh, Ha^Vha, Gs, Gd, Gd, Hhd, Aa, Ha, Ms, Ms, Ms, Ha
Ms^Qhh, Ms, Ha^Qhh, Aa, Re, Re, Hhd, Aa, Gd, Gd, Ha, Ms, Ms, Ha, Ms, Ms^Xm, Ms^Xm, Ms^Xm, Ms, Ms^Xm, Ms^Qhh, Ms^Xm, Ms^Xm, Ms^Xm, Ms^Xm, Ha^Fma, Ha^Fpa, Aa^Esa, Aa^Qhh, Ai^Qhh, Aa, Aa^Qhh, Ha^Dr, Gd, Hhd, Hhd, Md, Ms, Ms^Xm, Ms, Ms, Ms
Ms^Qhh, Ha, Ms, Ha^Qhh, Aa, Gd, Hhd, Hhd, Hhd, Gd, Ha^Fma, Ms, Ms, Aa, Ha, Ms^Xm, Ms^Xm, Ha, Ms, Ms^Xm, Ms^Qhh, Ms, Ha^Fpa, Ms, Hhd, Ms, Hhd, Aa, Ha^Qhh, Ha^_mh, Ms^Qhh, Chr^Dr, Chr^Kov, Hhd, Ms, Md, Ms, Ms^Xm, Ms, Ms^Xm, Ms^Xm, Ms^Xm
Ha^Qhh, Ha^_mhh, Ms, Ha^Qhh, Gd, Gd, Re, Ms, Ms^Xm, Ha, Ha^Fma, Ha, Aa^Vha, Ha, Ms^Xm, Ms^Xm, Ms^Xm, Ms^Xm, Ms^Qhh, Ms^Qhh, Ha^Esa, Hhd, Hhd, Aa^Fpa, Aa^Fma, Hhd, Gd, Aa^Fma, Ha^Fpa, Ms^Qhh, Ha, Ms^Qhh, Ms^Qhh, Ms^Qhh, Ms^Qhh, Ms^Qhh, Ms^Qhh, Ms, Ms^Xm, Ms^Xm, Ms^Xm, Ms^Xm
Ms^Qhh, Ms, Ha^Qhh, Ha^Qhh, Aa, Rb, Ha^Fpa, Ms, Ms, Ms, Ms, Ha^Fpa, Ha^Fma, Ms^Xm, Ms^Xm, Ms^Xm, Ms^Xm, Ms^Qhh, Ha, Ha, Hhd, Hhd, Gd, Aa, Aa^Esa, Gd, Gd, Aa^Esa, Aa, Aa, Aa^Fpa, Ha^Esa, Aa, Ha, Aa, Ha, Aa, Ms^Qhh, Ha^Qhh, Md^Qhh, Md^Qhh, Ha^Qhh
Ms^Qhh, Ms^Qhh, Ha, Aa^Esa, Ha, Rb, Aa, Ha^Fma, Aa, Ms, Ms, Ha^Qhh, Md^Xm, Md^Xm, Ms^Xm, Ms^Xm, Ha^Qhh, Ha^Qhh, Aa, Cea, Cea^Esa, Aa, Gs, Gd, Gd, Gd, Aa^Fpa, Gd, Gd, Aa^Fpa, Gd, Aa, Aa, Aa, Aa, Aa, Ss, Aa^Esa, Hhd, Md, Hhd, Md
Ms, Ha^Fma, Aa, Aa, Ms, Ha^Esa, Aa, Aa^Fpa, Rb, Ha^Fpa, Ha, Md^Qhh, Md^Xm, Md^Xm, Md^Xm, Ms^Qhh, Ha^Edt, Cea, Cea^Edt, Aa, Aa^Edt, Aa, Aa, Gd, Gs, Aa, Aa, Gd, Aa, Gd, Gd, Gd, Ai, Aa^Vha, Gd, Gd, Aa, Ss, Ss^Em, Ss, Ss, Hhd
Aa, Aa^Esa, Ha^Qhh, Aa, Ms^Qhh, Ms, Ha, Rb, Rb, Aa, Ha^Qhh, Ms^Qhh, Ms^Xm, Md^Xm, Ha^Qhh, Md^Qhh, Ha, 7 Kea^Edt, Cea^Esa, Gd, Gs, Gs, Aa, Aa^Esa, Gs, Aa, Gs, Gd, Sm^Qhu, Gd, Sm^Qhu, Ss, Ss, Ai, Ss^Em, Gd, Gs, Aa, Ss, Sm^Qhu, Sm^Qhu, Sm^Qhu
Aa^Qhh, Ha^Qhh, Ha^Fpa, Ms^Qhh, Ms^Xm, Ms^Qhh, Ha^Fma, Gd, Rb, Hhd, Ms^Qhh, Ms^Xm, Ms^Xm, Ms^_mh, Ha^Qhh, Ha^Vhha, Hhd, Aa^Esa, Aa, Aa, Gd, Gd, Gd, Gd, Gs, Gd, Gs, Wwg^Qhu, Wwrg^Qhu, Wwrg^Qhu, Gd, Gd, Gd^Em, Ss, Gd, Ss, Gs, Aa, Wwg^Qhu, Sm^Qhu, Ss, Sm^Qhu
Ms^Qhh, Ha^Fpa, Ms^Xm, Ms, Ms^Xm, Ms^Qhh, Ms^Qhh, Aa^Fma, Aa, Hhd, Ms^Qhh, Ms^Xm, Md, Md^Xm, Md^Qhh, Hhd, Hhd, Cea^Edt, Ha, Gd, Re, Gd^Vhr, Gs, Aa, Aa, Gd, Gs, Gs, Aa, Gd, Aa, Gd, Aa, Aa, Ss, Gs, Sm^Qhu, Gs, Ss, Wwg^Qhu, Gd, Gd
Ms^Qhh, Ms, Ms^Xm, Ms^Xm, Ms^_mhh, Ms^Qhh, Ha^Fpa, Aa^Fma, Aa^Esa, Ms^Qhh, Ms^Xm, Ms^Xm, Md^Xm, Md^Qhh, Ha, Hhd, Aa, Ha, Ha, Rb, Gd, Gs, Gd, Aa, Gd, Gs, Ha, Aa, Aa, Aa, Aa, Gs, Gs, Aa, Gd, Ss^Em, Ai, Wwrg^Qhu, Wwrg^Qhu, Ss, Ss^Em, Sm^Qhu
Ms^Qhh, Ms^Xm, Ms^Xm, Ms^Xm, Ms^Qhh, Ms^Qhh, Ha, Aa^Fma, Rb, Ms^Qhh, Ms^Qhh, Ms^Xm, Ha, Md^Qhh, Hhd, Aa^Esa, Aa, Aa, Re, Aa, Aa, Gs, Gd, Gd, Gs, Hhd, Ha^Vhha, Ha, Ha, Aa^Esa, Gd, Aa, Gs, Gs, Gd, Aa, Ai, Sm^Qhu, Sm^Qhu, Ss, Ss, Sm^Qhu
Ms^Qhh, Ms, Ms, Ms, Ms^Qhh, Ha, Gd, Rb, Gd, Ha, Ms^Qhh, Ms^Xm, Ms^Xm, Ha^Qhh, Hhd, Aa, Aa, Rb, Aa, Aa, Gd, Aa, Gd, Gs, Gs, Aa, Aa, Aa, Gd, Gd, Gd, Gs, Ss, Gd^Em, Aa, Gd^Vhr, Aa, Ai, Aa, Ss, Chs, Ss
Ms^Qhh, Ms, Ms^Qhh, Ms^Qhh, Ha^Fma, Aa^Fpa, Aa^Fma, Rb, Hhd, Ha, Md^Qhh, Ms^Xm, Ms^Qhh, Ha^Qhh, Hhd, Aa, Rb, Rb, Gd^Em, Gd, Aa, Aa, Gd^Fdw, Gd^Fdw, Gd, Gs, Gd, Gd, Ss, Gd^Em, Wwg^Qhu, Gd, Ss^Em, Ai, Ai, Aa, Aa, Aa^Esa, Aa, Chr^Edt, Chs, Gd
Ha^Qhh, Ha^Esa, Ha^Qhh, Ha^Esa, Aa^Vha, Aa^Fma, Gd, Aa, Ms^Qhh, Ms^Qhh, Md^Xm, Md^Xm, Ms^Qhh, Ha^Fma, Aa^Fpa, Gd, Re, Re, Gs, Gd, Aa, Gd, Gd, Aa^Fdw, Aa, Gd, Aa, Gd, Ss, Ss, Wwg^Qhu, Sm^Qhu, Sm^Qhu, Ai, Ss, Sm^Qhu, Sm^Qhu, Aa, Chr, Chr^Kov, Ss, Ss^Edt
Ms^Qhh, Ms^Qhh, Gd, Gd, Re, Rb, Gd, Hhd, Ms^Qhh, Ms^Xm, Md^Xm, Md^Qhh, Ha^Fma, Ha^Fpa, Aa^Fpa, Aa^Fpa, Gs, Gs, Aa, Aa, Aa, Gd, Ai, Aa, Ss^Vhs, Aa, Aa, Aa, Aa^Esa, Gd, Gd, Ss^Vhs, Ss, Ss, Ss, Sm^Qhu, Sm^Qhu, Aa, Urb^Qhu, Urb^Qhu, Urb^Qhu, Ss
Ms, Ha, Aa, Gd, Re, Re, Aa^Fpa, Ha^Fma, Ha^Feta, Ms^Qhh, Ha^Qhh, Ha^Qhh, Gd, Gd, Re, Re, Gd, Aa, Aa, Aa^Esa, Aa, Ai, Wwrg^Qhu, Gd, Ss, Ss, Aa, Aa, Aa, Gd^Em, Aa, Ss, Gd^Fdw, Ss, Ss, Ss, Rp^Dr, Chr, Chs, Aa, Chs, Ss
Ha, Aa, Ss, Rb, Rb, Aa^Fpa, Rb, Aa^Fma, Ha^Fpa, Md, Hhd, Gd, Gd, Re, Rb, Gd, Aa, Gd, Aa^Esa, Aa, Ai, Wwrg^Qhu, Wwg^Qhu, Wwrg^Qhu, Wwg^Qhu, Wog^Qhu, Gd, Gd, Wwrg^Qhu, Wwrg^Qhu, Gd^Em, Gd, Gd, Aa, Chr, Rp^Dr, Chr, 3 Khr, Chs^Edt, Rp^Dr, Chs, Wwrg^Qhu
Ha, Aa^Esa, Ss, Ss, Gd, Rb, Rb^Dr, Gd, Aa, Hhd, Ha^Vca, Aa, Aa, Rb, Gs, Gd, Ss, Aa, Gd, Ai, Ai, Sm^Qhu, Sm^Qhu, Wwg^Qhu, Wog^Qhu, Wog^Qhu, Ss, Gd, Ss, Wwrg^Qhu, Aa^Esa, Aa, Aa, Chr^Edt, Chr^Kov, Chs, Ss, Chr^Edt, Sm^Qhu, Chs, Chr, Chr^Dr
Gd, Aa, Ss, Ss, Ss, Ss, Gd, Rb, Re, Ha, Rb, Re, Aa, Aa, Gs, Gs, Ss, Ss, Sm^Qhu, Sm^Qhu, Wwrg^Qhu, Ss, Ss, Sm^Qhu, Sm^Qhu, Ss, Ss^Em, Ss, Sm^Qhu, Gd, Aa, Aa, Aa^Esa, Chr^Dr, Ss, Wwrg^Qhu, Wwg^Qhu, Sm^Qhu, Sm^Qhu, Sm^Qhu, Chs, Chr^Edt
Ss, Ss, Ss, Ss, Gs, Gs, Chr, Re, 2 Khr, Cha^Dr, Chr, Ss, Ss, Aa, Ss, Ss, Ss^Em, Ss, Ss, Sm^Qhu, Ss^Em, Wwrg^Qhu, Ss, Ss, Sm^Qhu, Ss, Sm^Qhu, Sm^Qhu, Wwg^Qhu, Gs^Em, Gs, Aa^Esa, Ss, Aa, Gd^Fdw, Ss, Ss, Ss, Sm^Qhu, Chr^Dr, Chs, Ss
Ss, Ss, Ss, Ss, Gs, Ss^Dr, Ss, Urb^Qhu, Urb^Qhu, Urb^Qhu, Ss, Ss, Ss^Dr, Gd, Ss, Ss, Ss, Ss, Ss, Ss, Ss, Wwrg^Qhu, Wwrg^Qhu, Wwrg^Qhu, Ss, Ss, Sm^Qhu, Sm^Qhu, Ss, Gs, Chs, Chs, Chs, Sm^Qhu, Sm^Qhu, Sm^Qhu, Sm^Qhu, Chs, Sm^Qhu, Sm^Qhu, Ss, Ss
