Ms^Qhh, Ms^Qhh, Ms^Qhh, Ms^Qhh, Ms^Qhh, Ms^Qhh, Ms^Qhh, Ms^Qhh, Ms^Qhh, Ms^Qhh, Ms^Qhh, Ms^Qhh, Aa^Fpa, Aa^Fpa, Aa^Fpa, Aa^Fpa, Aa^Fma, Aa^Fpa, Aa^Fpa, Aa^Fpa, Ha^Fpa, Aa^Fpa, Ms^Qhh, Ms^Qhh, Ms^Qhh, Ms^Qhh, Ms^Qhh, Aa^Qhh, Ms^Qhh, Ms^Qhh, Ms^Qhh, Ms^Qhh, Ms^Qhh
Ms^Qhh, Ms^Xm, Ms^Xm, Ms^Xm, Ms^Xm, Ms, Ms^Xm, Ms, Ms^Qhh, Ms^Qhh, Ms^Qhh, Ms^Qhh, Ha^Fma, Ha^Fpa, Aa^Fpa, Aa^Fpa, Aa^Fma, Aa^Fpa, Ha, Ha^Fpa, Ha, Ha^Fpa, Ms^Qhh, Ms, Ms, Ms^Xm, Ha, Ms, Ms, Ms, Ms^Xm, Ms^Xm, Ms^Qhh
Ms^Qhh, Ms, Ms^Xm, Ms^Xm, Ms, Ms^Xm, Ha^Qhh, Ha^Qhh, Aa, Ms^Qhh, Ms, Coa^Esa, Aa^Fpa, Ha^Fpa, Aa, Aa, Coa, Rb^Voa, Rb^Esa, Ha, Aa, Ha, Ha^Voa, Ha^Qhh, Ha^Qhh, Ms, Ha^_mh, Ms, Ms, Ms, Ms^Xm, Ms, Ms^Qhh
Ms^Qhh, Ms^Xm, Ms, Ms^_mh, Ms^Qhh, Ms^Qhh, Ms^Qhh, Aa^Voa, Aa, Ha, Ha, Aa^Fpa, Aa^Fpa, Aa^Fpa, Aa, Coa^Esa, 2 Koa, Rb^Esa, Coa, Aa, Aa, Aa, Aa^Fpa, Aa, Coa^Esa, Ha^Qhh, Ha, Ha, Ms, Ms, Ms, Ms^Xm, Ms^Qhh
Ms^Qhh, Ms, Ms^Qhh, Ms^Qhh, Coa^Dr, Coa^Kov, Aa^Dr, Aa, Aa, Aa, Ha^Fpa, Ha^Fma, Ha^Fpa, Aa, Aa, Coa^Dr, Aa, Aa, Coa, Rb^Esa, Rb^Esa, Aa^Fpa, Ha^Fpa, Ha^Fpa, Ms, Ms^Qhh, Ms^Qhh, Ms^Qhh, Ha^Qhh, Ms, Ms, Ms, Aa^Qhh
Ms, Ms^Qhh, Ms^Qhh, Ha, Aa, Rd^Esa, Rb^Esa, Aa, Aa, Aa, Ha, Ha^Fpa, Ha, Aa, Aa, Aa, Aa, Coa^Esa, Aa, Aa, Rd^Esa, Aa^Fpa, Aa, Ha^Fpa, Ha, Ha, Aa, Aa, Aa, Ha^Qhh, Ha^Qhh, Ms, Ms^Qhh
Ha, Ha, Ha^Dr, Aa, Aa, Rb^Esa, Rb^Esa, Aa, Aa, Aa, Aa, Ha^Voa, Rd^Edt, Rb^Esa, Rd^Esa, Aa, Aa, Aa, Aa, Aa, Aa, Aa, Aa, Aa, Aa, Aa, Rd^Esa, Aa, Ha, Aa, Aa, Ha^Qhh, Ha
Aa, Aa, Aa^Esa, Aa^Esa, Aa^Esa, Aa^Esa, Aa, Aa, Rd^Esa, Aa^Esa, Aa, Aa^Edt, Aa, Coa^Esa, Aa, Aa, Rb^Esa, Rd^Esa, Aa, Aa^Fpa, Aa^Fpa, Aa, Aa, Aa^Voa, Rd^Esa, Rd^Esa, Aa, Aa, Ha, Ha, Ha^Fpa, Ha, Ha
Ha, Aa, Aa, Aa, Aa, Aa, Aa, Aa, Aa^Esa, Rb^Esa, Rb^Esa, Aa, Aa, Aa, Aa, Rb^Esa, Aa, Rd^Esa, Aa, Aa^Fma, Aa^Fma, Aa^Fpa, Coa^Esa, Coa^Kov, Aa, Rd^Esa, Aa, Aa, Aa^Fpa, Aa^Fpa, Ha^Fpa, Ha^Fpa, Ha^Fpa
Ha, Ha, Ha^Vca, Ha, Aa^Esa, Aa^Esa, Aa^Esa, Aa^Esa, Aa, Aa, Rb^Esa, Aa, Rb^Esa, Aa, Aa, Aa, Aa, Aa, Aa^Fpa, Aa, Aa, Aa^Fpa, Aa, Coa^Dr, Aa, Aa, Aa, Ha^Fpa, Aa, Ha, Ha^Fpa, Ha, Ha
Ha, Ha, Ha, Ha, Aa, Aa, Aa, Aa, Rb^Esa, Rd^Esa, Rd^Esa, Rd^Esa, Aa, Aa, Aa, Aa, Aa, Rd^Esa, Aa^Voa, Aa^Fpa, Aa, Aa, Ha, Aa, Ha, Aa, Ha^Dr, Ha^Fpa, Ha^Fpa, Ha^Fpa, Ms^Xm, Ms, Ms
Ha, Ha, Aa^Esa, Aa, Aa, Aa, Aa^Esa, Aa, Aa^Esa, Aa, Aa, Rb^Esa, Aa, Aa, Aa, Ha, Ha, Aa, Aa, Aa^Edt, Rd^Esa, Aa, Aa^Dr, Ha, Ms, Ms, Ms, Aa^Fpa, Ms, Ms^Xm, Ms, Ms^Xm, Ms^Xm
Aa^Esa, Aa^Esa, Rb^Esa, Aa, Aa, Rb^Esa, Rb^Esa, Rd^Esa, Aa, Aa, Rb^Esa, Rb^Esa, Aa, Aa, Aa, Ha^Dr, Ms, Ha, Ha, Aa, Aa, Rd^Esa, Aa, Aa, Ha, Ms^Xm, Aa^Fpa, Ms^Xm, Ms, Ms, Aa, Ms, Ms
Rd^Esa, Rb^Esa, Aa, Rd^Esa, Aa, Aa, Aa, Aa, Aa, Aa, Aa, Aa, Aa^Esa, Aa^Esa, Coa^Esa, Ms, Ms, Ha, Ha^Fpa, Aa, Aa, Rd^Esa, Rb^Esa, Aa, Aa, Ms, Aa^Fpa, Aa^Fpa, Ha^Fpa, Ms, Aa, Aa^Voa, Aa
Aa, Aa, Aa, Aa, Ha, Aa, Aa^Voa, Aa, Aa, Aa, Aa, Aa, Aa^Esa, Aa, Coa^Dr, Coa^Kov, Ms, Ha, Ha^Fpa, Aa^Fma, Aa, Aa, Rb^Esa, Aa, Aa, Aa^Fpa, Aa, Aa^Fpa, Ha^Fpa, Ha, Aa^Fpa, Aa, Aa
Aa, Aa, Ha, Aa, Ha, Ha, Ha, Aa^Edt, Aa, Aa, Aa, Aa, Aa, Aa, Aa, Ha^Dr, Ms^Xm, Ha, Ha^Fpa, Aa^Fpa, Aa, Aa, Aa, Aa, Aa, Aa, Aa, Aa^Fpa, Ms, Aa^Fpa, Aa^Fpa, Aa, Aa
Aa, Aa, Aa, Ms, Ms, Ha, Ha, Aa, Aa, Rd^Esa, Rb^Esa, Aa, Aa, Aa, Aa^Fpa, Ha, Ha^Edt, Ms, Ha^Edt, Ha, Aa^Fpa, Aa, Aa^Voa, Aa, Aa, Aa, Aa, Ms, Ms, Aa, Aa, Aa, Aa
Aa, Aa, Aa, Ha, Ms, Ms^Xm, Ms, Aa, Aa, Aa, Rb^Esa, Aa, Aa, Aa, Aa^Fpa, Ha^Fpa, Ha, Coa^Ecf, Ms, Ha, Aa, Aa^Edt, Aa^Edt, Aa, Aa, Aa, Aa, Ha, Aa, Aa, Aa^Esa, Aa^Esa, Aa
Aa, Aa, Aa, Aa, Ha, Ms, Ms, Aa, Aa, Aa, Rd^Esa, Aa, Aa, Aa, Aa, Ha, Aa^Fpa, Ha, Ms^Xm, Ha, Ha, Aa, Rb^Esa, Aa, Aa, Aa, Aa^Esa, Aa, Aa, Aa^Esa, Aa, Aa, Aa
Aa, Aa, Ms, Ha, Ms, Ms, Ms, Ha, Aa, Aa, Aa, Rb^Esa, Aa, Aa, Aa, Aa^Fpa, Aa, Ha^Fpa, Ms^Xm, Ms, Aa, Aa, Rb^Esa, Aa, Aa, Aa^Esa, Aa, Aa, Rb^Esa, Aa^Esa, Rd^Esa, Aa, Aa
Aa, Aa, Aa, Ha, Ms, Ms, Ai, Wwrg, Wwrg, Aa, Aa, Aa, Aa, Aa^Voa, Rd^Edt, Aa, Aa, Ha, Ms^Xm, Ms, Ha, Aa, Aa, Rb^Esa, Aa, Aa^Esa, Aa^Esa, Aa, Rb^Esa, Rb^Esa, Aa^Esa, Aa, Aa
Ha, Aa, Ha, Ha, Ms, Ai, Ha, Wwrg, Aa, Aa, Aa, Aa, Aa, Aa, Rd^Esa, Aa, Aa, Ha, Ha, Ms^Xm, Ha, Aa, Aa, Rd^Esa, Rb^Esa, Aa, Aa^Esa, Aa, Rd^Esa, Aa, Aa, Aa^Esa, Aa
Ha, Ha, Ha, Ms, Ai, Ai, Ha, Aa, Aa, Aa, Aa, Rb^Esa, Aa, Aa, Aa, Aa, Aa^Esa, Aa, Aa^Esa, Ms, Ha, Aa, Aa, Rb^Esa, Aa, Aa, Aa, Aa, Aa, Aa, Aa, Aa^Esa, Aa
Ms, Ms^Xm, Ms, Ms, Ai, Ha, Aa, Aa, Aa^Edt, Aa, Rb^Esa, Rb^Esa, Aa, Aa, Aa, Aa, Aa, Ha, Ha, Ha, Ha^Edt, Aa^Esa, Aa, Rb^Esa, Aa, Aa, Aa, Aa, Aa, Aa, Aa, Aa, Aa
Ms, Ms, Wwrg, Ai, Ms, Ai, Wwg, Aa^Voa, Aa, Aa, Aa, Aa, Aa, Aa, Aa, Aa^Esa, Aa, Ha^Fpa, Ms, Ha^Fma, Ha^Fda, Ha, Ha, Aa, Aa, Aa^Voa, Rb^Esa, Aa, Aa, Ha, Ha, Ha, Aa^Qhh
Ms, Ha, Ms, Ms, Ms^Xm, Ha, Ha, Ha, Ha, Aa, Aa, Aa, Rd^Esa, Aa, Aa, Aa, Aa^Fpa, Ha, Ha, Ms^Xm, Ha, Ha, Aa^Fda, Aa^Fma, Aa, Aa, Rb^Esa, Aa, Ha, Ha, Ha^Qhh, Ha^Qhh, Ha^Fma
Ms, Ms^Xm, Ms, Ms, Ms, Ms, Ms, Ms, Aa^Fpa, Aa, Aa, Aa, Rd^Esa, Aa, Aa, Aa^Fpa, Ha^Vca, Aa^Fma, Ms, Ms^Xm, Ha^Fda, Ha, Ha, Aa^Fma, Aa, Rb^Esa, Aa, Aa, Aa^Fma, Ha, Ha^Qhh, Ha^Fma, Ha^Fma
Ms, Ms^Xm, Ms, Ms, Wwrg, Ms^Xm, Ms, Aa^Fpa, Aa^Fpa, Aa^Fma, Ha, Aa, Rb^Esa, Rb^Esa, Aa, Aa^Fpa, Ha, Ha, Aa^Fda, Ms^Xm, Ms, Ha, Aa, Aa, Rd^Esa, Rd^Esa, Aa, Aa^Fma, Aa^Fma, Aa^Fma, Ha^Qhh, Ha^Fma, Ha^Fma
Ms^Xm, Ms, Ms, Ha, Ai, Ms, Ms, Ms^Xm, Ms, Ms, Ha, Aa, Aa, Rb^Esa, Aa, Aa, Ha, Ha, Ha, Ms, Ms, Ha, Aa, Aa, Aa, Aa, Aa^Esa, Aa^Fma, Ha^Fma, Ha^Fma, Ha^Qhh, Ha^Fma, Ha^Fma
Ms^Xm, Ms^Xm, Ha, Ms, Ai, Ai, Ai, Ms, Ha^Fma, Ha^Fpa, Aa, Aa, Aa, Aa, Aa^Esa, Aa, Aa, Aa, Aa, Ha, Ha, Ha, Aa, Aa^Vca, Aa, Aa, Aa, Aa, Ha^Qhh, Ha^Qhh, Ha, Ms, Ms
Ms^Xm, Ms, Aa^Fpa, Ha, Ms, Ha^Fpa, Ai, Ai, Ai, Aa^Fpa, Aa, Aa, Aa, Aa, Aa, Aa, Aa, Aa^Esa, Aa, Ha, Rb^Esa, Rd^Esa, Aa, Aa, Aa, Aa, Ha, Ha^Qhh, Ha^_mh, Ha, Ha, Ms, Ms^Xm
Ms^Xm, Ms, Aa^Fpa, Ms, Ha, Aa^Fpa, Aa^Fpa, Aa^Fpa, Aa^Fpa, Aa, Aa^Esa, Aa, Aa^Esa, Aa, Aa, Aa, Aa, Aa, Aa, Aa, Rb^Esa, Aa, Aa, Aa^Esa, Aa, Aa, Ms^Qhh, Ms^Qhh, Ms^Qhh, Ha^Qhh, Ms^Qhh, Ms^Xm, Ms
Ms^Xm, Ms^Xm, Ms, Ms, Ha, Ms, Ha, Aa^Vla, Aa, Aa^Esa, Aa, Aa^Esa, Aa^Esa, Aa, Aa, Rb^Esa, Rb^Esa, Aa, Aa, Rb^Esa, Aa, Aa, Ai, Aa, Aa, Ha^Qhh, Ha^Qhh, Ms^Qhh, Ms^Qhh, Wwrg, Aa, Ms^Qhh, Ms^Qhh
Ms, Ms, Ms^Xm, Ms, Ms, Ms, Ha, Aa, Aa, Aa, Aa, Aa, Aa, Aa^Esa, Aa, Aa, Aa, Aa^Voa, Aa, Aa, Aa, Aa, Ai, Ai, Ai, Ai, Ai, Ha^Qhh, Wwg, Wwrg, Ai, Ai, Aa
Ms, Ms, Ms, Ms, Ms, Ha, Aa, Aa, Ha, Ha, Ha^Qhux, Ha, Aa, Aa, Aa, Aa, Aa, Rd^Esa, Rd^Esa, Aa, Aa, Ai, Ai, Ai, Ai, Ai, Wog, Wog, Wog, Ai, Ai, Ai, Ai
Ha, Ha, Ha, Ms, Ha, Ha, Ha^Qhux, Ha^Qhux, Ms^Qhux, Ms^Qhux, Ms, Ha^Qhux, Ha^Qhux, Aa, Aa, Aa, Aa, Aa, Rb^Esa, Aa, Aa, Aa^Esa, Wwg, Wwg, Wwrg, Ai, Ai, Ai, Ai, Ai, Ai, Ai, Ai
Ha^Qhux, Ha^Qhux, Ha^Qhux, Ha, Ha^Qhux, Ha^Qhux, Ms, Ms, Ms, Ms^Xm, Ms, Ms, Ha^Qhux, Aa^Vca, Ha^Qhux, Aa, Aa, Aa, Aa, Rb^Esa, Aa, Aa, Ha, Wwrg, Ha^Qhh, Ha^Qhh, Ms^Qhh, Aa^Esa, Wwg, Wwg, Ms^Qhh, Ms^Qhh, Ms^Qhh
Ms^Qhux, Ms, Ms, Ha^Qhux, Ha^Qhux, Ha^Qhux, Ms^_ml, Ms, Ms^Xm, Ms^Xm, Ms, Ms, Ha^Qhux, Ha^Qhux, Ha^Qhux, Aa, Aa^Esa, Aa, Aa, Aa, Aa, Aa, Aa, Ha, Ha^Qhh, Ms, Ms^Xm, Ms^Qhh, Ms^Qhh, Ms^Qhh, Ms, Ms^Xm, Ms
Ms^Qhux, Ms, Ms^Xm, Ms, Ms^Xm, Ms, Ms, Ms, Ms^Xm, Ms^Xm, Ms^Xm, Ms, Ha^Qhux, Ha^Qhux, Ha^Qhux, Ha^Qhux, Aa^Esa, Aa, Aa, Rb^Esa, Rb^Esa, Aa, Ha, Ha^Qhh, Ha^Qhh, Ha^_mh, Ms, Ms, Ms, Ms, Ms^Xm, Ms, Ms^Xm
Ms^Qhux, Ms^Xm, Ms^Xm, Ms, Ms^Xm, Ms^Xm, Ms^Xm, Ms^Xm, Ms^Xm, Ms, Ms^Qhux, Ha^Qhux, Ms^Qhux, Ms^Qhux, Ha^Qhux, Ha^Qhux, Ha^Qhux, Aa, Rd^Esa, Rb^Esa, Rb^Esa, Aa, Aa, Ha, Ha, Ha^Qhh, Ha^Qhh, Ha, Ha, Ms, Ms^Xm, Ms^Xm, Ms^Xm
