Mm^Qhh, Mm^Qhh, Mm^Qhh, Mm^Qhh, Mm^Qhh, Mm^Qhh, Ha^Qhh, Mm^Qhh, Mm^Qhh, Mm^Qhh, Mm^Qhh, Mm^Qhh, Mm^Qhh, Mm^Qhh, Mm^Qhh, Mm^Qhh, Mm^Qhh, Mm^Qhh, Mm^Qhh, Aa^Qhh, Ha^Qhh, Mm^Qhh, Mm^Qhh, Mm^Qhh, Mm^Qhh, Mm^Qhh, Mm^Qhh, Mm^Qhh, Ha^Qhh, Mm^Qhh, Mm^Qhh, Mm^Qhh, Mm^Qhh, Mm^Qhh, Mm^Qhh, Mm^Qhh, Mm^Qhh, Mm^Qhh, Mm^Qhh, Mm^Qhh, Mm^Qhh, Mm^Qhh, Mm^_mhh, Mm^Qhh, Mm^Xm, Mm^Xm, Mm^Xm, Mm^Xm, Mm^Xm, Mm^Qhh, Mm^Xm, Mm^Qhh, Mm^Qhh, Mm^Qhh, Wo, Wo, Wo
Mm^Qhh, Mm^Xm, Mm^Xm, Mm^Xm, Mm^Xm, Mm^Xm, Ha^_mhh, Mm^Xm, Mm^Xm, Mm^Xm, Mm, Mm^Xm, Mm^Xm, Mm^Xm, Mm^Xm, Mm^Xm, Mm^Xm, Mm^Xm, Mm^Xm, Ha^Fpa, Ha^_mhh, Mm^Xm, Mm^Xm, Mm^Xm, Mm^Xm, Mm^Xm, Mm^Xm, Mm^Xm, Ha, Mm^Xm, Mm, Mm^Xm, Mm^Qhh, Mm^Xm, Mm^Xm, Mm^_mhh, Mm^Qhh, Mm^Qhh, Mm^Qhh, Mm^Qhh, Mm^Qhh, Mm^Xm, Mm^Qhh, Mm^Xm, Mm^Qhh, Mm^Xm, Mm^Qhh, Mm^Qhh, Mm^Qhh, Mm^Xm, Mm^Qhh, Mm^Xm, Mm^Qhh, Mm^Qhh, Wo, Wo, Wo
Mm^Qhh, Mm^Xm, Mm^Xm, Ha^Fpa, Mm^Qhh, Mm^Xm, Mm, Mm^Xm, Ha^Fpa, Mm^Xm, Mm^Xm, Mm, Mm^Qhh, Mm^Qhh, Mm^Qhh, Mm^Qhh, Mm^Qhh, Mm^Qhh, Mm^Qhh, Mm^Xm, Mm, Mm^Xm, Ha^Fpa, Mm^Xm, Mm, Ha^Fpa, Mm^Xm, Mm, Mm^Xm, Ha^Fpa, Mm^Qhh, Mm^Qhh, Ww, Mm^Qhh, Mm^Qhh, Mm^Qhh, Ww, Ww, Ww, Ww, Ww, Mm^Qhh, Ww, Mm^Qhh, Ww, Mm^Qhh, Wo, Wo, Wo, Hh^Qhh, Wo, Mm^Qhh, Wo, Wo, Wo, Wo, Wo
Mm^Qhh, Mm^Qhh, Hh^Qhh, Mm^Qhh, Wwf, Mm^Qhh, Hh^Qhh, Mm^Qhh, Mm^Qhh, Mm^Xm, Mm^Qhh, Mm^Qhh, Wwf, Ww, Ww, Ww, Ww, Ww, Ww, Mm^Qhh, Mm^Qhh, Mm^Qhh, Mm^Qhh, Mm^Xm, Mm^Qhh, Mm^Xm, Mm^Qhh, Mm^Xm, Mm^Qhh, Mm^Qhh, Ww, Ww, Ww, Ww, Ww, Ww, Wwf, Wwf, Mm, Mm, Mm, Ww, Ww, Ww, Ww, Ww^Qhh, Ww^Qhh, Wo, Wo, Wo, Wo, Wo, Wo, Wo, Wo, Wo, Wo
Wwf, Wwf, Ww, Ww, Ww, Ww, Ww, Wwf, Ww, Mm^Qhh, Wwf, Wwf, Wo, Wwf, Wo, Ww, Ww, Ww, Ww, Ww, Ww, Ww, Ww, Mm^Qhh, Wwf, Mm^Qhh, Wwf, Mm^Qhh, Ww, Ww, Ww, Ww, Mm, Ww, Ww, Ww, Ww, Hh, Mm, Mm^Vd, Mm, Wwf, Ww, Ww^Qhh, Ww, Ww, Ww^Qhh, Wo, Wo, Wo, Wo, Wo, Wo, Wo, Wo, Wo, Wo
Ww, Ww, Ww, Ww, Ww, Ww, Ww, Ww, Ww, Ww, Ww, Ww, Ww, Wo, Ww, Ww, Mm, Ww, Ww, Ww, Ww, Ww, Ww, Ww, Ww, Ww, Ww, Ww, Ww, Ww, Mm, Mm^Vd, Mm, Ww, Ww, Ww^Vm, Ww, Ww, Ww, Mm, Hh, Ww, Ww^Qhh, Ww^Qhh, Mm, Ww, Ww, Ww^Qhh, Wo, Wo, Wo, Wo, Wo, Wo, Wo, Wo, Wo
Wwf, Wwf, Wwf, Ww, Ww, Ww^Vm, Ww, Ww, Ww, Ww, Ww, Ww, Ww, Ww, Ww, Mm, Mm^Vd, Mm, Gs^Fp, Ww, Ww, Ww, Hh, Ww, Ww, Ww, Ww, Ww^Vm, Ww, Wwf, Hh, Mm, Ww, Ww, Ww, Ww, Ww, Ww, Wwf, Ww, Ww, Ww, Ww^Qhh, Mm, Ww, Ww, Ww^_mh, Ww^Qhh, Wo, Wo, Wo, Wo, Mm, Mm, Mm, Mm, Mm
Gs, Ce, Ce, Wwf, Wwf, Ww, Ww, Ww, Ww, Ww, Ww, Ww^Vm, Ww, Ww, Ww, Mm, Mm, Hh, Hh, Ww, Ww, Wwf, Mm^Vd, Mm, Wwf, Wwf, Ww, Ww, Ww, Ww, Ww, Ww, Ww, Ww, Ww, Ww, Ww, Wwf, Mm, Ww, Ww, Ww, Ww, Ww^Qhh, Ww, Ww, Ww^Qhh, Ww^Qhh, Hh, Wo, Mm^Xm, Mm, Mm, Ha^Fpa, Mm, Mm, Mm
Mm, 1 Ke, Mm, Ce, Mm, Ww, Mm, Ww, Ww, Ww, Ww, Ww, Ww, Ww, Ww, Ww, Wwf, Wwf, Wwf, Ww, Ww, Ww, Mm, Mm, Ww, Ww, Ww, Ww, Mm, Ww, Ww, Ww, Wo, Wo, Wo, Ww, Ww, Mm, Mm^Vd, Mm, Ww, Ww, Wo, Ww^Qhh, Ww^Qhh, Ww^Qhh, Mm, Mm, Mm, Mm^Xm, Mm^Xm, Ai, Mm^Xm, Mm, Ha^Fpa, Mm, Mm
Mm, Mm, Mm, Mm, Mm, Mm, Mm, Ww, Ww, Ww, Ww, Ww, Mm, Ww, Ww, Ww, Ww, Ww^Vm, Ww, Ww, Ww, Ww, Wwf, Ww, Ww, Ww, Wwf, Mm, Mm^Vd, Mm, Wwf, Ww, Ww, Wo, Ww, Ww, Ww, Mm, Mm, Mm, Ww, Ww, Ww, Ww, Wwf, Hh, Mm, Mm, Ha, Ha^Fpa, Mm^Xm, Mm^Xm, Mm^Xm, Mm^Xm, Ha, Mm^Xm, Mm^Xm
Gs, 3 Ke, Ce, Mm^Xm, Mm^Xm, Mm, Ww, Ww, Ww, Ww, Ww, Mm, Mm^Vd, Mm, Wwf, Ww, Ww, Ww, Wo, Ww, Ww, Ww, Ww, Ww, Ww, Ww, Ww, Mm, Mm, Wwf, Ww, Ww, Ww, Ww, Ww, Ww, Ww, Ww, Ww, Wwf, Ww, Ww, Ww, Ww, Ww, Mm, Mm, Mm, Mm^Xm, Mm^Xm, Mm^Xm, Ha, Mm^Xm, Mm^Xm, Mm^Xm, Mm^Xm, Mm^Xm
Gg, Ce, Rd, Gs^Fp, Ww, Ww, Ww, Ww, Ww, Ww, Ww, Mm, Mm, Gs^Fp, Wwf, Ww, Ww, Ww, Ww, Ww, Ww, Ww, Wwf, Ww, Wwf, Ww, Ww, Ww, Ww, Wwf, Ww, Ww, Ww, Ww, Mm, Ww, Ww, Ww^Vm, Ww, Ww, Hh, Mm, Mm, Ww, Ww, Ww, Ww, Mm, Mm, Mm^Xm, Ha, Mm^Xm, Mm^Xm, Ha^Fpa, Mm^Xm, Mm^Xm, Mm^Xm
Gs^Fp, Gs^Fp, Ww, Wwf, Ww, Ww, Wwf, Gg, Ww, Wwf, Wwf, Mm, Hh, Wwf, Ww, Wwf, Ww, Ww, Ww^Vm, Ww, Wwf, Ww, Hh, Mm, Mm, Wwf, Ww, Ww, Ww, Ww, Ww, Ww, Wwf, Mm, Mm^Vd, Hh, Wwf, Ww, Ww, Wwf, Gs^Fp, Mm^Vd, Hh, Ww, Ww, Ww^Vm, Ww, Ww, Ww, Mm, Mm, Mm^Xm, Mm, Mm, Mm, Mm^Xm, Mm^Xm
Ww, Ww, Ww, Ww, Ww^Vm, Ww, Ww, Gs^Fp, Ww, Ww, Ww, Ww, Ww, Ww, Ww, Ww, Ww, Ww, Ww, Ww, Ww, Wwf, Hh, Mm^Vd, Mm, Mm, Ww, Ww, Ww, Wo, Ww, Ww, Ww, Mm, Wwf, Hh, Wwf, Ww, Ww, Ww, Wwf, Mm, Ww, Ww, Ww, Ww, Ww, Ww, Ww, Ww, Wwf, Hh, Hh, Mm, Mm, Mm^Xm, Mm^Xm
Ww, Ww, Ww, Ww, Ww, Ww, Ww, Ww, Ww, Ww^Vm, Ww, Ww, Ww, Ww, Ww, Ww, Wwf, Ww, Ww, Ww, Ww, Ww, Ww, Mm, Ww, Ww, Ww, Ww^Vm, Ww, Wo, Ww, Ww, Ww, Ww, Ww^Vm, Wwf, Ww, Ww, Ww, Ww, Ww^Vm, Ww, Ww, Ww, Wwf, Wwf, Hh, Ww, Ww, Ww, Ww, Wwf, Wwf, Mm, Mm, Mm^Xm, Mm^Xm
Ww, Ww, Ww, Ww, Ww, Ww, Ww, Ww, Ww, Ww, Ww, Ww, Mm, Ww, Mm, Mm, Mm, Mm, Mm, Ww, Ww, Ww, Ww, Ww, Ww, Ww, Ww, Ww, Ww, Ww, Ww, Ww, Ww, Ww, Ww, Ww, Ww, Ww, Ww, Ww, Ww, Ww, Ww, Ww, Mm, Mm, Mm, Wwf, Ww, Ww, Ww, Ww, Wwf, Hh^Fp, Mm, Mm, Mm
Ww, Ww, Mm, Ww, Mm, Ww, Wwf, Ww, Mm, Ww, Mm, Mm, Mm, Mm, Mm^Xm, Mm, Mm, Mm, Mm^Xm, Mm^Xm, Mm, Hh, Mm, Ww, Mm, Ww, Mm, Ww, Wwf, Ww, Hh, Ww, Mm, Ww, Ww, Ww, Mm, Ww, Mm, Ww, Ww, Ww, Ww, Mm, Mm, Mm, Mm, Hh, Ww, Ww, Ww^Vm, Ww, Ww, Hh, Hh, Mm, Mm
Mm, Mm, Mm^Xm, Mm, Hh^Fp, Wwf, Mm^Xm, Hh, Hh, Mm, Mm^Xm, Mm, Hh, Hh^Fp, Mm^Xm, Mm, Hh, Hh, Mm^Xm, Mm^Xm, Mm^Xm, Mm^Xm, Mm, Mm, Mm^Xm, Mm, Mm^Xm, Wwf, Mm^Xm, Mm, Mm^Xm, Mm, Mm^Xm, Mm, Mm, Mm, Mm^Xm, Mm, Mm, Mm, Ww, Ww, Ww, Ww, Ww, Mm, Ww, Ww, Ww, Ww, Ww, Ww, Ww, Hh^Fp, Mm, Hh, Mm
Mm, Mm^Xm, Mm^Xm, Mm^Xm, Mm^Xm, Mm^Xm, Mm^Xm, Mm^Xm, Hh, Mm^Xm, Mm^Xm, Hh^Fp, Mm^Xm, Mm^Xm, Mm^Xm, Mm^Xm, Mm^Xm, Hh, Mm^Xm, Mm^Xm, Mm, Mm, Mm, Mm^Xm, Mm^Xm, Mm^Xm, Mm^Xm, Mm^Xm, Mm^Xm, Mm^Xm, Mm^Xm, Mm^Xm, Mm, Mm^Xm, Mm, Mm^Xm, Mm, Mm^Xm, Mm^Xm, Mm^Xm, Mm, Ww, Ww, Ww, Ww, Ww, Ww, Ww, Wo, Wo, Ww, Ww, Ww, Gs^Fp, Hh, Hh^Fp, Mm
Mm^Xm, Mm^Xm, Mm^Xm, Mm^Xm, Mm^Xm, Mm^Xm, Hh^Fp, Mm^Xm, Mm^Xm, Mm, Mm, Mm^Xm, Hh^Fp, Mm^Xm, Mm^Xm, Mm^Xm, Mm^Xm, Mm^Xm, Mm^Xm, Mm^Xm, Mm^Xm, Mm^Xm, Hh^Fp, Mm^Xm, Hh, Mm^Xm, Mm^Xm, Mm^Xm, Hh, Mm^Xm, Mm^Xm, Mm^Xm, Mm^Xm, Mm^Xm, Mm^Xm, Mm, Mm, Mm^Xm, Mm^Xm, Mm^Xm, Mm, Ww, Ww, Ww, Ww, Ww^Vm, Ww, Ww, Ww, Ww, Ww, Ww, Gs^Fp, Gs, Gs^Fp, Gs, Mm
Mm^Xm, Hh, Mm^Xm, Mm^Xm, Hh, Mm, Mm, Mm^Xm, Mm^Xm, Mm^Xm, Mm^Xm, Mm, Mm, Mm, Mm, Mm^Xm, Hh^Fp, Mm^Xm, Mm^Xm, Mm^Xm, Mm^Xm, Mm^Xm, Mm^Xm, Mm^Xm, Mm, Mm^Xm, Mm^Xm, Mm^Xm, Mm^Xm, Mm^Xm, Mm^Xm, Mm^Xm, Mm^Xm, Mm^Xm, Mm^Xm, Mm^Xm, Mm^Xm, Mm^Xm, Mm^Xm, Mm^Xm, Mm^Xm, Mm, Mm, Ww, Ww, Ww, Ww, Ww, Hh, Ww, Wwf, Wwf, Hh, Hh, Gs^Fp, Hh, Mm
Mm^Xm, Hh^Fp, Mm^Xm, Mm^Xm, Mm^Xm, Hh, Mm, Mm^Xm, Mm, Mm^Xm, Mm^Xm, Mm, Mm^Xm, Mm^Xm, Mm^Xm, Mm, Mm^Xm, Hh^Fp, Mm, Mm, Mm, Mm^Xm, Mm^Xm, Mm, Mm^Xm, Mm, Mm^Xm, Mm^Xm, Mm^Xm, Hh^Fp, Mm^Xm, Mm^Xm, Mm^Xm, Hh, Mm^Xm, Mm, Mm, Mm^Xm, Hh^Fp, Mm^Xm, Mm^Xm, Mm^Xm, Mm^Xm, Mm, Mm, Ww, Mm, Hh, Mm, Hh, Hh^Fp, Hh, Hh^Fp, Gs, Mm, Mm, Ms^Xm
Mm^Xm, Mm^Xm, Mm^Xm, Mm^Xm, Mm^Xm, Mm, Mm^Xm, Mm, Mm^Xm, Mm^Xm, Mm^Xm, Mm^Xm, Mm^Xm, Mm^Xm, Mm^Xm, Mm^Xm, Mm^Xm, Mm, Mm^Xm, Mm^Xm, Mm^Xm, Mm^Xm, Mm^Xm, Mm^Xm, Mm^Xm, Mm^Xm, Mm, Mm, Mm, Mm^Xm, Mm^Xm, Mm^Xm, Mm^Xm, Mm^Xm, Mm^Xm, Mm, Mm, Mm^Xm, Mm^Xm, Mm^Xm, Mm^Xm, Mm^Xm, Mm^Xm, Mm^Xm, Ms^Xm, Mm, Hh^Fp, Hh, Mm^Xm, Mm, Mm, Mm, Mm, Mm, Hh, Hh^Fp, Ms^Xm
Mm^Xm, Mm^Xm, Mm^Xm, Mm^Xm, Mm^Xm, Mm^Xm, Mm^Xm, Mm^Xm, Mm^Xm, Mm^Xm, Mm^Xm, Mm^Xm, Mm^Xm, Mm^Xm, Mm^Xm, Mm^Xm, Mm^Xm, Mm^Xm, Mm^Xm, Mm^Xm, Mm^Xm, Mm^Xm, Mm^Xm, Mm^Xm, Mm^Xm, Mm^Xm, Mm^Xm, Mm^Xm, Mm^Xm, Mm^Xm, Mm^Xm, Mm^Xm, Mm^Xm, Mm^Xm, Mm^Xm, Mm^Xm, Mm^Xm, Mm^Xm, Mm^Xm, Mm^Xm, Mm^Xm, Mm^Xm, Mm^Xm, Mm^Xm, Ms^Xm, Ms^Xm, Ms^Xm, Ms^Xm, Ms^Xm, Ms^Xm, Ms^Xm, Ms^Xm, Ms^Xm, Ms^Xm, Ms^Xm, Ms^Xm, Hh^Fp
