Aa^Fma, Gll^Fp, Ss, Aa^Fpa, Aa^Fpa, Aa^Fpa, Aa, Aa, Ai, Ds, Wwf, Gll^Fp, Aa, Aa^Fpa, Aa, Xu^Fmw, Gll^Fmw, Xu, Xu, Xu, Xu, Xu, Xu, Xu, Xu, Xu, Xu, Xu, Xue, Xu, Xu, Xu, Xu, Ww, Wwf, Xu, Xu, Xu, Xu, Xu, Xu, Xu, Xu, Xu, Hh^Fmw, Hh^Fp, Aa^Fma, Aa^Fma, Aa, Aa, Aa^Fma, Aa^Fma
Aa^Fma, Gg^Fetd, Ss, Aa^Fetd, Cv, Aa^Fpa, Aa, Aa, Ai, Aa, Wwf, Gll^Fp, Aa, Aa^Fpa, Aa, Gll^Fmw, Gd^Fetd, Hh, Xu, Xu, Xu, Xu, Xu, Xu, Re, Xu, Xu, Xu, Uh^Qhh, Xu, Xu, Xu, Xu, Ww, Ww, Wwf, Wwf, Xu, Xu, Xu, Xu, Xu, Xu, Xu, Xu, Hh^Fmw, Gg^Fet, Aa^Fma, Gg^Fetd, Gg^Fetd, Aa^Fma, Aa^Fma
Aa, Aa, Gg^Fet, Ss, Gg^Fet, Cv, Gg^Fet, Hh, Gg^Efm, Wwf, Ww, Wwf, Wwf, Aa, Aa, Aa, Re, Xu, Re, Re, Uu, Uu, Uu, Re, Uu, Re, Wwf, Re, Re, Uu^Qhh, Uu, Tb^Tf, Uu^Vud, Xu, Xu, Ww, Ww, Xu, Xu, Xu, Xu, Xu, Xu, Xu, Xu, Xu, Ss, Gll^Fp, Re, Gll^Fmw, Gll^Fmw, Gll^Fmw
Aa, Aa, Kv, 4 Kv, Cv, Cv, Gg^Efm, Gg^Efm, Ss, Wwf, Ww, Chs, Ss, Gll^Fp, Hh, Re, Xu, Re, Xu, Xu, Wwf, Uu^Ii, Xu, Xu, Ww, Cud, Cud, Ww, Tb^Tf, Re, Re, Uu, Uu, Xu, Xu, Xu, Ww, Xu, Xu, Xu, Xu, Xu, Xu, Xu, Xu, Xu, Xu, Ss, Aa, Gll^Fp, Aa, Aa
Aa^Fma, Aa^Fma, Cv, Gg^Fet, Cv, Gg^Fetd, Gll^Fp, Ss, Wwf, Wwf, Ww, Wwf, Wwf, Ss^Vhs, Ss, Hh, Xu, Re, Wo, Wo, Cud, Cud, Ww, Ww, Wo, Ww^Bw|, Ww, Ww, Cud, Xu, Xu, Uh^Qhh, Xu, Xu, Xu, Xu, Xu, Ww, Xu, Xu, Xu, Xu, Xu, Xu, Xu, Xu, Xu, Cea, Aa, Aa, Aa^Fma, Aa
Aa^Fma, Gg^Fet, Gg^Efm, Aa, Aa^Fpa, Aa^Fpa, Ss, Ss, Ww, Ww, Ww, Ww, Wwf, Ss, Ww, Ww, Ww, Ww^Bw|, Wo, Wo, Cud, Xu, Wo, Wo, Uh^Qhh, Uu, Tb^Tf, Ww, Ww, Cud, Re, Uu, Re, Xu, Xu, Xu, Ww, Ww, Xu, Xu, Uh^Qhh, Uh^Qhh, Xu, Xu, Xu, Uu^Ii, Uu, Aa, Cea, Cea, Aa^Fma, Aa^Fma
Gll^Fp, Gg^Fetd, Gg^Efm, Aa, Aa^Fpa, Ss, Wwf, Ww, Wo, Ww, Wo, Ww, Ww, Ww, Ss, Ss, Gll^Fmw, Re, Xu, Xu, Xu, Ww^Bw\, Uu^Tf, Uh^Qhh, Cud, Cud, Cud, Uh, Ww^Bw/, Cud, Xu, Re, Xu, Xu, Xu, Ww^Vm, Ww, Ww, Uu, Re, Re, Re, Re, Re, Re, Re, Gll^Fmw, Re, Ce, 5 Kea, Ce, Ha
Gll^Fp, Gll^Fp, Re, Re, Gll^Fp, Ss, Wwf, Ww, Wo, Wo, Wo, Wo, Ww, Wwf, Ss, Ss, Gll^Fmw, Re, Xu, Xu, Cud, Wo, Uh, Uu, Uu^Vu, Cud, Uu^Vu, Uu^Tf, Ww, Ww, Ww, Xu, Xu, Xu, Ww, Ww, Wwf, Xu, Re, Re, Xu, Xu, Xu, Xu, Uu, Gll^Fmw, Gll^Fmw, Re, Gs, Ce, Gg^Fet, Gg^Fetd
Aa, Re, Gg^Fetd, Gll^Fp, Hh, Ai, Ai, Ai, Ai, Wo, Wo, Ww^Vm, Ww, Ww, Ww, Ss, Hh, Rd, Xu, Uu^Tf, Cud, Wo, Uh, Uu^Tf, Cud, 2 Kud, Cud, Wwf, Uh^Qhh, Cud, Ww, Xu, Ww, Ww, Xu, Xu, Wwf, Uu, Xu, Xu, Xu, Xu, Uh^Qhh, Xu, Re, Xu, Re, Uu^Ii, Xu, Gll^Fmw, Gll^Fmw, Gg^Fetd
Aa, Aa, Re, Gg^Efm, Gg^Fet, Ai, Aa, Ai, Ai, Ww, Ww, Ww, Wwf, Wwf, Ss, Ww, Uu^Ii, Re, Xu, Xu, Xu, Wo, Ww, Uu^Tf, Uh, Cud, Uu^Tf, Wwf, Uu^Tf, Cud, Ww, Ww, Ww, Xu, Uh^Qhh, Uu, Wwf, Xu, Ww, Xu, Xu, Uh^Qhh, Uh^Qhh, Re, Xu, Xu, Re, Re, Xu, Xu, Gll^Fp, Gll^Fp
Aa^Fpa, Aa^Fetd, Gg^Fet, Re, Aa^Fma, Aa^Fma, Aa^Fpa, Aa, Aa, Ai, Ss, Ww, Wwf, Ss, Ss, Ww, Xu, Re, Re, Xu, Xu, Uu^Tf, Ww^Bw/, Uu^Tf, Uu^Tf, Uh, Uu^Tf, Uu, Ww^Bw\, Ww, Uu, Xu, Xu, Xu, Re, Uu, Xu, Ww, Xu, Ww, Uu^Tf, Uu^Tf, Uu, Re, Xu, Re, Re, Uu, Uu^Tf, Gll^Fp, Xu, Xu
Aa^Fpa, Aa^Fpa, Wo, Re, Xu, Gg^Fetd, Re, Aa^Fpa, Aa^Fma, Ai, Ss, Ss, Hh, Ww, Xu, Ww, Wo, Xu, Re, Uh^Qhh, Xu, Uu^Vud, Uu, Wwf, Cud, Wwf, Ww, Ww, Xu, Cud, Re, Re, Re, Re, Uh, Xu, Wo, Ww, Xu, Ww, Ww, Xu, Re, Xu, Uh, Re, Uu^Ii, Uu, Uu^Tf, Xu, Xu, Xu
Aa^Fpa, Gg^Fet, Gll^Fp, Gll^Fmw, Gll^Fp, Re, Gg^Fetd, Re, Re, Ww, Gll^Fp, Hh, Uu^Tf, Xu, Xu, Xu, Ww, Xu, Uu^Vud, Uu, Re, Xu, Xu, Uu, Cud, Re, Cud, Ww, Ww, Xu, Xu, Xu, Uu^Tf, Uu, Uu^Vud, Xu, Ww, Ww, Ww, Wo, Xu, Xu, Wwf, Uu, Re, Re, Uu, Uh, Xu, Xu, Xu, Xu
Ds, Ds, Ww, Ww, Ww, Ds, Gll^Fmw, Gll^Fp, Ds, Ww^Bw\, Uu, Re, Re, Uh^Qhh, Xu, Xu, Xu, Ww, Wo, Xu, Uu, Xu, Xu, Uh^Qhh, Xu, Uu^Tf, Re, Uu, Uu, Ww, Wwf^Ii, Xu, Xu, Uu^Tf, Xu, Wwf, Wwf, Xu, Xu, Ww, Xu, Xu, Wwf, Uu, Uu, Re, Uu^Vud, Xu, Uh, Xu, Xu, Xu
Ww, Ww, Wo, Ww, Wo, Ww, Ww, Ww, Xu, Ww, Wwf, Uu, Uu, Re, Xu, Xu, Xu, Ww, Ww, Wo, Xu, Re, Re, Xu, Re, Xu, Xu, Re, Uu^Tf, Uu, Uu^Vud, Xu, Xu, Xu, Xu, Wo, Ww, Wwf, Wwf, Ww, Wo, Ww, Wwf, Wwf, Uu, Re, Re, Uu, Uu, Xu, Xu, Xu
Ww, Ww, Ww, Gll^Fp, Wo, Wwf, Wwf, Xu, Xu, Ww, Uu, Uu, Re, Re, Uu^Tf, Xu, Xu, Ww, Ww, Xu, Xu, Uu^Vud, Uu, Uu, Uu, Re, Re, Re, Xu, Uu^Tf, Cud, Uh^Qhh, Xu, Xu, Xu, Ww^Vm, Ww, Xu, Ww, Wwf, Wwf, Wwf, Uu, Uu, Uu^Tf, Xu, Xu, Re, Uu, Uh, Xu, Xu
Ww, Ww, Ww, Wo, Gll^Fmw, Wo, Wwf, Wwf, Wwf, Wwf, Uu, Re, Uu^Vu, Uh^Qhh, Xu, Xu, Xu, Ww, Ww, Xu, Xu, Wo, Xu, Wo, Wo, Xu, Cud, Xu, Ww, Cud, Ww, Cud, Ww, Xu, Xu, Xu, Ww, Xu, Wo, Ww, Xu, Uu^Vu, Xu, Xu, Re, Uu, Uu^Tf, Re, Re, Uu, Xu, Xu
Xu, Xu, Xu, Ww, Mm, Xu, Ww^Vm, Wo, Ww, Wwf, Wwf, Re, Uh^Qhh, Uh^Qhh, Xu, Xu, Xu, Ww^Vm, Ww, Wo, Ww, Ww, Ww, Xu, Wo, Wo, Wo, Wo, Wo, Wo, Wo, Wo, Wo, Ww, Wo, Ww, Ww, Ww, Ww, Xu, Xu, Xu, Xu, Xu, Uu, Xu, Uu^Tf, Xu, Re, Uu^Tf, Xu, Xu
Xu, Xu, Xu, Xu, Xu, Xu, Ww, Xu, Ww, Ww, Wwf, Uu, Xu, Xu, Wo, Xu, Ww, Xu, Wo, Ww, Ww, Wo, Xu, Ww, Ww, Ww, Ww, Ww, Ww, Xu, Ww, Wo, Ww, Wo, Xu, Wo, Ww, Xu, Xu, Xu, Xu, Xu, Xu, Xu, Uu, Uu^Tf, Uh, Xu, Re, Uh, Xu, Xu
Ms^Xm, Ms^Xm, Ms^Xm, Xu, Xu, Xu, Ww, Wo, Xu, Ww, Uu, Wwf, Ww, Wo, Ww, Wo, Xu, Ww, Xu, Xu, Wo, Xu, Xu, Xu, Wo, Ww, Xu, Xu, Xu, Ww, Xu, Ww, Ss, Xu, Ww, Ww, Ww, Xu, Xu, Xu, Uu^Tf, Uu^Tf, Uu, Uu, Uu, Uh, Re, Re, Re, Uu, Xu, Xu
Ww, Ww, Ms, Ms^Xm, Xu, Xu, Ww, Wo, Ww, Ww, Uh, Uu, Xu, Xu, Xu, Xu, Xu, Ww, Wo, Xu, Ww, Xu, Ww, Xu, Xu, Ww, Ww, Chs, Chs, Xu, Xu, Ss, Xu, Xu, Ww, Ss^Vm, Ss, Xu, Xu, Xu, Uu, Xu, Re, Re, Re, Re, Uu, Xu, Uu^Vu, Uu, Xu, Xu
Ww, Ww, Ww, Ms^Xm, Xu, Xu, Xu, Ww, Wo, Ww, Wwf, Wwf, Xu, Wo, Ww, Xu, Wo, Ww, Xu, Ww, Xu, Ww^Vm, Xu, Ww, Ww, Xu, Ss^Vm, Ss, Ss^Bw|, Ss, Ss^Vhs, Ss, Xu, Xu, Ss^Bw/, Ss^Bw|, Ss, Xu, Uu, Uu^Vud, Re, Re, Re, Re^Tf, Uu^Tf, Uu, Xu, Xu, Xu, Xu, Xu, Xu
Ww, Ww, Ww, Ms^Xm, Ha, Xu, Xu, Uh^Qhh, Ww^Vm, Ww, Wwf, Ww, Wo, Wo, Ww, Ww, Ww, Ww, Ww, Ww, Ww, Wo, Ww, Xu, Ww, Xu, Ww, Ss^Bw\, Ss^Bw|, Ss^Bw/, Ss, Xu, Sm^Qhu, Uu, Uu, Ss, Uu, Uu, Chs, Re, Re^Tf, Re^Tf, Uu^Tf, Uh, Uu, Xu, Xu, Xu, Xu, Xu, Xu, Xu
Mm, Mm, Ww, Ww, Ms^Xm, Xu, Uh^Ii, Uu^Tf, Ww, Ww, Wwf, Ww, Ww, Xu, Xu, Xu, Xu, Xu, Xu, Wo, Xu, Ww, Xu, Ww, Ww, Ww, Chw, Ss^Bw/, Xu, Ss^Bw\, Re, Uu, Uu, Uu, Ss, Uu, Ss, Chs, Xu, Ss, Xu, Uh, Uh, Uu^Tf, Uu, Xu, Xu, Xu, Xu, Xu, Xu, Xu
Mm, Mm, Ww, Ww, Ww, Uu^Ii, Ww, Ww, Ww, Wwf, Uu^Vud, Ww, Ww, Xu, Xu, Xu, Re^Tf, Xu, Uh, Xu, Xu, Xu, Xu, Xu, Xu, Xu, Ww, Chs, Xu, Xu, Re, Uu, Re^Tf, Ss^Bw\, Chs, Ss, Re, Re^Tf, Re, Xu, Re^Tf, Xu, Xu, Xu, Xu, Xu, Xu, Xu, Xu, Xu, Xu, Xu
Ww, Ww, Ms, Ww, Ww, Ww, Uu^Ii, Ww, Wwf, Wwf, Ce, Uu, Ss, Ww, Xu, Re, Ss, Re, Ss, Ss, Ww, Ss, Ww, Ss, Ww, Ww, Ss, Chs, Uu, Re^Tf, Uu, Uu, Re^Vu, Ss, Chs, Re^Tf, Chs, Ss, Ss^Bw/, Re^Tf, Re, Xu, Xu, Xu, Xu, Xu, Xu, Xu, Xu, Xu, Xu, Xu
Mm, Ms, Ha, Ww, Ww, Ww, Xu, Uu^Ii, Ce, Re, Ce, Re, Ce, Ss, Chs, Re, Ss, Ss, Ww, Ww, Ss, Ww, Ss, Ww, Ss, Ss, Re, Re^Tf, Uu, Xu, Uu, Xu, Xu, Ss^Bw\, Re, 3 Khs, Sm^Qhu, Chs, Ss^Bw\, Ss, Xu, Xu, Xu, Xu, Xu, Xu, Xu, Xu, Xu, Xu, Xu, Xu
Gll^Fdw, Gll^Fdw, Ww, Ww, Gll^Fdw, Ha, Xu, Uu, Uu, Ce, 1 Ke, Ce, Re, Re, Xu, Ss, Ww, Ww, Wwf, Ss, Re, Ss, Re, Ss^Vhs, Re^Tf, Ss, Sm^Qhu, Uu, Re^Tf, Re, Xu, Xu, Re^Tf, Ss, Chs, Chs, Sm^Qhu, Sm^Qhu, Xu, Re^Tf, Chs, Re^Tf, Re^Tf, Xu, Xu, Xu, Xu, Xu, Xu, Xu, Xu, Xu
Ww, Ww, Ww, Ww, Ds, Ha, Ms, Xu, Xu, Uu, Uu, Re^Tf, Uu, Xu, Wo, Ww, Ww, Ww, Re^Tf, Re^Tf, Xu, Re, Xu, Re^Tf, Xu, Re^Tf, Xu, Uu, Xu, Xu, Xu, Re^Tf, Ss, Ss^Bw/, Sm^Qhu, Ss, Xu, Sm^Qhu, Ss, Re, Xu, Sm^Qhu, Sm^Qhu, Xu, Xu, Xu, Xu, Xu, Xu, Xu, Xu, Xu
Ww, Ww, Ww, Ww, Ds, Ha, Ms, Mm^Xm, Xu, Xu, Uu, Re^Tf, Uu, Xu, Wo, Ww, Ww, Ww, Re^Tf, Re^Tf, Xu, Xue, Xu, Xue, Xu, Xue, Xu, Xue, Xu, Xu, Xu, Re^Tf, Ss, Sm^Qhu, Sm^Qhu, Sm^Qhu, Xu, Ss, Ss, Re, Xu, Sm^Qhu, Sm^Qhu, Xu, Xu, Xu, Xu, Xu, Xu, Xu, Xu, Xu
