Gll^Fp, Gll^Fp, Ss, Gs^Fp, Gll^Fmf, Gll^Fmf, Gg^Efm, Ds, Ss, Ds, Wwf, Gll^Fp, Re, Gll^Fmf, Gg, Xu, Gll^Fmf, Xu, Xu, Xu, Xu, Xu, Xu, Xu, Xu, Xu, Xu, Xu, Xue, Xu, Xu, Xu, Xu, Ww, Wwf, Xu, Xu, Xu, Xu, Xu, Xu, Xu, Xu, Xu, Hh^Fmf, Hh^Fp, Gll^Fp, Gs, Gs, Gs, Gll^Fp, Gs
Gll^Fp, Gg^Fet, Ss, Gg^Fet, Cv, Gll^Fmf, Gg^Efm, Ds, Ss, Ds, Wwf, Gll^Fp, Re, Gll^Fmf, Gg^Efm, Gll^Fmf, Gg^Fet, Hh, Xu, Xu, Xu, Xu, Xu, Xu, Re, Xu, Xu, Xu, Uh^Qhh, Xu, Xu, Xu, Xu, Ww, Ww, Wwf, Wwf, Xu, Xu, Xu, Xu, Xu, Xu, Xu, Xu, Hh^Fmf, Gg^Fet, Gll^Fp, Gg^Fet, Gg^Fet, Gll^Fp, Gll^Fp
Gg, Gg^Efm, Gg^Fet, Ss, Gg^Fet, Cv, Gg^Fet, Hh, Gg^Efm, Wwf, Ww, Wwf, Wwf, Re, Re, Gg^Efm, Re, Xu, Re, Re, Uu, Uu, Uu, Re, Uu, Re, Wwf, Re, Re, Uu^Qhh, Uu, Tb^Tf, Uu^Vud, Xu, Xu, Ww, Ww, Xu, Xu, Xu, Xu, Xu, Xu, Xu, Xu, Xu, Ss, Gll^Fp, Re, Gll^Fmf, Gll^Fmf, Gll^Fmf
Gg^Efm, Gg^Efm, Kv, 4 Kv, Cv, Cv, Gg^Efm, Gg^Efm, Ss, Wwf, Ww, Chs, Ss, Gll^Fp, Hh, Re, Xu, Re, Xu, Xu, Wwf, Uu^Ii, Xu, Xu, Ww, Cud, Cud, Ww, Tb^Tf, Re, Re, Uu, Uu, Xu, Xu, Xu, Ww, Xu, Xu, Xu, Xu, Xu, Xu, Xu, Xu, Xu, Xu, Ss, Re, Gll^Fp, Re, Re
Gll^Fmf, Gll^Fmf, Cv, Gg^Fet, Cv, Gg^Fet, Gll^Fp, Ss, Wwf, Wwf, Ww, Wwf, Wwf, Ss^Vhs, Ss, Hh, Xu, Re, Wo, Wo, Cud, Cud, Ww, Ww, Wo, Ww^Bw|, Ww, Ww, Cud, Xu, Xu, Uh^Qhh, Xu, Xu, Xu, Xu, Xu, Ww, Xu, Xu, Xu, Xu, Xu, Xu, Xu, Xu, Xu, Ce, Re, Re, Gll^Fp, Re
Gll^Fmf, Gg^Fet, Gg^Efm, Gg^Efm, Gll^Fmf, Gll^Fmf, Ss, Ss, Ww, Ww, Ww, Ww, Wwf, Ss, Ww, Ww, Ww, Ww^Bw|, Wo, Wo, Cud, Xu, Wo, Wo, Uh^Qhh, Uu, Tb^Tf, Ww, Ww, Cud, Re, Uu, Re, Xu, Xu, Xu, Ww, Ww, Xu, Xu, Uh^Qhh, Uh^Qhh, Xu, Xu, Xu, Uu^Ii, Uu, Re, Ce, Ce, Gll^Fmf, Gll^Fp
Gll^Fp, Gg^Fet, Gg^Efm, Re, Gll^Fmf, Ss, Wwf, Ww, Wo, Ww, Wo, Ww, Ww, Ww, Ss, Ss, Gll^Fmf, Re, Xu, Xu, Xu, Ww^Bw\, Uu^Tf, Uh^Qhh, Cud, Cud, Cud, Uh, Ww^Bw/, Cud, Xu, Re, Xu, Xu, Xu, Ww^Vm, Ww, Ww, Uu, Re, Re, Re, Re, Re, Re, Re, Gs^Fmf, Re, Ce, 5 Ke, Ce, Hh
Gll^Fp, Gll^Fp, Re, Re, Gll^Fp, Ss, Wwf, Ww, Wo, Wo, Wo, Wo, Ww, Wwf, Ss, Ss, Gll^Fmf, Re, Xu, Xu, Cud, Wo, Uh, Uu, Uu^Vu, Cud, Uu^Vu, Uu^Tf, Ww, Ww, Ww, Xu, Xu, Xu, Ww, Ww, Wwf, Xu, Re, Re, Xu, Xu, Xu, Xu, Uu, Gll^Fp, Gll^Fp, Re, Gs, Ce, Gg^Fet, Gg^Fet
Re, Re, Gg^Fet, Gll^Fp, Hh, Ss, Ss, Ww, Ww, Wo, Wo, Ww^Vm, Ww, Ww, Ww, Ss, Hh, Rd, Xu, Uu^Tf, Cud, Wo, Uh, Uu^Tf, Cud, 3 Kud, Cud, Wwf, Uh^Qhh, Cud, Ww, Xu, Ww, Ww, Xu, Xu, Wwf, Uu, Xu, Xu, Xu, Xu, Uh^Qhh, Xu, Re, Xu, Re, Uu^Ii, Xu, Gll^Fp, Gll^Fp, Gg^Fet
Re, Re, Re, Gg^Efm, Gg^Fet, Ss, Gg^Efm, Ss, Ss, Ww, Ww, Ww, Wwf, Wwf, Ss, Ww, Uu^Ii, Re, Xu, Xu, Xu, Wo, Ww, Uu^Tf, Uh, Cud, Uu^Tf, Wwf, Uu^Tf, Cud, Ww, Ww, Ww, Xu, Uh^Qhh, Uu, Wwf, Xu, Ww, Xu, Xu, Uh^Qhh, Uh^Qhh, Re, Xu, Xu, Re, Re, Xu, Xu, Gll^Fp, Gll^Fp
Gll^Fmf, Gg^Fet, Gg^Fet, Re, Gll^Fp, Gll^Fp, Gll^Fmf, Ds, Ds, Ww, Ss, Ww, Wwf, Ss, Ss, Ww, Xu, Re, Re, Xu, Xu, Uu^Tf, Ww^Bw/, Uu^Tf, Uu^Tf, Uh, Uu^Tf, Uu, Ww^Bw\, Ww, Uu, Xu, Xu, Xu, Re, Uu, Xu, Ww, Xu, Ww, Uu^Tf, Uu^Tf, Uu, Re, Xu, Re, Re, Uu, Uu^Tf, Gll^Fp, Xu, Xu
Gll^Fmf, Gll^Fmf, Wo, Re, Xu, Gg^Fet, Re, Gll^Fmf, Gll^Fp, Ww, Ss, Ss, Hh, Ww, Xu, Ww, Wo, Xu, Re, Uh^Qhh, Xu, Uu^Vud, Uu, Wwf, Cud, Wwf, Ww, Ww, Xu, Cud, Re, Re, Re, Re, Uh, Xu, Wo, Ww, Xu, Ww, Ww, Xu, Re, Xu, Uh, Re, Uu^Ii, Uu, Uu^Tf, Xu, Xu, Xu
Gll^Fp, Gg^Fet, Gll^Fp, Gll^Fmf, Gll^Fp, Re, Gg^Fet, Re, Re, Ww, Gll^Fp, Hh, Uu^Tf, Xu, Xu, Xu, Ww, Xu, Uu^Vud, Uu, Re, Xu, Xu, Uu, Cud, Re, Cud, Ww, Ww, Xu, Xu, Xu, Uu^Tf, Uu, Uu^Vud, Xu, Ww, Ww, Ww, Wo, Xu, Xu, Wwf, Uu, Re, Re, Uu, Uh, Xu, Xu, Xu, Xu
Ds, Ds, Ww, Ww, Ww, Ds, Gll^Fmf, Gll^Fp, Ds, Ww^Bw\, Uu, Re, Re, Uh^Qhh, Xu, Xu, Xu, Ww, Wo, Xu, Uu, Xu, Xu, Uh^Qhh, Xu, Uu^Tf, Re, Uu, Uu, Ww, Wwf^Ii, Xu, Xu, Uu^Tf, Xu, Wwf, Wwf, Xu, Xu, Ww, Xu, Xu, Wwf, Uu, Uu, Re, Uu^Vud, Xu, Uh, Xu, Xu, Xu
Ww, Ww, Wo, Ww, Wo, Ww, Ww, Ww, Xu, Ww, Wwf, Uu, Uu, Re, Xu, Xu, Xu, Ww, Ww, Wo, Xu, Re, Re, Xu, Re, Xu, Xu, Re, Uu^Tf, Uu, Uu^Vud, Xu, Xu, Xu, Xu, Wo, Ww, Wwf, Wwf, Ww, Wo, Ww, Wwf, Wwf, Uu, Re, Re, Uu, Uu, Xu, Xu, Xu
Ww, Ww, Ww, Gll^Fp, Wo, Wwf, Wwf, Xu, Xu, Ww, Uu, Uu, Re, Re, Uu^Tf, Xu, Xu, Ww, Ww, Xu, Xu, Uu^Vud, Uu, Uu, Uu, Re, Re, Re, Xu, Uu^Tf, Cud, Uh^Qhh, Xu, Xu, Xu, Ww^Vm, Ww, Xu, Ww, Wwf, Wwf, Wwf, Uu, Uu, Uu^Tf, Xu, Xu, Re, Uu, Uh, Xu, Xu
Ww, Ww, Ww, Wo, Gll^Fmf, Wo, Wwf, Wwf, Wwf, Wwf, Uu, Re, Uu^Vu, Uh^Qhh, Xu, Xu, Xu, Ww, Ww, Xu, Xu, Wo, Xu, Wo, Wo, Xu, Cud, Xu, Ww, Cud, Ww, Cud, Ww, Xu, Xu, Xu, Ww, Xu, Wo, Ww, Xu, Uu^Vu, Xu, Xu, Re, Uu, Uu^Tf, Re, Re, Uu, Xu, Xu
Xu, Xu, Xu, Ww, Mm, Xu, Ww^Vm, Wo, Ww, Wwf, Wwf, Re, Uh^Qhh, Uh^Qhh, Xu, Xu, Xu, Ww^Vm, Ww, Wo, Ww, Ww, Ww, Xu, Wo, Wo, Wo, Wo, Wo, Wo, Wo, Wo, Wo, Ww, Wo, Ww, Ww, Ww, Ww, Xu, Xu, Xu, Xu, Xu, Uu, Xu, Uu^Tf, Xu, Re, Uu^Tf, Xu, Xu
Xu, Xu, Xu, Xu, Xu, Xu, Ww, Xu, Ww, Ww, Wwf, Uu, Xu, Xu, Wo, Xu, Ww, Xu, Wo, Ww, Ww, Wo, Xu, Ww, Ww, Ww, Ww, Ww, Ww, Xu, Ww, Wo, Ww, Wo, Xu, Wo, Ww, Xu, Xu, Xu, Xu, Xu, Xu, Xu, Uu, Uu^Tf, Uh, Xu, Re, Uh, Xu, Xu
Mm^Xm, Mm^Xm, Mm^Xm, Xu, Xu, Xu, Ww, Wo, Xu, Ww, Uu, Wwf, Ww, Wo, Ww, Wo, Xu, Ww, Xu, Xu, Wo, Xu, Xu, Xu, Wo, Ww, Xu, Xu, Xu, Ww, Xu, Ww, Ss, Xu, Ww, Ww, Ww, Xu, Xu, Xu, Uu^Tf, Uu^Tf, Uu, Uu, Uu, Uh, Re, Re, Re, Uu, Xu, Xu
Ww, Ww, Mm, Mm^Xm, Xu, Xu, Ww, Wo, Ww, Ww, Uh, Uu, Xu, Xu, Xu, Xu, Xu, Ww, Wo, Xu, Ww, Xu, Ww, Xu, Xu, Ww, Ww, Chs, Chs, Xu, Xu, Ss, Xu, Xu, Ww, Ss^Vm, Ss, Xu, Xu, Xu, Uu, Xu, Re, Re, Re, Re, Uu, Xu, Uu^Vu, Uu, Xu, Xu
Ww, Ww, Ww, Mm^Xm, Xu, Xu, Xu, Ww, Wo, Ww, Wwf, Wwf, Xu, Wo, Ww, Xu, Wo, Ww, Xu, Ww, Xu, Ww^Vm, Xu, Ww, Ww, Xu, Ss^Vm, Ss, Ss^Bw|, Ss, Ss^Vhs, Ss, Xu, Xu, Ss^Bw/, Ss^Bw|, Ss, Xu, Uu, Uu^Vud, Re, Re, Re, Re^Tf, Uu^Tf, Uu, Xu, Xu, Xu, Xu, Xu, Xu
Ww, Ww, Ww, Mm^Xm, Hh, Xu, Xu, Uh^Qhh, Ww^Vm, Ww, Wwf, Ww, Wo, Wo, Ww, Ww, Ww, Ww, Ww, Ww, Ww, Wo, Ww, Xu, Ww, Xu, Ww, Ss^Bw\, Ss^Bw|, Ss^Bw/, Ss, Xu, Sm^Qhu, Uu, Uu, Ss, Uu, Uu, Chs, Re, Re^Tf, Re^Tf, Uu^Tf, Uh, Uu, Xu, Xu, Xu, Xu, Xu, Xu, Xu
Mm, Mm, Ww, Ww, Mm^Xm, Xu, Uh^Ii, Uu^Tf, Ww, Ww, Wwf, Ww, Ww, Xu, Xu, Xu, Xu, Xu, Xu, Wo, Xu, Ww, Xu, Ww, Ww, Ww, Chw, Ss^Bw/, Xu, Ss^Bw\, Re, Uu, Uu, Uu, Ss, Uu, Ss, Chs, Xu, Ss, Xu, Uh, Uh, Uu^Tf, Uu, Xu, Xu, Xu, Xu, Xu, Xu, Xu
Mm, Mm, Ww, Ww, Ww, Uu^Ii, Ww, Ww, Ww, Wwf, Uu^Vud, Ww, Ww, Xu, Xu, Xu, Re^Tf, Xu, Uh, Xu, Xu, Xu, Xu, Xu, Xu, Xu, Ww, Chs, Xu, Xu, Re, Uu, Re^Tf, Ss^Bw\, Chs, Ss, Re, Re^Tf, Re, Xu, Re^Tf, Xu, Xu, Xu, Xu, Xu, Xu, Xu, Xu, Xu, Xu, Xu
Ww, Ww, Mm, Ww, Ww, Ww, Uu^Ii, Ww, Wwf, Wwf, Ce, Uu, Ss, Ww, Xu, Re, Ss, Re, Ss, Ss, Ww, Ss, Ww, Ss, Ww, Ww, Ss, Chs, Uu, Re^Tf, Uu, Uu, Re^Vu, Ss, Chs, Re^Tf, Chs, Ss, Ss^Bw/, Re^Tf, Re, Xu, Xu, Xu, Xu, Xu, Xu, Xu, Xu, Xu, Xu, Xu
Mm, Mm, Hh, Ww, Ww, Ww, Xu, Uu^Ii, Ce, Re, Ce, Re, Ce, Ss, Chs, Re, Ss, Ss, Ww, Ww, Ss, Ww, Ss, Ww, Ss, Ss, Re, Re^Tf, Uu, Xu, Uu, Xu, Xu, Ss^Bw\, Re, 2 Khs, Sm^Qhu, Chs, Ss^Bw\, Ss, Xu, Xu, Xu, Xu, Xu, Xu, Xu, Xu, Xu, Xu, Xu, Xu
Gll^Fmf, Gll^Fmf, Ww, Ww, Gll^Fmf, Hh, Xu, Uu, Uu, Ce, 1 Ke, Ce, Re, Re, Xu, Ss, Ww, Ww, Wwf, Ss, Re, Ss, Re, Ss^Vhs, Re^Tf, Ss, Sm^Qhu, Uu, Re^Tf, Re, Xu, Xu, Re^Tf, Ss, Chs, Chs, Sm^Qhu, Sm^Qhu, Xu, Re^Tf, Chs, Re^Tf, Re^Tf, Xu, Xu, Xu, Xu, Xu, Xu, Xu, Xu, Xu
Ww, Ww, Ww, Ww, Ds, Hh, Mm, Xu, Xu, Uu, Uu, Re^Tf, Uu, Xu, Wo, Ww, Ww, Ww, Re^Tf, Re^Tf, Xu, Re, Xu, Re^Tf, Xu, Re^Tf, Xu, Uu, Xu, Xu, Xu, Re^Tf, Ss, Ss^Bw/, Sm^Qhu, Ss, Xu, Sm^Qhu, Ss, Re, Xu, Sm^Qhu, Sm^Qhu, Xu, Xu, Xu, Xu, Xu, Xu, Xu, Xu, Xu
Ww, Ww, Ww, Ww, Ds, Hh, Mm, Mm^Xm, Xu, Xu, Uu, Re^Tf, Uu, Xu, Wo, Ww, Ww, Ww, Re^Tf, Re^Tf, Xu, Xue, Xu, Xue, Xu, Xue, Xu, Xue, Xu, Xu, Xu, Re^Tf, Ss, Sm^Qhu, Sm^Qhu, Sm^Qhu, Xu, Ss, Ss, Re, Xu, Sm^Qhu, Sm^Qhu, Xu, Xu, Xu, Xu, Xu, Xu, Xu, Xu, Xu
