Gd, Gd, Gd, Gd, Gs, Gs, Gs, Gs, Gs, Gs, Gs, Gs, Gs, Gs, Gs, Gs, Gs, Gs, Gs^Eff, Gs^Eff, Re^Gvs, Re^Gvs, Re^Gvs, Gs, Gs, Gs, Gs, Gs, Gs, Gs, Gs, Gs, Gs, Gs, Rb^Gvs, Rb^Gvs, Rb^Gvs, Rb^Gvs, Re^Gvs, Gs, Gs, Gs, Gs, Gs, Gs, Gs, Gs, Gs, Gs^Efm, Gs^Efm, Gg, Gg, Gg, Gg, Gg, Gg, Gg, Gg, Gg, Gg, Gg, Gg, Gg, Gg, Gg, Gg, Gg, Gg, Gg, Gg, Gg, Gg, Gg, Gg, Gg, Gg, Gg, Gg, Rb^Gvs, Gg, Re^Gvs, Re^Gvs, Re^Gvs, Gg, Re^Gvs, Re^Gvs, Rb^Gvs, Rb^Gvs
Gd, Gd, Gd, Gd, Gs, Gs, Gs, Gs, Gs, Gs, Gs, Gs, Gs, Gs, Gs, Gs, Gs^Eff, Gs^Eff, Rb^Gvs, Re^Gvs, Re^Gvs, Re^Gvs, Rb^Gvs, Re^Gvs, Gs, Gs, Gs, Gs, Gs, Gs, Rb^Gvs, Rb^Gvs, Rb^Gvs, Re^Gvs, Rb^Gvs, Re^Gvs, Re^Gvs, Re^Gvs, Re^Gvs, Rb^Gvs, Re^Gvs, Re^Gvs, Re^Gvs, Gs, Gs^Eff, Gs, Gs^Efm, Gs, Gs^Efm, Gs, Gg^Efm, Gg, Gg^Efm, Gg, Gg^Efm, Gg^Efm, Gg, Gg, Gg^Efm, Gg, Gg^Efm, Gg, Gg, Gg, Gg, Gg, Gg, Gg, Gg, Gg, Gg, Gg, Gg, Gg, Re^Gvs, Gg, Gg, Rb^Gvs, Gg^Eff, Re^Gvs, Re^Gvs, Rb^Gvs, Re^Gvs, Rb^Gvs, Rb^Gvs, Re^Gvs, Rb^Gvs, Rb^Gvs
Gd, Gd, Gd, Gs, Gs, Gs, Gs, Gs, Gs, Gs, Gs, Gs, Gs, Gs, Rb^Gvs, Gs^Eff, Rb^Gvs, Rb^Gvs, Re^Gvs, Re^Gvs, Re^Gvs, Rb^Gvs, Rb^Gvs, Rb^Gvs, Rb^Gvs, Gs, Gs, Gs^Es, Gs, Re^Gvs, Re^Gvs, Re^Gvs, Re^Gvs, Re^Gvs, Re^Gvs, Re^Gvs, Re^Gvs, Re^Gvs, Re^Gvs, Re^Gvs, Re^Gvs, Rb^Gvs, Re^Eff, Re^Eff, Rb^Gvs, Rb^Gvs, Re^Gvs, Gs^Es, Gs^Efm, Gg, Gs^Efm, Gg, Gg, Gg, Gg^Efm, Gg, Gg^Vh, Gg, Gg, Gg^Efm, Gg, Gg, Gg^Efm, Gg^Efm, Gg, Gg, Gg, Gg^Efm, Gg, Gg, Gg, Gs^Fds, Gs^Fds, Re^Gvs, Re^Gvs, Gg, Gg^Eff, Gg^Eff, Rb^Gvs, Re^Gvs, Re^Gvs, Rb^Gvs, Re^Gvs, Rb^Gvs, Rb^Gvs, Rb^Gvs, Rb^Gvs, Rb^Gvs
Gd, Gd, Gd, Gs, Gs, Gd, Gs^Fds, Gs^Fds, Gs^Fds, Gs^Fds, Gs^Fds, Gs, Gs, Gs, Rb^Gvs, Rb^Gvs, Rb^Gvs, Re^Gvs, Re^Gvs, Re^Gvs, Gs, Rb^Gvs, Gs, Gs, Re, Re, Re, Gs, Gs, Gs, Re^Gvs, Re^Gvs, Rb^Gvs, Re^Gvs, Re^Gvs, Re^Gvs, Re^Gvs, Rb^Gvs, Re^Gvs, Re^Gvs, Re^Eff, Re^Eff, Re^Gvs, Re^Gvs, Re^Gvs, Re^Gvs, Re^Gvs, Re^Gvs, Gs, Gs, Gg^Efm, Gg^Efm, Gg^Efm, Gg, Ds^Esd, Ds^Esd, Ds, Ds, Ds, Ds, Ds, Gg, Gg^Efm, Gg, Gg^Efm, Gg^Efm, Gg, Gg, Gg, Gs^Vh, Gs, Gs^Fds, Re^Gvs, Re^Gvs, Re^Gvs, Gs^Fds, Gg, Re^Gvs, Re^Gvs, Re^Gvs, Gg, Re^Gvs, Rb^Gvs, Rb^Gvs, Re^Gvs, Rb^Gvs, Re^Gvs, Re^Gvs
Gd, Gd, Gd, Gs, Gs, Gd, Gs^Fds, Gs^Fds, Gs^Fds, Gs^Fds, Gs^Fds, Gs^Fds, Gs, Gs, Rb^Gvs, Rb^Gvs, Re^Gvs, Re^Gvs, Gs, Gs, Re, Gs, Gs^Vh, Re, Ch, Ch, Ch, Re, Gg, Gs, Gs, Rb^Gvs, Gs, Re^Gvs, Rb^Gvs, Rb^Gvs, Re^Gvs, Re^Gvs, Re^Gvs, Re^Gvs, Gs^Gvs, Re^Eff, Gs^Eff, Re^Gvs, Re^Gvs, Rb^Gvs, Re^Gvs, Re^Gvs, Gs, Gs^Efm, Gs^Efm, Gg, Ds, Ds, Ww, Ww, Ww, Ww, Ww, Ww, Ww, Ds, Ds^Esd, Gg, Gg, Gg, Gg^Efm, Gg^Efm, Gg^Efm, Re, Gs, Gs, Re^Gvs, Re^Gvs, Rb^Gvs, Re^Gvs, Gg, Re^Gvs, Re^Gvs, Re^Gvs, Gg^Es, Gg, Re^Gvs, Rb^Gvs, Re^Gvs, Re^Gvs, Re^Eff, Re^Eff
Gd, Gd, Gs, Gs, Gd, Gs, Gs, Gs^Fds, Hh^Fds, Gs^Fds, Hh^Fds, Re^Gvs, Re^Gvs, Re^Gvs, Re^Gvs, Rb^Gvs, Re^Gvs, Re^Gvs, Gs^Vh, Re, Gs^Vh, Re, Re, Re, Ch, 2 Kh, Ch, Re, Gg, Gg, Gg, Gs, Rb^Gvs, Rb^Gvs, Re^Gvs, Re^Gvs, Rb^Gvs, Re^Gvs, Rb^Gvs, Gs^Gvs, Gs^Eff, Gs^Eff, Gs^Vl, Rb^Eff, Rb^Eff, Re^Gvs, Re^Gvs, Re^Gvs, Gs^Efm, Gs^Efm, Gs^Efm, Gg, Ds, Ww, Ww, Ww, Wo, Wo, Wo, Wo, Ww, Ww, Ds^Esd, Gg^Efm, Gg, Gg^Efm, Gg, Gg, Re, Re, Re, Gs, Gs, Re^Gvs, Re^Gvs, Gs, Gs^Wm, Gg, Gg, Gg, Gg^Efm, Gg, Gg^Eff, Re^Gvs, Re^Eff, Rb^Eff, Rb^Gvs, Re^Gvs
Gs, Gs, Gs, Gd, Gs, Gs, Gd, Hh, Hh^Fds, Hh^Fds, Hh^Fds, Gs, Gs, Re^Gvs, Re^Gvs, Re^Gvs, Gs, Gs, Re, Re, Gs, Gs, Gs, Re, Re, Ch, Re, Re, Gg, Gg, Gs, Gs, Gs, Gs, Rb^Gvs, Rb^Gvs, Gs, Gs, Gs^Vl, Gs^Eff, Re, Re, Rb^Gvs, Rb^Gvs, Rb^Gvs, Re^Eff, Rb^Gvs, Gs^Efm, Gs, Gs^Efm, Gs, Ds, Ww, Ww, Wo, Wo, Wo, Wo, Wo, Wo, Wo, Ww, Ww, Ds, Gg, Gg, Gg, Gs^Vh, Gg, Gg, Gg, Re, Gs^Vl, Gs, Gg, Gg, Gg, Gg, Gg, Gg, Gg, Gg, Gg, Gg^Eff, Gg^Eff, Re^Gvs, Re^Gvs, Rb^Gvs
Gs, Gs, Gs, Gd, Gs, Gs, Hh, Hh^Es, Hh, Hh, Gs, Gs, Gs^Fds, Gs^Fds, Gs^Fds, Gs, Gs, Re, Re, Gs^Wm, Re, Gs, Re, Re, Rb^Gvs, Re, Gs^Eff, Re, Re, Gg, Gg, Gs, Gs, Rb^Gvs, Gs, Gs, Gs, Gs, Gs, Re, Re^Gvs, Re^Gvs, Rb^Gvs, Rb^Gvs, Rb^Gvs, Rb^Gvs, Rb^Gvs, Rb^Gvs, Gs^Gvs, Gs^Efm, Gs^Efm, Ds, Ww, Wo, Wo, Wo, Wo, Wo, Wo, Wo, Wo, Wo, Ww, Ds, Gg^Efm, Gg^Efm, Gg^Efm, Gg, Gs, Gg, Gs, Gg, Gs, Gs, Gs, Gg, Gg, Gg^Efm, Gg, Gg, Gg, Gg, Gg^Efm, Gg, Gg, Gg^Eff, Gg^Eff, Re^Gvs
Gd, Gd, Gs, Gs, Gs, Gd, Gd, Hh, Hh, Gd, Gs, Gs, Gs, Gs^Fds, Gs, Gs, Gs, Gd^Vh, Re, Re, Gd^Vh, Re, Re^Gvs, Gd, Rb^Gvs, Re^Gvs, Rb^Gvs, Gs^Eff, Gs^Eff, Re, Gg, Gg, Gs, Gs, Gs, Gs, Gs, Gs, Re^Gvs, Re^Gvs, Re^Gvs, Rb^Gvs, Rb^Gvs, Re^Gvs, Gs^Wm, Rb^Gvs, Rb^Gvs, Rb^Gvs, Re^Gvs, Gs^Efm, Ds, Ds, Ww, Wo, Wo, Wo, Wo, Wo, Wo, Wo, Wo, Ww, Ww, Ds, Gg, Gg, Gg, Gg, Gs, Gs, Gs, Gs, Gs, Gs, Gs, Gs, Gs, Gg, Gg, Gg^Efm, Gg, Gg, Gg, Gg, Gg, Gg, Gg, Gg^Eff
Gs, Gs, Gs, Gd, Gd^Es, Gd, Gs, Gd, Gs, Gs, Gs, Gs, Gs, Gs, Gs, Gs, Gd, Gd, Gs, Gd, Gs, Gs, Re^Gvs, Re^Gvs, Re^Gvs, Rb^Gvs, Re^Gvs, Rb^Eff, Gs^Eff, Re, Re, Gs, Re, Gs, Gs, Gs, Gs, Gs^Vl, Rb^Gvs, Rb^Gvs, Rb^Gvs, Rb^Gvs, Rb^Gvs, Rb^Gvs, Re^Gvs, Re^Gvs, Re^Gvs, Re^Gvs, Re^Gvs, Gs, Ds^Esd, Ww, Ww, Ww, Wo, Wo, Wo, Wo, Wo, Wo, Wo, Wo, Ww, Ds, Gg, Gg^Efm, Gs, Gs, Rd, Ds, Ds, Ds, Ds, Ds, Ds, Ds, Gg, Gg, Gg, Gg, Gg, Gg, Gg, Gg, Gg, Gg^Efm, Gs^Fds, Gs^Fds
Gd, Gs, Gd, Gs, Gd, Gd, Gs, Gs, Gs^Fds, Gs, Gs^Fds, Gd, Gs, Gs, Gd, Gd, Gd, Gd, Gd, Gd, Gd, Gd, Gd, Gd, Gd, Re^Gvs, Rb^Gvs, Rb^Gvs, Rb^Gvs, Gs^Eff, Gs, Re, Gs, Re, Re, Gs, Gs, Gs, Re, Rb^Gvs, Rb^Gvs, Rb^Vl, Re, Re^Gvs, Re^Gvs, Rb^Gvs, Rb^Gvs, Rb^Gvs, Rb^Gvs, Gs, Ds^Esd, Ww, Wo, Wo, Wo, Wo, Wo, Wo, Wo, Wo, Wo, Ww, Ww, Ds, Gg^Efm, Gs, Ds, Ds, Ds, Ds, Ds, Ds, Ds, Ds, Ds, Ds, Gs, Gs, Gg, Gg, Gg^Efm, Gg, Gg^Efm, Gg, Gg, Gg, Gs^Fds, Gs^Fds
Gd, Gd, Gd, Gd, Gd, Gs, Gs, Gs, Gs^Fds, Gs^Fds, Gs^Fds, Gd^Fds, Gd, Re^Gvs, Gd, Ds^Esd, Ds^Esd, Ds^Esd, Ds^Esd, Ds, Ds, Ds, Ds, Ds, Gd, Gs, Re^Gvs, Re^Gvs, Gs, Rb^Gvs, Gs, Gs, Gs, Gs, Gs, Re, Re, Re, Gs^Vl, Re, Re, Re, Gs^Fds, Gs, Gs^Fds, Re^Gvs, Gs, Rb^Gvs, Gs, Gs, Ds, Ww, Ww, Wo, Wo, Wo, Wo, Wo, Wo, Wo, Wo, Wo, Ww, Ds, Gg, Gs, Gs^Efm, Ds, Ds, Ds, Ds, Ds, Ds, Ds, Rd, Gs, Gs, Gg^Efm, Gg^Efm, Gg, Gg, Gg, Gg, Gg, Gs^Fds, Gs^Fds, Gs^Fds, Gs^Fds
Gg, Gd, Gs^Es, Gd, Gs, Gd, Gs, Gs^Fds, Gs, Gs^Fds, Gd, Gs, Gd, Gd, Gd, Ds, Ds, Ds, Ds^Esd, Ds, Ds, Ds^Esd, Ds, Ds, Ds, Gd, Gd, Gs, Gs, Gs, Hh, Hh, Hh, Hh, Gs, Gs, Re, Gs, Gs, Gs, Re, Gs^Fds, Gs^Fds, Gs^Fds, Gs^Fds, Gs^Fds, Gs^Fds, Gs, Gs^Efm, Gs, Gs^Efm, Ds, Ww, Ww, Wo, Wo, Wo, Wo, Wo, Wo, Wo, Ww^Wkf, Ww^Wkf, Ds^Esd, Gg^Efm, Gg^Efm, Gs^Es, Gs, Ds, Ds, Ds, Ds, Ds, Ds, Ds, Gs, Gg, Gg, Gg^Efm, Gg, Gg, Gg, Gg, Gg, Gg, Gs^Fds, Gs^Fds, Gs^Fds
Gd, Gd, Gd, Gd, Gd, Gs, Gd, Gs, Gd, Gs, Gs, Gd, Gd, Ds, Ds, Ds, Ds, Ds, Ds, Ds^Esd, Ds, Ds^Esd, Ds, Ds, Ds, Ds, Gs, Gs, Gs, Gs, Hh, Hh, Hh, Hh, Hh, Gs, Gs, Re, Gs, Gs^Es, Re, Gs, Gs^Fds, Gs^Fds, Gs^Fds, Gs^Fds, Gs, Gs, Gs, Gs, Gs, Ds, Ww, Wo, Wo, Wo, Wo, Wo, Wo, Ww, Ww^Wkf, Ww^Wkf, Ds, Ds^Esd, Gg^Efm, Gs, Gs, Gs^Efm, Gs, Ds, Ds, Ds, Ds, Ds, Gs, Gs, Gs, Gg, Gg, Gg, Gg^Efm, Gg, Gg^Efm, Gg, Gg, Gs^Fds, Gs^Fds, Gs^Fds
Gd, Gd, Gd, Gd, Gd, Gd, Gd, Gd, Gd, Gd, Gd, Gs, Gd, Gd, Ds, Ds, Ds^Esd, Ds, Ds^Esd, Ds, Ds, Ds, Ds, Gd, Gd, Gd^Vh, Gs, Gs, Gs, Gs, Gs, Hh, Hh, Hh, Gs, Gs, Gs, Re, Re, Gs, Re, Gs, Gs, Gs, Gs, Gs, Gs, Gs, Gs^Efm, Gs^Efm, Gg, Ds, Ww, Ww, Ww, Ww, Ww, Ww, Ww, Ww, Ww^Wkf, Ds, Gg^Efm, Gg, Gg, Gg, Gg, Gs, Gg, Gs, Gs, Gs, Gs, Gs, Gs, Gs, Gs^Efm, Gs, Gg, Gg, Gg, Gg, Gg, Gg^Es, Gg, Gs^Fds, Gs^Fds, Gs^Fds
Gd, Gd, Gd, Gd, Gd, Gd, Gd, Gd, Gs, Gd, Gd, Gs, Gd, Gd, Gd, Ds, Ds, Ds, Ds, Ds, Ds, Gd, Gd, Gd, Gs, Gd, Gs, Gs, Gs, Gs, Gs, Gs, Gs, Gs, Gs, Gs, Gs, Gs, Gs, Re, Gs, Gs, Gs, Gs, Ds, Gs, Gs, Gs, Gg, Gg^Efm, Ww, Ww, Ww, Ww, Ds, Ds, Ds, Ds, Ds^Esd, Ds, Ds^Esd, Ds, Gg, Gg, Gg, Gg, Gg^Efm, Gg, Gg, Gs, Gs, Gg, Gg^Efm, Gg, Gg, Gg, Gg, Gg, Gg, Gg, Gg^Efm, Gg, Gg, Gg, Gg^Efm, Gg, Gs^Fds, Gs^Fds
Gd, Gd, Gd, Gd, Gd, Gd, Gs, Gd, Gs, Gd, Gs, Gs, Gs, Gs, Gd, Gd, Gd, Gd, Gd, Gd, Gd, Gd, Gs, Gs, Gs, Gs, Gs, Gs, Gs, Gs, Gs, Gs, Gs, Gs, Gs, Gs, Gs, Gs, Gs, Re, Re, Gs, Ds, Ds^Esd, Ds, Ds, Gs^Efm, Gg, Ww, Ww, Ww, Ww, Gs^Fds, Gs^Fds, Gg, Gg^Efm, Gg, Gg^Efm, Gg, Gg^Efm, Gg, Gg^Efm, Gg, Gg^Efm, Gg, Gg, Gg, Gg, Gg, Gs, Gg, Gs, Gg, Gg, Gg, Gg^Efm, Gg, Gg, Gg, Gg, Gg, Gg, Gg^Efm, Gg, Gg, Gg, Gg, Gs^Fds
Gs, Gd, Gd, Gd, Gd, Gd, Gd, Gd, Gs, Gs, Gd, Gs, Gd, Gd, Gs, Gd, Gs, Gd, Gs, Gs, Gs, Gs^Em, Gd, Gs, Gs, Gs, Gs, Gs, Gs, Gs, Gs, Gs, Gs, Gs, Ds, Gs, Ds, Ds, Ds, Gs, Re, Gs, Gs, Ds, Gs, Gs^Efm, Gg, Gg, Ww, Ww, Gg, Gg, Gg, Gg, Gg, Gg^Vl, Re, Re, Re, Gg^Vl, Gg, Gg, Gg, Gg, Gg, Gg, Gg, Gg, Gg, Gg, Gg, Gg, Gg, Gg, Gg, Gg, Gg^Vh, Gg, Gg, Gg, Gg, Gg, Gg, Gg, Gg^Wm, Gg, Gg, Gg
Gd, Gs, Gd, Gd, Gd, Gd, Gd, Gd, Gd, Gd, Gs, Gd, Gs, Gd, Gd, Gd, Gs, Gd, Gs, Gd, Gs^Em, Gd, Gs, Gs^Em, Gs, Gs, Gs, Gs, Gs, Gs, Gs, Gs, Gs, Ds, Ds, Ds^Esd, Ds^Esd, Dd^Do, Ds, Gs, Gs, Re, Gs, Gs, Gs, Gg, Ww^Wkf, Ww^Wkf, Ww, Ww, Gg^Efm, Gg, Gg, Gg^Efm, Gg, Gg, Re, Gg^Ecf, Re, Gg, Gs^Fds, Gs^Fds, Gs^Fds, Gg, Gg, Gg, Gg, Gg^Efm, Gg, Gg, Gg, Gg, Gg, Gg, Gg^Efm, Gg, Gg, Re, Re, Gg, Gg, Gg, Re, Re, Gg, Gg, Gs^Fds, Gs^Fds
Gd, Gd, Gd, Gd, Gd, Gd, Gs, Gd, Gs, Gd, Gs, Gd, Gs, Gs^Es, Gd, Gs, Gs, Gs, Gs, Gs, Gs, Gs, Gs^Em, Gs, Gs, Gs, Gs, Gs, Gs, Gs, Gs^Es, Gs, Gs, Gs, Gs, Gs, Gs, Ds^Esd, Ds, Gs, Gs, Re, Re, Gs, Gg, Gg, Ww, Ww, Gg, Gg, Gg, Gg, Re^Gvs, Re^Gvs, Re^Gvs, Re, Gg^Vl, Re, Gg, Gg^Vl, Gs^Fds, Hh^Fds, Hh^Fds, Hh^Fds, Hh, Hh, Gg, Gg, Gg, Gg, Gg, Gg^Efm, Gg, Gg^Efm, Gg, Gg^Efm, Gg, Gg, Gg, Re, Ce, Gg, Re, Gg, Gg, Gg, Gg, Gs^Fds
Gd, Gd, Gd, Gd, Gd, Gd, Gd, Gd, Gd, Gd, Gs, Gs, Gs, Gd, Gs, Gs, Gs, Gs, Gs^Vh, Gs, Gs, Gs, Gs, Gs, Gs, Gs, Ww, Ww, Ww, Gs, Gs, Gs, Gs, Gs, Gs^Vh, Re^Gvs, Rb^Gvs, Gs, Ds, Ds, Rb^Gvs, Gs^Eff, Gs^Eff, Re, Rr, Ww, Ww, Ww, Gg, Gg^Efm, Gg, Re^Gvs, Re^Gvs, Re^Gvs, Gs^Fds, Re, Gs^Fds, Gg, Re^Gvs, Gg, Gg, Hh^Fds, Hh^Fds, Hh^Fds, Hh^Es, Hh, Hh, Gg, Gg^Vh, Gg, Gs, Gg, Gg, Gg^Efm, Gg^Efm, Gg, Gg, Gg^Efm, Gg, Gg, 1 Ke, Ce, Gg, Re, Gg^Vl, Gg, Gg, Gg
Gd, Gd, Gd, Gd, Gd, Gd, Gd, Gs, Gs, Gs, Gs, Gs, Gs, Gs, Gs, Gs, Re, Re, Re, Gs, Hh, Hh^Fds, Ww, Ww, Ww, Ww, Wo, Wo, Ww, Gs, Re^Gvs, Re^Gvs, Rb^Gvs, Rb^Gvs, Rb^Gvs, Re^Gvs, Rb^Gvs, Rb^Gvs, Re^Gvs, Rb^Gvs, Rb^Gvs, Rb^Gvs, Re^Gvs, Gs^Eff, Gg^Eff, Wwf, Wwf, Gg, Gg, Gg, Gg, Gs^Fds, Re, Re, Re, Re, Re^Gvs, Re^Gvs, Rb^Gvs, Re^Gvs, Gg, Hh, Hh, Hh, Hh, Hh, Gg, Gg, Gg, Gg, Gs, Gs, Gg, Gg, Gg, Gg, Gg, Gg, Gg^Em, Ce, Ce, Re, Gg, Gg, Gg, Gg, Re, Re
Gd, Gd, Gd, Gd, Gd, Gd, Gd, Gd, Gs, Gs, Gs, Gd, Gs, Gs, Gs, Gs^Vh, Re, Gs^Ecf, Re, Gs, Gs, Hh^Fds, Ww, Ww, Gs^Fds, Ww, Ww, Wo, Wo, Ww, Ww, Re^Gvs, Gs, Re^Gvs, Re^Gvs, Re^Gvs, Rb^Gvs, Re^Gvs, Re^Gvs, Rb^Gvs, Re^Gvs, Re^Gvs, Rb^Gvs, Gs^Eff, Gg, Wwf, Ww, Rr, Re, Gg, Gg, Gg, Re^Es, Gg, Rb^Gvs, Re^Gvs, Rb^Gvs, Rb^Gvs, Rb^Gvs, Rb^Gvs, Rb^Gvs, Gg, Hh, Hh^Fds, Hh^Fds, Hh, Gg, Gg, Gg, Gg, Gg^Efm, Gg, Gg^Efm, Gg, Gg, Gg, Gg, Gg^Vh, Re, Gg, Gg, Re, Re, Re, Re, Re, Re, Re
Gd, Gd, Gd, Gd, Gd, Gd, Gd, Gd, Gs, Gs, Gs^Fds, Gs, Gs^Fds, Gs, Gs, Gs, Gs, Re, Gs^Vh, Re, Re, Gs, Gs, Hh^Fds, Ch, Hh^Fds, Hh, Ww, Ww, Ww, Ww, Gs, Ww, Gs, Gs, Re^Gvs, Re^Gvs, Re^Gvs, Re^Gvs, Re^Gvs, Re^Gvs, Re^Gvs, Gg, Gg, Ww, Ww, Ww, Gg, Gg, Re, Re, Re, Gg, Gg, Re^Gvs, Re^Gvs, Re^Gvs, Rb^Gvs, Rb^Gvs, Rb^Gvs, Re^Gvs, Re^Gvs, Hh, Hh^Fds, Hh, Gs, Gg, Gs, Gg^Efm, Gg, Gg, Gg, Gg, Gg, Gg^Efm, Gg, Gg, Gg, Gg, Re, Re, Re, Re, Re, Re, Re, Gs, Gg
Gd, Gd^Es, Gd, Gd, Gd, Gd, Gs, Gd, Gs, Gs^Fds, Gs^Fds, Gs^Fds, Gs^Fds, Gs^Fds, Gs, Gs, Gs, Gs, Gs, Gs, Hh^Fds, Re, Re, Ch, 3 Kh, Ch, Hh^Fds, Ww, Ww, Wo, Wo, Ww, Ww, Ww, Ww, Gs, Gs, Rb^Gvs, Gs, Re^Gvs, Gg, Gg, Ww, Ww, Ww, Ww, Gg, Gg, Gg, Gg, Re, Gg, Gg^Eff, Re^Gvs, Re^Gvs, Re^Gvs, Re^Gvs, Re^Gvs, Re^Gvs, Re^Gvs, Re^Gvs, Re^Gvs, Re^Gvs, Gg, Gg, Gg, Gg, Gg, Gg, Gg, Gg, Gg, Gg, Gg, Gg, Gg, Gg, Gg, Re, Re, Re, Re, Ce, Gg, Gg^Vh, Gg, Gg, Gs
Gd, Gd, Gd, Gd, Gd, Gs, Gs, Gs, Gs^Fds, Gs^Fds, Gs^Fds, Gs^Fds, Gs^Fds, Gs^Fds, Gs^Fds, Gs, Re^Gvs, Re^Gvs, Re^Gvs, Gs^Fds, Gs, Gs, Re, Ch, Ch, Ch, Gs^Fds, Ww, Ww, Wo, Ww, Ww, Ww, Ww, Ww, Gs^Fds, Gs^Fds, Gs^Fds, Gs^Fds, Gs^Fds, Ww, Ww, Ww, Ww, Gg, Gg, Gg, Gg, Gg, Gg, Gg, Re, Re, Gg^Eff, Gg^Eff, Re^Gvs, Re^Gvs, Re^Gvs, Re^Gvs, Rb^Gvs, Rb^Gvs, Re^Gvs, Gg, Gg, Gg, Gg, Gg, Gg^Efm, Gg, Gg, Gg, Gg^Es, Gg, Gg, Gg^Efm, Gg, Gg, Re, Re, Re, Gg, Gg, Gg, 6 Ke, Ce, Gg, Gg, Gg
Gd, Gd, Gd, Gd, Gd, Gd, Gd, Gs, Gs, Gs^Fds, Gs^Fds, Gs^Fds, Gs^Fds, Gs^Fds, Rb^Gvs, Gs, Rb^Gvs, Rb^Gvs, Re^Gvs, Re^Gvs, Re^Gvs, Gs, Gs, Re, Re, Re, Gs, Ww, Ww, Ww, Gs, Ww, Gs, Ww, Ww, Ww, Ww, Gs^Fds, Gs^Fds, Ww, Ww, Ww, Gg, Gg, Gg, Gg, Gs, Gg, Gg, Gg, Gg, Gg, Re, Re, Re, Gg^Eff, Gg^Eff, Gg^Eff, Gg^Eff, Rb^Gvs, Rb^Gvs, Rb^Gvs, Gg, Gg, Gg, Gg, Gg^Es, Gg, Gg, Gg, Gg, Gg, Gg, Gg, Gg, Gg, Re, Re, Re, Gg, Gg, Ce, Gg, Ce, Gg^Efm, Gg, Gg, Gg
Gd, Gd, Gd, Gs, Gd, Gs, Gd, Gd, Gs, Gs^Fds, Gs, Gs, Rb^Gvs, Rb^Gvs, Rb^Gvs, Rb^Gvs, Re^Gvs, Re^Gvs, Re^Gvs, Re^Gvs, Re^Gvs, Gs^Eff, Gs^Eff, Gs, Re, Gs, Re, Gs, Gs, Gs, Gs, Gs, Gs, Gs, Re^Gvs, Ww, Ww, Gs^Fds, Gs^Fds, Ww, Ww, Gg, Gg, Gg, Gg, Gs, Gg, Gg, Gg, Gg, Gg, Re, Gg, Gg, Gg, Re, Re, Re, Re, Re, Re, Gg, Gg, Gg, Gg, Gg, Gg, Gg, Gg, Gg, Gg, Gg, Gg, Gg, Re, Re, Re, Re, Gg, Re, Gg^Vh, Gg, Gg, Gg, Gg, Gg, Gg, Gg
Gd, Gd, Gd, Gd, Gd, Gd, Gd, Gd, Gs, Gs, Rb^Gvs, Rb^Gvs, Re^Gvs, Rb^Gvs, Re^Gvs, Re^Gvs, Re^Gvs, Re^Gvs, Re^Gvs, Re^Gvs, Re^Eff, Gs^Eff, Re, Re, Gs, Re, Gs, Re, Re, Gs, Gs, Gs, Gs, Re^Gvs, Re^Gvs, Re^Gvs, Ww, Ww, Ww, Ww, Ww, Gg, Gg, Gs, Gg, Gg, Gg, Gg, Gg, Gg, Re, Re, Gg, Gg, Gg, Gg, Gg, Gg, Gg, Gg, Gg, Re, Re, Gg, Gg, Gg, Re, Gg, Re, Gg, Re, Re, Re, Re, Re, Re, Gg, Gg, Gg, Gg, Gg, Gg, Gg, Gg, Gg, Gg, Gg, Gg
Gd, Gd, Gd, Gd, Gd, Gd, Gs, Gs, Rb^Gvs, Rb^Gvs, Re^Gvs, Re^Gvs, Rb^Gvs, Re^Gvs, Re^Gvs, Re^Gvs, Re^Gvs, Re^Gvs, Gs^Eff, Gs^Eff, Re, Re, Gs, Gs, Gs, Gs, Gs, Gs, Re, Gs^Vh, Gs, Gs, Gs, Gs, Gs, Gs, Ww, Ww, Ww, Ww, Gg, Gg, Gs, Gg, Gs, Hh, Hh^Fds, Gs^Fds, Gs^Fds, Gg, Re, Gg, Gg, Gg, Gg, Ds, Ds, Ds, Ds, Ds, Ds, Gg, Gg, Re, Re, Re, Re, Re, Re, Re, Re, Re, Re, Re, Gg, Gg, Gg, Gg, Gg, Gg, Gg, Gg, Gg, Gg^Es, Gg, Gs, Gg, Gg
Gd, Gd, Gd, Gs, Gd, Gs, Gs, Re^Gvs, Gd, Re^Gvs, Rb^Gvs, Rb^Gvs, Rb^Gvs, Re^Gvs, Rb^Gvs, Rb^Gvs, Gs, Gs^Eff, Re, Re, Gs, Gs, Gs, Gs, Gs, Gs, Gs^Vh, Re, Gs^Wm, Re, Gs, Gs, Gs, Gs, Gg, Gs, Ww, Ww, Ww, Ww^Wkf, Gg, Gg, Gg, Gg, Gg, Gs^Fds, Hh^Fds, Hh^Fds, Hh, Gg, Re, Gg, Gg, Gg, Ds, Ds, Ds, Ds^Esd, Ds^Esd, Ds, Gg, Gg, Re, Re, Re, Re, Gg, Gg, Gg, Gg, Gg, Gg, Gg, Gg, Gg, Gg, Gs, Gs, Gg, Gg, Gg, Gg, Gg, Gg, Gs, Gs, Gs, Gg
Gd, Gd, Gd, Gd, Gd, Gs, Gs, Gd, Rb^Gvs, Rb^Gvs, Rb^Gvs, Rb^Gvs, Rb^Gvs, Rb^Gvs, Gs, Gs, Gs, Re, Gs, Gs, Gs, Gs, Rb^Gvs, Re^Gvs, Rb^Gvs, Gs, Gs, Re, Re, Re, Gs, Gs, Gs, Gg, Ww, Ww, Ww, Ww, Ww^Wkf, Ww^Wkf, Gg, Gg, Gg, Gs, Gg, Hh, Gs^Fds, Gs^Fds, Hh, Gg^Vh, Gg, Re, Gg^Wm, Gg, Ds, Ds, Ds, Ds, Ds^Esd, Ds, Gg, Gg, Re, Re, Gg, Gg, Hh, Hh, Hh, Hh, Hh, Gg, Gg, Gs, Gs, Gs, Gs, Gg, Gg, Gs, Gg, Gg, Gg, Gg, Gg, Gs, Gs, Gg
Gd, Gd, Gd, Gd, Gd, Gs, Gd, Gs, Rb^Gvs, Re^Gvs, Rb^Gvs, Rb^Gvs, Rb^Gvs, Gs, Gs, Gs, Gs, Re, Gs, Gs, Re^Gvs, Re^Gvs, Rb^Gvs, Re^Gvs, Rb^Gvs, Rb^Gvs, Rb^Gvs, Rb^Gvs, Gs, Gs^Vh, Gs, Gs, Ww, Ww, Ww, Ww, Ww^Wkf, Ww, Re^Gvs, Re^Gvs, Rb^Gvs, Rb^Gvs, Re^Gvs, Re^Gvs, Re^Gvs, Gg, Re, Gg, Gg^Vh, Gg, Re, Re, Gg, Gg, Ds^Esd, Ds^Esd, Ds, Ds, Ds, Ds, Gg, Re, Re, Re, Gg, Hh, Hh, Hh^Fds, Hh^Fds, Hh, Gg^Vl, Gg, Gg, Gg, Gg, Gs, Gg, Gg, Gg, Gg, Gg, Gg, Gg, Gg, Gg, Gg, Gg, Gg
Gd, Gd, Gd, Gd, Gd, Gs, Gd, Rb^Gvs, Gs, Re^Gvs, Rb^Gvs, Rb^Gvs, Hh, Hh, Hh, Gs, Gs, Re, Gs, Re^Gvs, Re^Gvs, Rb^Gvs, Re^Gvs, Rb^Gvs, Rb^Gvs, Rb^Gvs, Rb^Gvs, Rb^Gvs, Rb^Gvs, Gs, Gs, Gg, Ww, Ww, Ww, Ww, Rb^Gvs, Rb^Gvs, Re^Gvs, Rb^Gvs, Rb^Gvs, Rb^Gvs, Rb^Gvs, Rb^Gvs, Gg, Re, Gg^Vh, Re, Re, Re, Gg, Gg^Vh, Ds, Ds, Ds, Ds, Ds, Ds, Gg, Gg, Re, Re, Re, Gg, Gg, Gs^Fds, Gs^Fds, Hh^Fds, Hh, Hh, Hh, Gg, Gg, Gg^Es, Gg, Gg, Gg, Gg, Gg^Es, Gg, Gg, Gg, Gg, Gg, Gg, Gg, Gg, Gg
Gd, Gd, Gd, Gd, Gd, Gd, Gd, Gd, Gd, Rb^Gvs, Gs, Hh, Hh, Hh, Hh, Gs, Gs, Re, Gs, Re^Gvs, Rb^Gvs, Re^Gvs, Rb^Gvs, Re^Gvs, Re^Gvs, Rb^Gvs, Rb^Gvs, Rb^Gvs, Rb^Gvs, Rb^Gvs, Gs, Gs, Ww, Ww, Ww, Gg, Rb^Gvs, Re^Gvs, Rb^Gvs, Rb^Gvs, Rb^Gvs, Rb^Gvs, Rb^Gvs, Rb^Gvs, Gg, Re, Re, Gg, Gg, Gg, Gg, Gg, Gg, Gg, Gg, Gg, Gg, Gg, Re, Re, Re, Re, Gs^Fds, Gg, Gg, Gg, Gs^Fds, Hh^Fds, Hh, Hh, Hh, Gg, Gg, Gg, Gg, Gg, Gg, Gg, Gg, Gs, Gg, Gg, Gg, Gg, Gg, Gg, Gg, Gg
Gs, Gd, Gd, Gd, Gd, Gd, Gs, Gs, Gs, Gd, Gs, Gs, Hh, Hh^Fds, Hh^Fds, Hh, Gs, Re, Re, Gs, Gs, Re^Gvs, Re^Gvs, Rb^Gvs, Rb^Gvs, Rb^Gvs, Rb^Gvs, Rb^Gvs, Rb^Gvs, Rb^Gvs, Rb^Gvs, Gs, Ww, Ww, Re^Gvs, Re^Gvs, Rb^Gvs, Rb^Gvs, Rb^Gvs, Rb^Gvs, Rb^Gvs, Rb^Gvs, Rb^Gvs, Rb^Gvs, Gg, Gg, Re, Gg, Re, Gg, Gg, Gg, Gg, Gg, Gg, Gg, Re, Re, Re, Re, Gs^Fds, Gg, Gs^Fds, Gs^Fds, Gs^Fds, Gg, Gg, Gs^Fds, Gg, Gg, Gg, Gg, Gg, Gg, Re^Gvs, Gg, Gg, Gg, Gg, Gg, Gs, Gg, Gg, Gs, Gs, Gg, Gg, Gg
Gd, Gd, Gd, Gd, Gd, Gd, Gs, Gs, Gd, Gd^Es, Gs, Gs, Gs^Fds, Gs^Fds, Gs^Fds, Gs, Gs^Fds, Gs^Vh, Re, Gs, Gs, Gs, Gs, Re^Gvs, Re^Eff, Rb^Gvs, Rb^Gvs, Rb^Gvs, Rb^Gvs, Rb^Gvs, Gs, Ww, Ww, Ww, Gg, Re^Gvs, Re^Gvs, Re^Gvs, Rb^Gvs, Rb^Gvs, Rb^Gvs, Rb^Gvs, Gg, Gg, Gs, Re, Rr, Re, Re, Re, Re, Re, Re, Re, Re, Re, Re, Re, Gg, Re, Re, Gs^Fds, Gg, Gs^Fds, Gg, Gg, Gg, Gg, Rb^Gvs, Rb^Gvs, Rb^Gvs, Re^Gvs, Re^Gvs, Re^Gvs, Rb^Gvs, Gg, Gg, Gg, Gg, Gg, Gg, Gg, Gg, Gg, Gg, Gg, Gg^Es, Gg
Gd, Gd, Gd, Gd, Gd, Gd, Gs, Gd, Gs, Gs, Gs, Gs, Gs, Gs, Gs^Fds, Gs^Fds, Gs^Fds, Gs, Re, Gs, Gs, Gs, Gs, Gs^Gvs, Gs^Fds, Re^Eff, Rb^Eff, Rb^Gvs, Rb^Gvs, Gs, Gs, Ww, Ww, Gg, Rb^Gvs, Re^Gvs, Rb^Gvs, Rb^Gvs, Rb^Gvs, Rb^Gvs, Gs, Gs, Rr, Rr, Rr, Rr, Gg, Re, Gg, Re, Re, Re, Re, Re, Re, Re, Gg, Gg, Gg, Gg, Gg, Re, Gg, Gg, Gg, Gg, Rb^Gvs, Rb^Gvs, Rb^Gvs, Rb^Gvs, Rb^Gvs, Rb^Gvs, Re^Gvs, Rb^Gvs, Re^Gvs, Rb^Gvs, Gg, Gg, Gg, Gg^Es, Gg, Gg, Gg, Gg, Gg, Gg, Gg^Es, Gg^Es
Gd, Gd^Es, Gd, Gd, Gd, Gd, Gd, Gs, Gs, Gs, Gd, Ds, Ds, Ds, Ds, Ds^Esd, Gs, Gs, Re, Gs^Vh, Gs, Gs, Re^Gvs, Gs^Fds, Re^Gvs, Gs^Eff, Re^Gvs, Rb^Eff, Gs^Eff, Gs, Gs, Ww, Ww, Gg, Gg, Rb^Gvs, Gg, Rb^Gvs, Gs, Gs, Rr, Rr, Gs, Gs, Gg, Gg, Gg, Gg, Gs, Gg, Gg, Gg, Gg, Gg, Gg, Gg, Gg, Gg, Gg, Gg, Gg, Re, Gg, Gg, Gg, Gg^Eff, Gg^Eff, Rb^Gvs, Rb^Gvs, Rb^Gvs, Re^Gvs, Re^Gvs, Rb^Gvs, Re^Gvs, Re^Gvs, Re^Gvs, Gg^Vh, Gg, Gg, Gg, Gg, Gg, Gg, Gg, Gg, Gg, Gg, Gg
Gd, Gd, Gd, Gd, Gd, Gd, Gs, Gd, Gd, Gs, Ds, Ds^Esd, Ds, Ds, Gs, Ds, Gs, Gs, Re, Gs, Gs, Rb^Gvs, Rb^Gvs, Re^Gvs, Rb^Gvs, Rb^Gvs, Re^Gvs, Re^Gvs, Re^Gvs, Gs^Eff, Gs, Ww, Ww, Gg, Gg, Gg, Gg, Gg, Rr, Rr, Gg, Gg, Gg, Gg, Gg, Gg, Gg, Gg, Gg, Gg, Gs, Gg, Gs, Gs, Gg, Gg, Gg, Gg, Gg, Gg, Gg, Re, Re, Gg, Gg, Gg, Gg, Gg^Eff, Gg^Eff, Re^Gvs, Re^Gvs, Rb^Gvs, Re^Gvs, Re^Gvs, Rb^Gvs, Rb^Gvs, Re, Gg, Gg, Gg^Vh, Re, Gg, Re, Gg, Gg, Gg, Gg, Gg
Gd, Gd, Gd, Gd, Gd, Gd, Gd, Gd, Gd, Gd, Gd, Ds, Gs, Ds, Ds, Gs, Gs, Gs, Re, Gs, Re^Gvs, Gs, Re^Gvs, Rb^Gvs, Rb^Gvs, Rb^Gvs, Rb^Gvs, Re^Gvs, Rb^Gvs, Re^Gvs, Gs, Ww, Ww, Ww, Ww, Gg, Rr, Rr, Rr, Gg, Gg, Gg, Gg, Gg, Gg, Gg, Gs, Gs, Rd, Gs, Rd, Gs, Rd, Gs, Rd, Gs, Gs, Gg, Gg, Gg, Gg, Gg, Gg, Re, Re, Re, Re, Gg, Gg^Eff, Gg^Eff, Re^Gvs, Re^Gvs, Re^Gvs, Re^Gvs, Gg, Gg, Rr, Gg, Gg, Gg, Re, Re, Gg, Re, Gg^Wm, Gg, Gg, Gg
Gd, Gd, Gd, Gd, Gd, Gd, Gs, Gd, Gs, Gd, Gs, Gs, Re^Gvs, Ds, Gs^Eff, Gs^Eff, Gs^Eff, Gs, Gs^Vh, Re, Gs, Re^Gvs, Gs, Re^Gvs, Rb^Gvs, Rb^Gvs, Rb^Gvs, Rb^Gvs, Rb^Gvs, Rb^Gvs, Re^Gvs, Gs, Gg, Ww, Ww^Bsb/, Ww^Bsb/, Ww^Bsb/, Rr, Gg, Gg, Gg, Gg, Gg, Gg, Gg, Gg, Gs, Ds, Ds, Ds, Ds, Ds, Ds, Rd, Rd, Rd, Gs, Gg, Gg, Gg, Gg, Gg, Gg, Gg, Gg, Gg, Gg, Re, Re, Gg^Eff, Re^Gvs, Re^Gvs, Gg, Re, Rr, Rr, Ch, Rr, Rr, Re, Gg^Es, Gg, Re^Gvs, Gg, Rb^Gvs, Rb^Gvs, Rb^Gvs, Gg
Gd, Gd, Gd, Gd, Gs, Gs, Gd, Gs, Gs, Gd, Re^Gvs, Re^Gvs, Re^Gvs, Gs^Eff, Rb^Gvs, Re^Gvs, Rb^Gvs, Gs^Eff, Gs, Re, Re, Gs, Re^Gvs, Rb^Gvs, Rb^Gvs, Rb^Gvs, Rb^Gvs, Rb^Gvs, Re^Gvs, Re^Gvs, Re^Gvs, Gs, Rr, Rr, Rr, Ww^Bsb/, Ww, Ww, Ww, Gg, Ww, Gg, Gg, Gg, Gg, Gg, Gs, Ds, Ds^Esd, Ds^Esd, Ds, Ds, Ds^Esd, Ds^Esd, Ds, Rd, Rd, Gs, Gs, Gg, Gg, Gg, Gg, Gg, Gg, Gg, Gg, Gg, Re, Gg, Gg, Gg, Gg, Gg, Rr, Ch, 5 Kh, Ch, Rr, Gg, Re^Gvs, Re^Gvs, Re^Gvs, Re^Gvs, Rb^Gvs, Rb^Gvs, Rb^Gvs, Rb^Gvs
Gd, Gd, Gd, Gd, Gd, Gd, Gs, Gs, Re^Gvs, Re^Gvs, Re^Gvs, Re^Gvs, Rb^Gvs, Rb^Gvs, Rb^Gvs, Rb^Gvs, Gs, Gs, Gs, Gs, Gs, Re, Re, Re^Gvs, Re^Gvs, Rb^Gvs, Gs^Vh, Re^Gvs, Re^Gvs, Rb^Gvs, Gd, Rr, Rr, Rr, Gs, Gg, Gg, Ww, Ww, Ww, Ww, Ww, Ww, Ww, Ww^Wkf, Gg, Gg, Ds, Ds, Ds, Ds, Ds, Dd^Do, Ds, Rd, Rd, Gs, Gg, Gg, Gs, Gg, Gg, Gg, Gg, Gg, Gg, Gg, Gg, Gg, Re, Re, Re, Re, Gg, Rr, Ch, Ch, Ch, Rr, Re, Re^Gvs, Re, Re^Gvs, Rb^Gvs, Rb^Gvs, Re^Gvs, Rb^Gvs, Re^Gvs
Gd, Gd, Gd, Gd, Gd, Gd, Gd, Gd, Gd, Re^Gvs, Rb^Gvs, Rb^Gvs, Rb^Gvs, Rb^Gvs, Rb^Gvs, Rb^Gvs, Gs, Gs, Gs, Gs, Gs, Gs, Re, Gs, Gs, Gs, Gs, Gs, Gd, Gd, Rr, Rr, Gs, Gs, Gs, Gs, Gs, Gs, Gs, Ww, Ww, Ww, Ww, Ww, Ww, Ww^Wkf, Ww^Wkf, Gg, Ds, Ds, Ds, Ds, Ds, Ds, Rd, Rd, Rd, Gs, Gg, Gg, Gg, Gg, Gg, Gg, Gg, Gg, Gg, Gg, Gg, Gg, Re, Gg, Gg, Re, Gg, Rr, Rr, Rr, Gg, Re^Gvs, Re^Gvs, Re^Gvs, Re^Gvs, Re^Gvs, Rb^Gvs, Rb^Gvs, Rb^Gvs, Rb^Gvs
Gd, Gd, Gd, Gs, Gd, Gd, Gd, Gs, Re^Gvs, Rb^Gvs, Re^Gvs, Re^Gvs, Rb^Gvs, Rb^Gvs, Re^Gvs, Re^Gvs, Gs, Hh, Hh, Hh, Hh^Es, Gs, Gs, Re, Re, Gs, Rr, Rr, Rr, Rr, Gs, Gs, Gs, Gs, Gs, Gs, Gs, Gs, Gs, Gs, Gg, Ww, Gg, Ww, Ww, Ww^Wkf, Ww, Gg, Gs, Gs, Ds, Ds, Ds, Ds^Esd, Ds, Rd, Gs, Gs, Gg, Gs, Gg, Gg, Gg, Gg, Gg, Gg, Gg, Gg, Gg, Gg, Gg^Vh, Gg, Gg, Gg, Gg, Gg, Re, Gg, Re, Re^Gvs, Re, Re^Gvs, Re^Gvs, Re^Gvs, Rb^Gvs, Rb^Gvs, Re^Gvs, Rb^Gvs
Gd, Gd, Gd, Gd, Gd^Es, Gd, Gd, Gd, Re^Gvs, Rb^Gvs, Rb^Gvs, Re^Gvs, Re^Gvs, Re^Gvs, Re^Gvs, Gs, Gs, Hh, Hh, Hh, Hh, Hh, Gs, Gs, Gs, Re, Rr, Rr, Gs, Gs, Gs, Gs, Gd, Gs, Gs, Gs, Gs, Gs, Gs, Gs, Gs, Gs, Gg^Vh, Gg, Gg, Ww, Ww, Ww, Gg, Gs, Gs, Rd, Gs, Rd, Rd, Rd, Rd, Gs, Gg, Gg, Gg, Gg, Gg, Gg^Es, Gg, Gg, Gg, Gg, Gg, Gg, Gg, Gg, Gg, Gg, Gg^Vh, Re, Gg, Re, Gg^Es, Rb^Gvs, Rb^Gvs, Re^Gvs, Rb^Gvs, Rb^Gvs, Re^Gvs, Re^Gvs, Gs, Gs
Gd, Gd, Gd, Gd, Gd, Gd, Gd, Gd, Gs, Re^Gvs, Rb^Gvs, Re^Gvs, Re^Gvs, Re^Gvs, Gs, Gs, Hh, Hh, Hh, Hh, Hh, Gs, Gs, Gs, Re, Rr, Re, Gd, Gs, Gs, Gd, Gd, Gd, Gd, Gd, Gd, Gd, Gs, Gs, Gs, Gs, Gs, Gs, Gg, Gs, Gg, Ww, Ww, Ww, Gg, Gg, Gg, Gs, Rd, Gs, Rd, Gs, Gg, Gg, Gg, Gg, Gg, Gg, Gg, Gg, Gg, Gg, Gg, Gg, Gg, Gg, Gg, Gg, Gg, Gg, Gg, Gg, Gg, Gg, Gg, Gg, Rb^Gvs, Rb^Gvs, Rb^Gvs, Gd, Gs, Rd, Gd
Rb, Rb, Rb, Gd, Rb, Gd, Gd, Gd, Gd, Re^Gvs, Re^Gvs, Rb^Gvs, Rb^Gvs, Gd, Gd, Gd, Gd, Gs, Gs, Gs, Gs, Gs, Gs, Gs, Re, Rr, Gs, Gs, Gs, Gs, Ds^Esd, Ds, Ds, Ds, Ds, Ds, Ds, Gs, Gs, Gs, Gs, Gs, Gs^Es, Gs, Gs, Gg, Gg, Ww, Ww, Ww, Ww, Gg, Gg, Gs, Gg, Gs, Gg, Gg, Gg, Gg, Gg, Gg, Gg, Gg, Gg, Gg, Hh, Hh, Hh, Hh, Hh, Hh, Gg, Gg, Gg, Gg, Gs^Fds, Gg, Gg, Gg, Gg, Gs, Gs, Rd, Gd, Rd, Gd, Gs
Rb, Rb, Rb, Rb, Rb, Rb, Rb, Gd, Gd, Re^Gvs, Re^Gvs, Rb^Gvs, Rb^Gvs, Gd, Ch, Ch, Ch, Gd, Gs^Es, Gs, Gs, Gs, Rb, Rb, Re, Re, Gs, Gs^Es, Re^Gvs, Ds^Esd, Ds^Esd, Ds, Ds, Ds, Ds^Esd, Ds, Gd, Gd, Gs, Gs, Gs, Gs, Gs, Gs, Gs, Gg, Gs^Fds, Gs^Fds, Gs^Fds, Ww, Ww, Ww, Ww, Gg, Gg, Gg, Gg, Gg, Gg, Gg, Gg, Gg, Gg, Gg, Gg, Hh, Hh, Hh, Hh, Hh, Hh, Hh, Gg, Gg, Gg, Gg, Gs^Fds, Gs^Fds, Gs^Fds, Gs^Fds, Gs, Gs, Rd, Gd, Gd, Rd, Rd, Rd
Gd, Gd, Gd, Gd, Gd^Eff, Rb, Rb, Rb, Gd, Rb^Gvs, Rb^Gvs, Re^Gvs, Gd, Gd, Ch, 4 Kh, Ch, Gs, Gs, Gs, Rb, Rb, Rb, Rb, Gs, Gs, Rb^Gvs, Re^Gvs, Gd^Wm, Ds, Ds, Ds, Ds, Ds, Ds, Ds, Ds, Gd, Gs, Gs, Gs, Gs, Gs, Gs, Gs, Gs^Fds, Gs^Fds, Gs^Fds, Gs^Fds, Gs^Fds, Ww, Ww, Ww, Gg, Gg, Gg, Gg, Gg^Vh, Gg, Gg, Gg, Gg, Gg, Gg, Gg, Hh, Hh, Hh, Hh, Hh, Hh, Gg, Gg, Gg, Gg, Gs^Fds, Gs^Fds, Gs^Fds, Gs^Fds, Gg, Gs, Rd, Rd, Rd, Rd, Rd, Rd^Es, Rd
Re^Gvs, Gd, Re^Gvs, Rb^Gvs, Re^Eff, Gd^Eff, Rb, Rb, Rb, Gd, Gd, Gd, Rb, Rb, Rb, Ch, Rb, Rb, Rb, Rb, Rb, Rb, Gs, Gs, Rb^Gvs, Re^Gvs, Rb^Gvs, Rb^Gvs, Rb^Gvs, Gd, Ds, Ds, Ds, Ds, Ds, Ds, Gd, Gd, Gd, Gs, Gs, Gs, Gs, Gs, Gs, Gs^Fds, Gs, Gs^Fds, Gs^Fds, Gs^Fds, Ww^Wkf, Ww, Ww, Gg, Gg, Gg, Gg, Gg, Gg, Gg, Gg, Gg, Gg, Gg, Gg, Gg, Hh, Hh, Hh, Hh, Gg, Gg, Gg, Gg, Gs, Gg, Gs, Gs, Gg, Gs, Rd, Gs, Rd, Gd, Rd, Ds, Ds, Ds
Rb^Gvs, Rb^Gvs, Re^Gvs, Re^Gvs, Re^Gvs, Gd^Eff, Gd^Eff, Rb, Rb, Rb, Rb, Rb, Rb, Rb, Gs^Eff, Rb, Gs, Rb, Rb, Rb, Gs, Gs, Gs, Gs, Gd, Rb^Gvs, Rb^Gvs, Re^Gvs, Re^Gvs, Rb^Eff, Gd^Eff, Gd, Ds, Ds, Ds, Ds, Ds, Ds, Gd, Gs, Gs, Gs, Gs, Gs, Gs, Gs, Gs, Gs^Fds, Gs^Fds, Gs^Fds, Ww^Wkf, Ww, Ww, Gg, Gg, Gg, Gg, Gg, Gg, Gg, Gg, Gg, Gg, Gg, Gg, Gg, Hh, Hh, Hh, Gg, Gg, Gs, Gs, Rd, Gs, Gs^Es, Gs, Gs, Rd, Gs, Gs, Gs, Rd, Rd, Ds, Ds, Ds, Ds
Gd, Re^Gvs, Re^Gvs, Re^Gvs, Re^Gvs, Re^Gvs, Re^Gvs, Gd^Eff, Gd^Eff, Rb, Rb, Rb, Rb^Eff, Gd^Eff, Rb^Gvs, Gs^Eff, Gd^Eff, Gs, Rb, Gs, Gs, Gs^Vh, Rb, Rb, Rb, Rb^Gvs, Rb^Gvs, Re^Gvs, Rb^Eff, Re^Eff, Re^Gvs, Gd^Eff, Gd^Eff, Ds, Ds, Ds, Ds, Gd, Gs, Gs, Gs, Gs, Gs, Gs, Gs, Gs^Es, Gs, Gs, Gg, Ww^Wkf, Ww, Ww, Gg, Gg, Gg, Gg, Gg, Gg, Gg, Gg^Es, Gg, Gg, Gs, Gg, Gg, Gg, Gg, Gs, Gs, Gs, Gs^Vh, Gs, Gs, Gs, Rd, Gs, Rd, Rd, Gd, Gs, Rd, Gd, Rd, Ds, Ds, Ds, Ds, Ds
Re^Gvs, Re^Gvs, Re^Gvs, Re^Gvs, Re^Gvs, Re^Gvs, Rb^Gvs, Gd, Gd, Gd, Gs^Eff, Rb^Eff, Rb^Gvs, Rb^Gvs, Re^Gvs, Rb^Gvs, Re^Gvs, Gs, Rb, Gs^Vh, Rb, Re, Gs, Gs^Vh, Gs, Rb, Gs^Eff, Re^Eff, Rb^Gvs, Re^Gvs, Rb^Gvs, Re^Gvs, Rb^Gvs, Gd^Eff, Gd, Gd, Gd, Gd, Gs, Gs, Gs, Gs, Gs, Gs, Gs, Gs, Gs, Gg, Gg, Ww^Wkf, Ww, Ww, Ww, Gg, Gg, Gg, Gg, Gg, Gg, Gg, Gg, Gg, Gg, Gg, Gg, Gg, Gs, Gs, Gs, Gg, Rd, Gd, Gd, Gd, Rd, Rd, Rd, Rd, Rd, Gs, Rd, Gd, Rd, Ds, Ds, Ds, Ds, Ds
Rb^Gvs, Re^Gvs, Rb^Gvs, Re^Gvs, Re^Gvs, Re^Gvs, Gd, Gs, Rb^Eff, Gs^Eff, Re^Gvs, Rb^Gvs, Re^Gvs, Re^Gvs, Re^Gvs, Re^Gvs, Re^Gvs, Re^Gvs, Gs, Rb, Gs, Gs, Gs, Gs, Gs, Rb^Gvs, Rb^Gvs, Re^Gvs, Rb^Gvs, Rb^Gvs, Rb^Gvs, Rb^Gvs, Rb^Gvs, Rb^Gvs, Re^Gvs, Gs, Rb^Gvs, Gs, Gs, Gs, Gs, Gs, Gs, Gs, Gs, Gs, Gs, Gg, Gg, Gg, Ww, Ww, Ww, Ww^Wkf, Gg, Gg, Gg, Gg, Gs, Gg, Gs, Gg, Gg, Gg, Gs, Gs, Rd, Rd, Gs, Gd, Gd, Rd, Rd, Gd, Rd, Rd, Rd, Rd, Ds, Ds, Rd, Rd, Ds, Ds, Ds, Ds, Ds, Ds
Gd, Rb^Gvs, Re^Gvs, Re^Gvs, Gd, Gd, Gd, Gd^Es, Rb^Gvs, Re^Gvs, Rb^Gvs, Rb^Gvs, Re^Gvs, Re^Gvs, Rb^Gvs, Re^Gvs, Re^Gvs, Rb^Gvs, Rb^Gvs, Gs, Gs, Hh, Hh, Hh, Gs, Rb^Gvs, Rb^Gvs, Rb^Gvs, Rb^Gvs, Rb^Gvs, Re^Gvs, Re^Gvs, Rb^Gvs, Re^Gvs, Rb^Gvs, Re^Gvs, Gs, Gs, Gs^Fds, Gs, Gs^Fds, Gs, Gs, Gs, Gs, Gg^Vh, Gg, Gg, Gs, Gg, Gg, Ww, Ww, Ww, Ww, Gg, Gg, Gg, Gs, Gs, Gg, Gg, Gg, Gg, Gs, Rd, Rd, Gs, Rd, Gd, Rd, Gd, Rd, Rd, Rd, Rd, Rd, Ds, Ds, Ds, Ds, Rd, Rd, Rd, Ds, Ds, Ds, Ds
Rb^Gvs, Rb^Gvs, Rb^Gvs, Gd, Rb^Gvs, Gd, Rb^Gvs, Rb^Gvs, Rb^Gvs, Rb^Gvs, Rb^Gvs, Rb^Gvs, Re^Gvs, Rb^Gvs, Rb^Gvs, Re^Gvs, Rb^Gvs, Rb^Gvs, Rb^Gvs, Hh, Hh, Hh, Hh, Hh, Hh, Gs^Es, Gs, Gs, Gs, Rb^Gvs, Rb^Gvs, Rb^Gvs, Rb^Gvs, Rb^Gvs, Gs, Gs, Gs, Gs, Gs^Fds, Gs^Fds, Gs^Fds, Gs^Fds, Gs, Gs, Gs, Gg, Gs, Gs, Gs, Gs, Gs, Gg, Ww, Ww, Ww, Gg, Gg, Gg, Gg, Gg, Gg, Gg, Gs, Gg, Gs, Gd, Gs, Rd, Gd, Gd, Rd, Rd, Rd, Rd, Ds, Ds, Ds, Ds, Ds, Ds, Ds, Ds, Ds, Ds, Ds, Ds, Ds, Ds
Rb^Gvs, Rb^Gvs, Gd, Gd, Rb^Gvs, Rb^Gvs, Rb^Gvs, Rb^Gvs, Rb^Gvs, Rb^Gvs, Re^Gvs, Re^Gvs, Rb^Gvs, Rb^Gvs, Rb^Gvs, Re^Gvs, Rb^Gvs, Rb^Gvs, Gs, Hh, Hh, Hh^Es, Hh, Hh, Hh, Hh, Hh, Hh, Hh, Gs, Gs, Rb^Gvs, Gs, Gs, Gs^Fds, Gs^Fds, Gs^Fds, Gs^Fds, Gs^Fds, Gs^Fds, Gs^Fds, Gs, Gs^Fds, Gs, Gs, Gg, Gs, Gs, Gs, Gs, Gs, Gg, Gg, Ww, Ww, Ww, Gg, Gg, Gg, Gg, Gg, Gg, Gs, Gs, Gd, Gs, Rd, Gd, Rd, Gd, Rd, Rd, Ds, Ds, Ds, Ds, Ds, Ds, Ds, Ds, Ds, Ds, Ds, Ds, Ds, Ds, Ds, Ds
Gd, Gd, Gd, Rb^Gvs, Gd, Rb^Gvs, Gd, Re^Gvs, Rb^Gvs, Rb^Gvs, Rb^Gvs, Rb^Gvs, Re^Gvs, Rb^Gvs, Rb^Gvs, Rb^Gvs, Gs, Gs, Gs, Hh, Hh, Hh, Hh, Hh, Hh, Hh, Hh, Hh^Es, Hh, Gs, Gs, Gs, Gs, Gs, Gs, Gs^Fds, Gs^Fds, Gs^Fds, Gs^Fds, Gs^Fds, Gs^Fds, Gs^Fds, Gs^Fds, Gs, Gs, Gg, Gs, Gs, Gs, Gs, Gs, Gg, Gg, Ww, Ww, Ww, Gg, Gg, Gg, Gg, Gg, Gg, Gg, Gs, Gg, Gs, Gd, Gd, Gd, Rd, Rd, Rd, Ds, Ds, Ds, Ds, Ds, Ds, Ds, Ds, Ds, Ds, Ds, Ds, Ds, Ds, Ds, Ds
