Gd, Gd, Gd, Gd, Gs, Gs, Gs, Gs, Gs, Gs, Gs, Gs, Gs, Gs, Gs, Gs, Gs, Gs, Gs^Eff, Gs^Eff, Re^Gvs, Re^Gvs, Re^Gvs, Gs, Gs, Gs, Gs, Gs, Gs, Gs, Gs, Gs, Gs, Gs, Rb^Gvs, Rb^Gvs, Rb^Gvs, Rb^Gvs, Re^Gvs, Gs, Gs, Gs, Gs, Gs, Gs, Gs, Gs, Gs, Gs^Efm, Gs^Efm, Gg, Gg, Gg, Gg, Gg, Gg, Gg, Gg, Gg, Gg, Gg, Gg, Gg, Gg, Gg, Gg, Gs, Gg, Gs, Gs, Gs, Gg, Gd, Gs, Gs, Gs, Gs, Gs, Rb^Gvs, Gs, Re^Gvs, Re^Gvs, Re^Gvs, Gg, Re^Gvs, Re^Gvs, Rb^Gvs, Rb^Gvs
Gd, Gd, Gd, Gd, Gs, Gs, Gs, Gs, Gd, Gs, Gd, Gd, Gd, Gs, Gs, Gs, Gs^Eff, Gs^Eff, Rb^Gvs, Re^Gvs, Re^Gvs, Re^Gvs, Rb^Gvs, Re^Gvs, Gs, Gs, Gs, Gs, Gs, Gs, Rb^Gvs, Rb^Gvs, Rb^Gvs, Re^Gvs, Rb^Gvs, Re^Gvs, Re^Gvs, Re^Gvs, Re^Gvs, Rb^Gvs, Re^Gvs, Re^Gvs, Re^Gvs, Gs, Gs^Eff, Gs, Gs^Efm, Gs, Gs^Efm, Gs, Gg^Efm, Gg, Gg^Efm, Gg, Gg^Efm, Gg^Efm, Gg, Gg, Gg^Efm, Gg, Gg^Efm, Gg, Gg, Gg, Gs, Gs, Gs, Gs, Gd, Gg, Gd, Gd, Gd, Gd, Re^Gvs, Gd, Gs, Rb^Gvs, Gs^Eff, Re^Gvs, Re^Gvs, Rb^Gvs, Re^Gvs, Rb^Gvs, Rb^Gvs, Re^Gvs, Rb^Gvs, Rb^Gvs
Gd, Gd, Gd, Gs, Gs, Gs, Gs, Gs, Gd, Gd, Gd, Gd, Gd, Gs, Rb^Gvs, Gs^Eff, Rb^Gvs, Rb^Gvs, Re^Gvs, Re^Gvs, Re^Gvs, Rb^Gvs, Rb^Gvs, Rb^Gvs, Rb^Gvs, Gs, Gs, Gs^Es, Gs, Re^Gvs, Re^Gvs, Re^Gvs, Re^Gvs, Re^Gvs, Re^Gvs, Re^Gvs, Re^Gvs, Re^Gvs, Re^Gvs, Re^Gvs, Re^Gvs, Rb^Gvs, Re^Eff, Re^Eff, Rb^Gvs, Rb^Gvs, Re^Gvs, Gs^Es, Gs^Efm, Gg, Gs^Efm, Gg, Ds, Gg, Gg^Efm, Gg, Gg^Vh, Gg, Gg, Gg^Efm, Gg, Gs, Gg^Efm, Gg^Efm, Gg, Gs, Gs, Gd^Efm, Gs, Gd, Gd, Gll^Fdf, Gll^Fdf, Re^Gvs, Re^Gvs, Gd, Gs^Eff, Gs^Eff, Rb^Gvs, Re^Gvs, Re^Gvs, Rb^Gvs, Re^Gvs, Rb^Gvs, Rb^Gvs, Rb^Gvs, Rb^Gvs, Rb^Gvs
Gd, Gd, Gd, Gs, Gs, Gd, Gll^Fdf, Gll^Fdf, Gll^Fdf, Gll^Fdf, Gll^Fdf, Gd, Gd, Gs, Rb^Gvs, Rb^Gvs, Rb^Gvs, Re^Gvs, Re^Gvs, Re^Gvs, Gs, Rb^Gvs, Gs, Gs, Re, Re, Re, Gs, Gs, Gs, Re^Gvs, Re^Gvs, Rb^Gvs, Re^Gvs, Re^Gvs, Re^Gvs, Re^Gvs, Rb^Gvs, Re^Gvs, Re^Gvs, Re^Eff, Re^Eff, Re^Gvs, Re^Gvs, Re^Gvs, Re^Gvs, Re^Gvs, Re^Gvs, Gs, Gs, Ds, Ds, Ds, Ds, Ds^Esd, Ds^Esd, Ds, Gg, Gg, Gg, Gg, Gg, Gg, Gg, Gs, Gs, Gs, Gs, Gs, Gs^Vh, Gs, Gll^Fdf, Re^Gvs, Re^Gvs, Re^Gvs, Gll^Fdf, Gg, Re^Gvs, Re^Gvs, Re^Gvs, Gs, Re^Gvs, Rb^Gvs, Rb^Gvs, Re^Gvs, Rb^Gvs, Re^Gvs, Re^Gvs
Gd, Gd, Gd, Gs, Gs, Gd, Gll^Fdf, Gll^Fdf, Gll^Fdf, Gll^Fdf, Gll^Fdf, Gll^Fdf, Gd, Gs, Rb^Gvs, Rb^Gvs, Re^Gvs, Re^Gvs, Gs, Gs, Re, Gs, Gs^Vh, Re, Ch, Ch, Ch, Re, Gg, Gs, Gs, Rb^Gvs, Gs, Re^Gvs, Rb^Gvs, Rb^Gvs, Re^Gvs, Re^Gvs, Re^Gvs, Re^Gvs, Gs^Gvs, Re^Eff, Gs^Eff, Re^Gvs, Re^Gvs, Rb^Gvs, Re^Gvs, Re^Gvs, Gs, Gs^Efm, Ds, Ds, Ds, Ds, Ww, Ww, Ww, Ww, Ww, Ww, Ww, Gg, Gg, Gg, Gg, Gs, Gs, Gs, Gg^Efm, Re, Gs, Gs, Re^Gvs, Re^Gvs, Rb^Gvs, Gs, Gs, Re^Gvs, Re^Gvs, Re^Gvs, Gs, Gg, Re^Gvs, Rb^Gvs, Re^Gvs, Re^Gvs, Re^Eff, Re^Eff
Gd, Gd, Gs, Gs, Gd, Gs, Gs, Gll^Fdf, Hh^Fdf, Gll^Fdf, Hh^Fdf, Re^Gvs, Re^Gvs, Re^Gvs, Re^Gvs, Rb^Gvs, Re^Gvs, Re^Gvs, Gs^Vh, Re, Gs^Vh, Re, Re, Re, Ch, 2 Kh, Ch, Re, Gs, Gg, Gg, Gs, Rb^Gvs, Rb^Gvs, Re^Gvs, Re^Gvs, Rb^Gvs, Re^Gvs, Rb^Gvs, Gs^Gvs, Gs^Eff, Gs^Eff, Gs^Vl, Rb^Eff, Rb^Eff, Re^Gvs, Re^Gvs, Re^Gvs, Gs^Efm, Gs^Efm, Ds, Ds, Ds, Ww, Ww, Ww, Wo, Wo, Wo, Wo, Ww, Ww, Ds^Esd, Gg, Ds, Gg^Efm, Gg, Gg, Re, Re, Re, Gs, Gs, Re^Gvs, Re^Gvs, Gs, Gs^Wm, Gg, Gs, Gs, Gs, Gg, Gg^Eff, Re^Gvs, Re^Eff, Rb^Eff, Rb^Gvs, Re^Gvs
Gs, Gs, Gs, Gd, Gs, Gs, Gd, Hh, Hh^Fdf, Hh^Fdf, Hh^Fdf, Gs, Gs, Re^Gvs, Re^Gvs, Re^Gvs, Gs, Gs, Re, Re, Gs, Gs, Gs, Re, Re, Ch, Re, Re, Gs, Gg, Gs, Gs, Gs, Gs, Rb^Gvs, Rb^Gvs, Gs, Gs, Gs^Vl, Gs^Eff, Re, Re, Rb^Gvs, Rb^Gvs, Rb^Gvs, Re^Eff, Rb^Gvs, Gs^Efm, Gs, Gs^Efm, Ds, Ds, Ww, Ww, Wo, Wo, Wo, Wo, Wo, Wo, Wo, Ww, Ww, Ds, Ds, Gg, Gg, Gs^Vh, Gg, Gg, Gg, Re, Gs^Vl, Gs, Gg, Gg, Gg, Gg, Gg, Gs, Gg, Gg, Gg, Gg^Eff, Gg^Eff, Re^Gvs, Re^Gvs, Rb^Gvs
Gs, Gs, Gs, Gd, Gs, Gs, Hh, Hh^Es, Hh, Hh, Gs, Gs, Gll^Fdf, Gll^Fdf, Gll^Fdf, Gs, Gs, Re, Re, Gs^Wm, Re, Gs, Re, Re, Rb^Gvs, Re, Gs^Eff, Re, Re, Gs, Gg, Gs, Gs, Rb^Gvs, Gs, Gs, Gs, Gs, Gs, Re, Re^Gvs, Re^Gvs, Rb^Gvs, Rb^Gvs, Rb^Gvs, Rb^Gvs, Rb^Gvs, Rb^Gvs, Gs^Gvs, Gs^Efm, Gs^Efm, Ds, Ww, Wo, Wo, Wo, Wo, Wo, Wo, Wo, Wo, Wo, Ww, Ds, Ds, Gg^Efm, Gg^Efm, Gg, Gs, Gg, Gs, Gg, Gs, Gs, Gs, Gg, Gg, Gg^Efm, Gg, Gg, Gg, Gg, Gg^Efm, Gg, Gg, Gg^Eff, Gg^Eff, Re^Gvs
Gd, Gd, Gs, Gs, Gs, Gd, Gd, Hh, Hh, Gd, Gs, Gd, Gd, Gll^Fdf, Gd, Gs, Gs, Gd^Vh, Re, Re, Gd^Vh, Re, Re^Gvs, Gd, Rb^Gvs, Re^Gvs, Rb^Gvs, Gs^Eff, Gs^Eff, Re, Gg, Gg, Gs, Gs, Gs, Gs, Gs, Gs, Re^Gvs, Re^Gvs, Re^Gvs, Rb^Gvs, Rb^Gvs, Re^Gvs, Gs^Wm, Rb^Gvs, Rb^Gvs, Rb^Gvs, Re^Gvs, Gs^Efm, Ds, Ds, Ww, Wo, Wo, Wo, Wo, Wo, Wo, Wo, Wo, Ww, Ww, Ww, Ds, Ds, Ds, Gg, Gs, Gs, Gs, Gs, Gs, Gs, Gs, Gs, Gs, Gg, Gs, Gg^Efm, Gs, Gs, Gg, Gg, Gs, Gg, Gg, Gg^Eff
Gs, Gs, Gs, Gd, Gd^Es, Gd, Gs, Gd, Gs, Gs, Gs, Gd, Gd, Gd, Gs, Gd, Gd, Gd, Gs, Gd, Gs, Gs, Re^Gvs, Re^Gvs, Re^Gvs, Rb^Gvs, Re^Gvs, Rb^Eff, Gs^Eff, Re, Re, Gs, Re, Gs, Gs, Gs, Gs, Gs^Vl, Rb^Gvs, Rb^Gvs, Rb^Gvs, Rb^Gvs, Rb^Gvs, Rb^Gvs, Re^Gvs, Re^Gvs, Re^Gvs, Re^Gvs, Re^Gvs, Gs, Gs, Ww, Ww, Ww, Wo, Wo, Wo, Wo, Wo, Wo, Wo, Wo, Ww, Ww, Ds, Ds, Ds, Gs, Rd, Ds, Ds, Ds, Ds, Ds, Ds, Ds, Gs, Gs, Gs, Gs, Gd, Gs, Gs, Gs, Gs, Gs, Gll^Fdf, Gll^Fdf
Gd, Gs, Gd, Gs, Gd, Gd, Gs, Gs, Gll^Fdf, Gs, Gll^Fdf, Gd, Gs, Gs, Gd, Gd, Gd, Gd, Gd, Gd, Gd, Gd, Gd, Gd, Gd, Re^Gvs, Rb^Gvs, Rb^Gvs, Rb^Gvs, Gs^Eff, Gs, Re, Gs, Re, Re, Gs, Gs, Gs, Re, Rb^Gvs, Rb^Gvs, Rb^Vl, Re, Re^Gvs, Re^Gvs, Rb^Gvs, Rb^Gvs, Rb^Gvs, Rb^Gvs, Gs, Gs, Ww, Wo, Wo, Wo, Wo, Wo, Wo, Wo, Wo, Wo, Ww, Ww, Ds, Ds, Gs, Ds, Ds, Ds, Ds, Ds, Ds, Ds, Ds, Ds, Ds, Gs, Gd, Gd, Gd, Gd, Gs, Gs, Gs, Gd, Gs, Gll^Fdf, Gll^Fdf
Gd, Gd, Gd, Gd, Gd, Gs, Gs, Gs, Gll^Fdf, Gll^Fdf, Gll^Fdf, Gll^Fdf, Gd, Re^Gvs, Gd, Ds^Esd, Ds^Esd, Ds^Esd, Ds^Esd, Ds, Ds, Ds, Ds, Ds, Gd, Gs, Re^Gvs, Re^Gvs, Gs, Rb^Gvs, Gs, Gs, Gs, Gs, Gs, Re, Re, Re, Gs^Vl, Re, Re, Re, Gll^Fdf, Gs, Gll^Fdf, Re^Gvs, Gs, Rb^Gvs, Gs, Gs, Gs, Ww, Ww, Wo, Wo, Wo, Wo, Wo, Wo, Wo, Wo, Wo, Ww, Ds, Gg, Gs, Gs^Efm, Ds, Ds, Ds, Ds, Ds, Ds, Ds, Rd, Gs, Gs, Gd, Gd, Gd, Gs, Gs, Gd, Gd, Gll^Fdf, Gll^Fdf, Gll^Fdf, Gll^Fdf
Gg, Gd, Gs^Es, Gd, Gs, Gd, Gs, Gll^Fdf, Gs, Gll^Fdf, Gd, Gd, Gd, Gd, Gd, Ds, Ds, Ds, Ds^Esd, Ds, Ds, Ds^Esd, Ds, Ds, Ds, Gd, Gd, Gs, Gs, Gs, Hh, Hh, Hh, Hh, Gs, Gs, Re, Gs, Gs, Gd, Re, Gll^Fdf, Gll^Fdf, Gll^Fdf, Gll^Fdf, Gll^Fdf, Gll^Fdf, Gs, Gs^Efm, Gs, Gs^Efm, Gs, Ww, Ww, Wo, Wo, Wo, Wo, Wo, Wo, Wo, Wwr, Wwr, Ds^Esd, Gg^Efm, Gg^Efm, Gs^Es, Gs, Ds, Ds, Ds, Ds, Ds, Ds, Ds, Gs, Gd, Gd, Gs^Efm, Gs, Gs, Gs, Gd, Gs, Gd, Gll^Fdf, Gll^Fdf, Gll^Fdf
Gd, Gd, Gd, Gd, Gd, Gs, Gd, Gs, Gd, Gs, Gd, Gd, Gd, Ds, Ds, Ds, Ds, Ds, Ds, Ds^Esd, Ds, Ds^Esd, Ds, Ds, Ds, Ds, Gs, Gs, Gs, Gs, Hh, Hh, Hh, Hh, Hh, Gs, Gs, Re, Gd, Gd^Es, Re, Gd, Gll^Fdf, Gll^Fdf, Gll^Fdf, Gll^Fdf, Gs, Gs, Gs, Gs, Gs, Gs, Ww, Wo, Wo, Wo, Wo, Wo, Wo, Ww, Wwr, Wwr, Ds, Ds^Esd, Gg^Efm, Gs, Gs, Gs^Efm, Gs, Ds, Ds, Ds, Ds, Ds, Gs, Gs, Gs, Gs, Gs, Gs, Gs, Gs, Gs, Gs, Gd, Gll^Fdf, Gll^Fdf, Gll^Fdf
Gd, Gd, Gd, Gd, Gd, Gd, Gd, Gd, Gd, Gd, Gd, Gs, Gd, Gd, Ds, Ds, Ds^Esd, Ds, Ds^Esd, Ds, Ds, Ds, Ds, Gd, Gd, Gd^Vh, Gs, Gs, Gs, Gs, Gs, Hh, Hh, Hh, Gs, Gs, Gs, Re, Re, Gd, Re, Gd, Gd, Gd, Gs, Gd, Gs, Gs, Gs^Efm, Gs^Efm, Gg, Gs, Ww, Ww, Ww, Ww, Ww, Ww, Ww, Ww, Wwr, Ds, Gg^Efm, Gg, Gg, Gg, Gg, Gs, Gg, Gs, Gs, Gs, Gs, Gs, Gs, Gs, Gs^Efm, Gs, Gg, Gg, Gg, Gs, Gs, Gs^Es, Gg, Gll^Fdf, Gll^Fdf, Gll^Fdf
Gd, Gd, Gd, Gd, Gd, Gd, Gd, Gd, Gs, Gd, Gd, Gs, Gd, Gd, Gd, Ds, Ds, Ds, Ds, Ds, Ds, Gd, Gd, Gd, Gs, Gd, Gs, Gs, Gs, Gs, Gs, Gs, Gs, Gs, Gs, Gs, Gs, Gs, Gs, Re, Gd, Gd, Gd, Gd, Ds, Gs, Gs, Gs, Gg, Gg^Efm, Ww, Ww, Ww, Ww, Ds, Ds, Ch, Ch^Kov, Ch, Ds, Ds^Esd, Ds, Gg, Gg, Gs, Gg, Gg^Efm, Gg, Gg, Gs, Gs, Gg, Gg^Efm, Gg, Gg, Gg, Gg, Gg, Gg, Gg, Gg^Efm, Gg, Gg, Gg, Gg^Efm, Gg, Gll^Fdf, Gll^Fdf
Gd, Gd, Gd, Gd, Gd, Gd, Gs, Gd, Gs, Gd, Gs, Gs, Gs, Gs, Gd, Gd, Gd, Gd, Gd, Gd, Gd, Gd, Gs, Gs, Gs, Gs, Gs, Gs, Gs, Gs, Gs, Gs, Gs, Gs, Gs, Gs, Gs, Gs, Gs, Re, Re, Gs, Ds, Ds^Esd, Ds, Ds, Gs^Efm, Gg, Ww, Ww, Ww, Ww, Gs^Fds, Gs^Fds, Gg, Gg, Gg, Rr^Vhh, Gg, Gg^Efm, Gg, Gg^Efm, Gs, Gs, Gs, Gg, Gg, Gg, Gg, Gs, Gg, Gs, Gg, Gg, Gg, Gg^Efm, Gg, Gg, Gg, Gg, Gg, Gg, Gg^Efm, Gg, Gg, Gg, Gg, Gll^Fdf
Gs, Gd, Gd, Gd, Gd, Gd, Gd, Gd, Gs, Gs, Gd, Gs, Gd, Gd, Gs, Gd, Gs, Gd, Gs, Gs, Gs, Gs^Em, Gd, Gs, Gs, Gs, Gs, Gs, Gs, Gs, Gs, Gs, Gs, Gs, Ds, Gs, Ds, Ds, Ds, Gs, Re, Gs, Gs, Ds, Gs, Gs^Efm, Gg, Gg, Ww, Ww, Gg, Gg, Gg, Gg, Gg, Gg, Re, Re, Re, Gg, Gs, Gs, Gd, Gs, Gs, Gs, Gg, Gg, Gg, Gg, Gg, Gg, Gg^Eff, Gg^Eff, Re^Eff, Gg, Gg^Vh, Gg, Gg, Gg, Gg, Gs, Gs, Gs, Gs^Wm, Gs, Gg, Gg
Gd, Gs, Gd, Gd, Gd, Gd, Gd, Gd, Gd, Gd, Gs, Gd, Gs, Gd, Gd, Gd, Gs, Gd, Gs, Gd, Gs^Em, Gd, Gs, Gs^Em, Gs, Gs, Gs, Gs, Gs, Gs, Gs, Gs, Gs, Ds, Ds, Ds^Esd, Ds^Esd, Dd^Do, Ds, Gs, Gs, Re, Gs, Gs, Gs, Gg, Wwr, Wwr, Ww, Ww, Gg^Efm, Gg, Gg, Gg^Efm, Gg, Gg^Vl, Re, Gg^Ecf, Re, Gs^Vl, Gll^Fdf, Gll^Fdf, Gll^Fdf, Gd, Gd, Gs, Gs, Gg^Efm, Gg, Gs, Gs^Eff, Gs^Eff, Rb^Gvs, Rb^Gvs, Re^Gvs, Re^Gvs, Rb^Gvs, Re, Re, Gg, Gs, Gs, Re, Re, Gs, Gg, Gll^Fdf, Gll^Fdf
Gd, Gd, Gd, Gd, Gd, Gd, Gs, Gd, Gs, Gd, Gs, Gd, Gs, Gs^Es, Gd, Gs, Gs, Gs, Gs, Gs, Gs, Gs, Gs^Em, Gs, Gs, Gs, Gs, Gs, Gs, Gs, Gs^Es, Gs, Gs, Gs, Gs, Gs, Gs, Ds^Esd, Ds, Gs, Gs, Re, Re, Gs, Gg, Gg, Ww, Ww, Gg, Gg, Gg, Gg, Re^Gvs, Re^Gvs, Re^Gvs, Re, Gg, Re, Gs^Vl, Gs, Gll^Fdf, Hh^Fdf, Hh^Fdf, Hh^Fdf, Hh, Hh, Gg, Gg, Gs, Gs, Rb^Gvs, Re^Gvs, Rb^Gvs, Rb^Gvs, Re^Gvs, Re^Gvs, Re^Gvs, Re^Gvs, Rb^Gvs, Re, Re, Gs, Re, Gs, Gs, Gs, Gs, Gll^Fdf
Gd, Gd, Gd, Gd, Gd, Gd, Gd, Gd, Gd, Gd, Gs, Gs, Gs, Gd, Gs, Gs, Gs, Gs, Gs^Vh, Gs, Gs, Gs, Gs, Gs, Gs, Gs, Ww, Ww, Ww, Gs, Gs, Gs, Gs, Gs, Gs^Vh, Re^Gvs, Rb^Gvs, Gs, Ds, Ds, Rb^Gvs, Gs^Eff, Gs^Eff, Re, Rr, Ww, Ww, Ww, Gg, Gg^Efm, Gg, Re^Gvs, Re^Gvs, Re^Gvs, Gs^Fds, Re, Gs^Fds, Gg, Re^Gvs, Gs, Gs, Hh^Fdf, Hh^Fdf, Hh^Fdf, Hh^Es, Hh, Hh, Gg, Gg^Vh, Re^Gvs, Rb^Gvs, Rb^Gvs, Re^Gvs, Re^Gvs, Re^Gvs, Re^Gvs, Rb^Gvs, Rb^Gvs, Gg, Gg, 1 Gg, Re, Gs, Re, Gs^Vl, Gs, Gs, Gs
Gd, Gd, Gd, Gd, Gd, Gd, Gd, Gs, Gs, Gs, Gs, Gs, Gs, Gs, Gs, Gs, Re, Re, Re, Gs, Hh, Hh^Fdf, Ww, Ww, Ww, Ww, Wo, Wo, Ww, Gs, Re^Gvs, Re^Gvs, Rb^Gvs, Rb^Gvs, Rb^Gvs, Re^Gvs, Rb^Gvs, Rb^Gvs, Re^Gvs, Rb^Gvs, Rb^Gvs, Rb^Gvs, Re^Gvs, Gs^Eff, Gg^Eff, Wwf, Wwf, Gg, Gg, Gg, Gg, Gs^Fds, Re, Re, Re, Re, Re^Gvs, Re^Gvs, Rb^Gvs, Re^Gvs, Gg, Hh, Hh, Hh, Hh, Hh, Gg, Gg, Rb^Gvs, Rb^Gvs, Rb^Gvs, Rb^Gvs, Rb^Gvs, Re^Gvs, Rb^Gvs, Rb^Gvs, Rb^Gvs, Gg, Gg^Em, Gg, Gg, Re, Gg, Gg, Gg, Gs, Re, Re
Gd, Gd, Gd, Gd, Gd, Gd, Gd, Gd, Gs, Gs, Gs, Gd, Gs, Gs, Gs, Gs^Vh, Re, Gs^Ecf, Re, Gs, Gs, Hh^Fdf, Ww, Ww, Gs^Fdf, Ww, Ww, Wo, Wo, Ww, Ww, Re^Gvs, Gs, Re^Gvs, Re^Gvs, Re^Gvs, Rb^Gvs, Re^Gvs, Re^Gvs, Rb^Gvs, Re^Gvs, Re^Gvs, Rb^Gvs, Gs^Eff, Gg, Wwf, Ww, Rr, Re, Gg, Gg, Gg, Re^Es, Gg, Rb^Gvs, Re^Gvs, Rb^Gvs, Rb^Gvs, Rb^Gvs, Rb^Gvs, Rb^Gvs, Gg, Hh, Hh^Fdf, Hh^Fdf, Hh, Gg, Rb^Gvs, Re^Gvs, Rb^Gvs, Rb^Gvs, Re^Gvs, Rb^Gvs, Rb^Gvs, Rb^Gvs, Rb^Gvs, Gg, Gg^Vh, Re, Gg, Gg, Re, Re, Re, Re, Re, Re, Re
Gd, Gd, Gd, Gd, Gd, Gd, Gd, Gd, Gs, Gs, Gll^Fdf, Gs, Gll^Fdf, Gs, Gs, Gs, Gs, Re, Gs^Vh, Re, Re, Gs, Gs, Hh^Fdf, Ch, Hh^Fdf, Hh, Ww, Ww, Ww, Ww, Gs, Ww, Gs, Gs, Re^Gvs, Re^Gvs, Re^Gvs, Re^Gvs, Re^Gvs, Re^Gvs, Re^Gvs, Gg, Gg, Ww, Ww, Ww, Gg, Gg, Re, Re, Re, Gg, Gg, Re^Gvs, Re^Gvs, Re^Gvs, Rb^Gvs, Rb^Gvs, Rb^Gvs, Re^Gvs, Re^Gvs, Hh, Hh^Fdf, Hh, Gs, Gg, Re^Gvs, Re^Gvs, Rb^Gvs, Re^Gvs, Re^Gvs, Rb^Gvs, Re^Gvs, Re^Gvs, Re^Gvs, Gg, Gg, Gg, Re, Re, Re, Re, Re, Re, Re, Gs, Gg
Gd, Gd^Es, Gd, Gd, Gd, Gd, Gs, Gd, Gs, Gll^Fdf, Gll^Fdf, Gll^Fdf, Gll^Fdf, Gll^Fdf, Gd, Gd, Gd, Gs, Gd, Gd, Hh^Fdf, Re, Re, Ch, 3 Kh, Ch, Hh^Fdf, Wwr, Ww, Wo, Wo, Ww, Ww, Ww, Ww, Gd, Gd, Rb^Gvs, Gd, Re^Gvs, Gg, Gg, Ww, Ww, Ww, Ww, Gg, Gg, Gg, Gg, Re, Gg, Gg^Eff, Re^Gvs, Re^Gvs, Re^Gvs, Re^Gvs, Re^Gvs, Re^Gvs, Re^Gvs, Re^Gvs, Re^Gvs, Re^Gvs, Gg, Gg, Gg, Gg, Re^Gvs, Re^Gvs, Re^Gvs, Re^Gvs, Rb^Gvs, Rb^Gvs, Re^Gvs, Gg, Gg, Gg, Gg, Re, Re, Re, Re, Gs, Gs, Gg^Vh, Gg, Gg, Gs
Gd, Gd, Gd, Gd, Gd, Gs, Gs, Gs, Gll^Fdf, Gll^Fdf, Gll^Fdf, Gll^Fdf, Gll^Fdf, Gll^Fdf, Gll^Fdf, Gd, Re^Gvs, Re^Gvs, Re^Gvs, Gll^Fdf, Gs, Gs, Re, Ch, Ch, Ch, Gs^Fdf, Wwr, Wwr, Wo, Ww, Ww, Ww, Ww, Ww, Gll^Fdf, Gll^Fdf, Gll^Fdf, Gll^Fdf, Gll^Fdf, Ww, Ww, Ww, Ww, Gg, Gg, Gg, Gg, Gg, Gg, Gg, Re, Re, Gg^Eff, Gg^Eff, Re^Gvs, Re^Gvs, Re^Gvs, Re^Gvs, Rb^Gvs, Rb^Gvs, Re^Gvs, Gg, Gg, Gg, Gg, Gg, Gg^Efm, Gg, Gg, Gg, Rb^Gvs, Gg, Gg, Gg^Efm, Gg, Gg, Re, Re, Re, Gs, Gs, Gs, 6 Gs^Efm, Gg^Efm, Gg, Gg, Gg
Gd, Gd, Gd, Gd, Gd, Gd, Gd, Gs, Gs, Gll^Fdf, Gll^Fdf, Gll^Fdf, Gll^Fdf, Gll^Fdf, Rb^Gvs, Gd, Rb^Gvs, Rb^Gvs, Re^Gvs, Re^Gvs, Re^Gvs, Gs, Gs, Re, Re, Re, Gs, Wwr, Wwr, Ww, Gs, Ww, Gs, Ww, Ww, Ww, Ww, Gll^Fdf, Gll^Fdf, Ww, Ww, Ww, Gg, Gg, Gg, Gg, Gs, Gg, Gs, Gg, Gg, Gg, Re, Re, Re, Gg^Eff, Gg^Eff, Gg^Eff, Gg^Eff, Rb^Gvs, Rb^Gvs, Rb^Gvs, Gg, Gg, Gg, Gg, Gg^Es, Gg, Gg, Gg, Gg, Gg, Gg, Gg, Gg, Gg, Re, Re, Re, Gg, Gg, Gg, Gg, Gg^Efm, Gg^Efm, Gg, Gg, Gg
Gd, Gd, Gd, Gs, Gd, Gs, Gd, Gd, Gs, Gll^Fdf, Gs, Gs, Rb^Gvs, Rb^Gvs, Rb^Gvs, Rb^Gvs, Re^Gvs, Re^Gvs, Re^Gvs, Re^Gvs, Re^Gvs, Gs^Eff, Gs^Eff, Gs, Re, Gs, Re, Gs, Gs, Gs, Gs, Gs, Gs, Gs, Re^Gvs, Ww, Ww, Gll^Fdf, Gll^Fdf, Ww, Ww, Gg, Gg, Gg, Gs, Gs, Gs, Gs, Gs, Gs, Gg, Re, Gg, Gg, Gg, Re, Re, Re, Re, Re, Re, Gg, Gg, Gg, Gg, Gg, Gg, Gg, Gg, Gg, Gg, Gg, Gg, Gg, Re, Re, Re, Re, Gg, Re, Gg^Vh, Gg, Gg, Gg, Gg, Gg, Gg, Gg
Gd, Gd, Gd, Gd, Gd, Gd, Gd, Gd, Gs, Gs, Rb^Gvs, Rb^Gvs, Re^Gvs, Rb^Gvs, Re^Gvs, Re^Gvs, Re^Gvs, Re^Gvs, Re^Gvs, Re^Gvs, Re^Eff, Gs^Eff, Re, Re, Gs, Re, Gs, Re, Re, Gs, Gs, Gs, Gs, Re^Gvs, Re^Gvs, Re^Gvs, Ww, Ww, Ww, Ww, Ww, Gg, Gg, Gs, Gs, Gs, Gd, Gd, Gd, Gs, Re, Re, Gg, Gg, Gg, Gg, Gg, Gg, Gg, Gg, Gg, Re, Re, Gg, Gg, Gg, Re, Gg, Re, Gg, Re, Re, Re, Re, Re, Re, Gg, Gg, Gg, Gg, Gg, Gg, Gg, Gg, Gg, Gg, Gg, Gg
Gd, Gd, Gd, Gd, Gd, Gd, Gs, Gs, Rb^Gvs, Rb^Gvs, Re^Gvs, Re^Gvs, Rb^Gvs, Re^Gvs, Re^Gvs, Re^Gvs, Re^Gvs, Re^Gvs, Gs^Eff, Gs^Eff, Re, Re, Gs, Gs, Gd, Gs, Gs, Gs, Re, Gs^Vh, Gs, Gs, Gs, Gs, Gs, Gs, Ww, Ww, Ww, Ww, Gg, Gg, Gs, Gg, Gs, Hh, Hh^Fdf, Gll^Fdf, Gll^Fdf, Gs, Re, Gg, Gg, Gg, Gg, Ds, Ds, Ds, Ds, Ds, Ds, Gg, Gg, Re, Re, Re, Re, Re, Re, Re, Re, Re, Re, Re, Gg, Gg, Gg, Gg, Gg, Gg, Gg, Gg, Gg, Gg^Es, Gg, Gs, Gg, Gg
Gd, Gd, Gd, Gs, Gd, Gs, Gs, Re^Gvs, Gd, Re^Gvs, Rb^Gvs, Rb^Gvs, Rb^Gvs, Re^Gvs, Rb^Gvs, Rb^Gvs, Gs, Gs^Eff, Re, Re, Gs, Gs, Gs, Gd, Gd, Gd, Gs^Vh, Re, Gs^Wm, Re, Gs, Gs, Gs, Gs, Gg, Gs, Ww, Ww, Ww, Wwr, Gg, Gg, Gg, Gg, Gg, Gll^Fdf, Hh^Fdf, Hh^Fdf, Hh, Gg, Re, Gg, Gg, Gg, Ds, Ds, Ds, Ds^Esd, Ds^Esd, Ds, Gg, Gg, Re, Re, Re, Re, Gg, Gg, Gg, Gg, Gg, Gg, Gg, Gg, Gg, Gg, Gs, Gs, Gg, Gg, Gg, Gg, Gg, Gg, Gs, Gs, Gs, Gg
Gd, Gd, Gd, Gd, Gd, Gs, Gs, Gd, Rb^Gvs, Rb^Gvs, Rb^Gvs, Rb^Gvs, Rb^Gvs, Rb^Gvs, Gs, Gs, Gs, Re, Gs, Gs, Gs, Gs, Rb^Gvs, Re^Gvs, Rb^Gvs, Gs, Gd, Re, Re, Re, Gs, Gs, Gs, Gg, Ww, Ww, Ww, Ww, Wwr, Wwr, Gg, Gg, Gg, Gs, Gg, Hh, Gll^Fdf, Gll^Fdf, Hh, Gg^Vh, Gg, Re, Gg^Wm, Gg, Ds, Ds, Ds, Ds, Ds^Esd, Ds, Gg, Gg, Re, Re, Gs, Gs, Hh, Hh, Hh, Hh, Hh, Gg, Gg, Gs, Gs, Gs, Gs, Gg, Gg, Gs, Gg, Gg, Gg, Gg, Gg, Gs, Gs, Gg
Gd, Gd, Gd, Gd, Gd, Gs, Gd, Gs, Rb^Gvs, Re^Gvs, Rb^Gvs, Rb^Gvs, Rb^Gvs, Gs, Gs, Gs, Gs, Re, Gs, Gs, Re^Gvs, Re^Gvs, Rb^Gvs, Re^Gvs, Rb^Gvs, Rb^Gvs, Rb^Gvs, Rb^Gvs, Gs, Gs^Vh, Gs, Gs, Ww, Ww, Ww, Ww, Wwr, Ww, Re^Gvs, Re^Gvs, Rb^Gvs, Rb^Gvs, Re^Gvs, Re^Gvs, Re^Gvs, Gg, Re, Gg, Gg^Vh, Gg, Re, Re, Gg, Gg, Ds^Esd, Ds^Esd, Ds, Ds, Ds, Ds, Gg, Re, Re, Re, Gs, Hh, Hh, Hh^Fdf, Hh^Fdf, Hh, Gg^Vl, Gg, Gg, Gg, Gg, Gs, Gg, Gg, Gg, Gg, Gg, Gg, Gg, Gg, Gg, Gg, Gg, Gg
Gd, Gd, Gd, Gd, Gd, Gs, Gd, Rb^Gvs, Gs, Re^Gvs, Rb^Gvs, Rb^Gvs, Hh, Hh, Hh, Gs, Gd, Re, Gs, Re^Gvs, Re^Gvs, Rb^Gvs, Re^Gvs, Rb^Gvs, Rb^Gvs, Rb^Gvs, Rb^Gvs, Rb^Gvs, Rb^Gvs, Gs, Gs, Gg, Ww, Ww, Ww, Ww, Rb^Gvs, Rb^Gvs, Re^Gvs, Rb^Gvs, Rb^Gvs, Rb^Gvs, Rb^Gvs, Rb^Gvs, Gg, Re, Gg^Vh, Re, Re, Re, Gg, Gg^Vh, Ds, Ds, Ds, Ds, Ds, Ds, Gg, Gg, Re, Re, Re, Gs, Gs, Gll^Fdf, Gll^Fdf, Hh^Fdf, Hh, Hh, Hh, Gg, Gg, Gg^Es, Gg, Gg, Gg, Gg, Gg^Es, Gg, Gg, Gg, Gg, Gg, Gg, Gg, Gg, Gg
Gd, Gd, Gd, Gd, Gd, Gd, Gd, Gd, Gd, Rb^Gvs, Gs, Hh, Hh, Hh, Hh, Gs, Gd, Re, Gs, Re^Gvs, Rb^Gvs, Re^Gvs, Rb^Gvs, Re^Gvs, Re^Gvs, Rb^Gvs, Rb^Gvs, Rb^Gvs, Rb^Gvs, Rb^Gvs, Gs, Gs, Ww, Ww, Ww, Gg, Rb^Gvs, Re^Gvs, Rb^Gvs, Rb^Gvs, Rb^Gvs, Rb^Gvs, Rb^Gvs, Rb^Gvs, Gg, Re, Re, Gg, Gg, Gg, Gg, Gg, Gg, Gg, Gg, Gg, Gg, Gg, Re, Re, Re, Re, Gll^Fdf, Gs, Gs, Gs, Gll^Fdf, Hh^Fdf, Hh, Hh, Hh, Gg, Gg, Gg, Gg, Gg, Gg, Gg, Gg, Gs, Gg, Gg, Gg, Gg, Gg, Gg, Gg, Gg
Gs, Gd, Gd, Gd, Gd, Gd, Gs, Gs, Gs, Gd, Gs, Gs, Hh, Hh^Fdf, Hh^Fdf, Hh, Gd, Re, Re, Gs, Gs, Re^Gvs, Re^Gvs, Rb^Gvs, Rb^Gvs, Rb^Gvs, Rb^Gvs, Rb^Gvs, Rb^Gvs, Rb^Gvs, Rb^Gvs, Gs, Ww, Ww, Re^Gvs, Re^Gvs, Rb^Gvs, Rb^Gvs, Rb^Gvs, Rb^Gvs, Rb^Gvs, Rb^Gvs, Rb^Gvs, Rb^Gvs, Gg, Gg, Re, Gg, Re, Gg, Gg, Gg, Gg, Gg, Gg, Gg, Re, Re, Re, Re, Gll^Fdf, Gd, Gll^Fdf, Gll^Fdf, Gll^Fdf, Gs, Gs, Gll^Fdf, Gs, Gs, Gg, Gg, Gg, Gg, Re^Gvs, Gg, Gg, Gg, Gg, Gg, Gs, Gg, Gg, Gs, Gs, Gg, Gg, Gg
Gd, Gd, Gd, Gd, Gd, Gd, Gs, Gs, Gd, Gd^Es, Gs, Gs, Gll^Fdf, Gll^Fdf, Gll^Fdf, Gd, Gll^Fdf, Gd^Vh, Re, Gs, Gs, Gs, Gs, Re^Gvs, Re^Eff, Rb^Gvs, Rb^Gvs, Rb^Gvs, Rb^Gvs, Rb^Gvs, Gs, Ww, Ww, Ww, Gg, Re^Gvs, Re^Gvs, Re^Gvs, Rb^Gvs, Rb^Gvs, Rb^Gvs, Rb^Gvs, Gg, Gg, Gs, Re, Rr, Re, Re, Re, Re, Re, Re, Re, Re, Re, Re, Re, Gs, Re, Re, Gll^Fdf, Gd, Gll^Fdf, Gd, Gs, Gg, Gs, Rb^Gvs, Rb^Gvs, Rb^Gvs, Re^Gvs, Re^Gvs, Re^Gvs, Rb^Gvs, Gg, Gg, Gg, Gg, Gg, Gg, Gg, Gg, Gg, Gg, Gg, Gg^Es, Gg
Gd, Gd, Gd, Gd, Gd, Gd, Gs, Gd, Gs, Gs, Gs, Gs, Gs, Gs, Gll^Fdf, Gll^Fdf, Gll^Fdf, Gd, Re, Gs, Gs, Gs, Gs, Gs^Gvs, Gll^Fdf, Re^Eff, Rb^Eff, Rb^Gvs, Rb^Gvs, Gs, Gs, Ww, Ww, Gg, Rb^Gvs, Re^Gvs, Rb^Gvs, Rb^Gvs, Rb^Gvs, Rb^Gvs, Gs, Gs, Rr, Rr, Rr, Rr, Gg, Re, Gg, Re, Re, Re, Re, Re, Re, Re, Gg, Gs, Gs, Gs, Gs, Re, Gd, Gd, Gs, Gs, Rb^Gvs, Rb^Gvs, Rb^Gvs, Rb^Gvs, Rb^Gvs, Rb^Gvs, Re^Gvs, Rb^Gvs, Re^Gvs, Rb^Gvs, Gg, Gg, Gg, Gg^Es, Gg, Gg, Gg, Gg, Gg, Gg, Gg^Es, Gg^Es
Gd, Gd^Es, Gd, Gd, Gd, Gd, Gd, Gs, Gs, Gs, Gd, Ds, Ds, Ds, Ds, Ds^Esd, Gd, Gd, Re, Gs^Vh, Gs, Gs, Re^Gvs, Gll^Fdf, Re^Gvs, Gs^Eff, Re^Gvs, Rb^Eff, Gs^Eff, Gs, Gs, Ww, Ww, Ww, Gg, Rb^Gvs, Gg, Rb^Gvs, Gs, Gs, Rr, Rr, Gs, Gs, Gg, Gg, Gg, Gg, Gs, Gg, Gg, Gg, Gg, Gg, Gg, Gg, Gg, Gg, Gg, Gg, Gg, Re, Gs, Gs, Gs, Gs^Eff, Gg^Eff, Rb^Gvs, Rb^Gvs, Rb^Gvs, Re^Gvs, Re^Gvs, Rb^Gvs, Re^Gvs, Re^Gvs, Re^Gvs, Gg^Vh, Gg, Gg, Gg, Gg, Gg, Gg, Gg, Gg, Gg, Gs^Eff, Gs^Eff
Gd, Gd, Gd, Gd, Gd, Gd, Gs, Gd, Gd, Gs, Ds, Ds^Esd, Ds, Ds, Gs, Ds, Gs, Gs, Re, Gs, Gs, Rb^Gvs, Rb^Gvs, Re^Gvs, Rb^Gvs, Rb^Gvs, Re^Gvs, Re^Gvs, Re^Gvs, Gs^Eff, Gs, Ww, Ww, Ww, Ww, Gg, Ch, Gg, Rr, Rr, Gg, Gg, Gg, Gg, Gg, Gg, Gg, Gg, Gg, Gg, Gs, Gg, Gs, Gs, Gg, Gg, Gg, Gg, Gg, Gg, Gg, Re, Re, Gs, Gs, Gg, Gg, Gs^Eff, Gs^Eff, Re^Gvs, Re^Gvs, Rb^Gvs, Re^Gvs, Re^Gvs, Rb^Gvs, Rb^Gvs, Re, Gg, Gg, Gg^Vh, Re, Gg, Re, Gg, Gg^Eff, Gs^Eff, Rb^Gvs, Rb^Gvs
Gd, Gd, Gd, Gd, Gd, Gd, Gd, Gd, Gd, Gd, Gd, Ds, Gs, Ds, Ds, Gs, Gs, Gs, Re, Gs, Re^Gvs, Gs, Re^Gvs, Rb^Gvs, Rb^Gvs, Rb^Gvs, Rb^Gvs, Re^Gvs, Rb^Gvs, Re^Gvs, Gs, Gs, Gs, Ww, Ww, Wwr, Rr, Rr, Rr, Gg, Gg, Gg, Gg, Gg, Gg, Gg, Gs, Gs, Rd, Gs, Rd, Gs, Rd, Gs, Rd, Gs, Gs, Gg, Gg, Gg, Gg, Gg, Gg, Re, Re, Re, Re, Gs, Gs^Eff, Gs^Eff, Re^Gvs, Re^Gvs, Re^Gvs, Re^Gvs, Gg, Gg, Rr, Gg, Gg, Gg, Re, Re, Gg, Re, Gg^Wm, Re^Gvs, Re^Gvs, Re^Gvs
Gd, Gd, Gd, Gd, Gd, Gd, Gs, Gd, Gs, Gd, Gs, Gs, Re^Gvs, Ds, Gs^Eff, Gs^Eff, Gs^Eff, Gs, Gs^Vh, Re, Gs, Re^Gvs, Gs, Re^Gvs, Rb^Gvs, Rb^Gvs, Rb^Gvs, Rb^Gvs, Rb^Gvs, Rb^Gvs, Re^Gvs, Gs, Gg, Ww, Ww^Bsb/, Ww^Bsb/, Ww^Bsb/, Rr, Ch^Kov, Ch, Gg, Gg, Gg, Gg, Gg, Gg, Gs, Ds, Ds, Ds, Ds, Ds, Ds, Rd, Rd, Rd, Gs, Gg, Gg, Gg, Gg, Gg, Gg, Gg, Gg, Gg, Gg, Re, Re, Gs^Eff, Re^Gvs, Re^Gvs, Gg, Re, Rr, Rr, Ch, Rr, Rr, Re, Gg^Es, Gg, Re^Gvs, Re^Gvs, Rb^Gvs, Rb^Gvs, Re^Gvs, Re^Gvs
Gd, Gd, Gd, Gd, Gs, Gs, Gd, Gs, Gs, Gd, Re^Gvs, Re^Gvs, Re^Gvs, Gs^Eff, Rb^Gvs, Re^Gvs, Rb^Gvs, Gs^Eff, Gs, Re, Re, Gs, Re^Gvs, Rb^Gvs, Rb^Gvs, Rb^Gvs, Rb^Gvs, Rb^Gvs, Re^Gvs, Re^Gvs, Re^Gvs, Gs, Rr, Rr, Rr, Ww^Bsb/, Ww, Ww, Ww, Ch, Ww, Gg, Gg, Gg, Gg, Gg, Gs, Ds, Ds^Esd, Ds^Esd, Ds, Ds, Ds^Esd, Ds^Esd, Ds, Rd, Rd, Gs, Gs, Gg, Gg, Gg, Gg, Gg, Re^Gvs, Re^Gvs, Re^Gvs, Gg, Re, Gs, Gs, Gg, Gg, Gg, Rr, Ch, 5 Kh, Ch, Rr, Gg, Re^Gvs, Re^Gvs, Re^Gvs, Re^Gvs, Rb^Gvs, Rb^Gvs, Rb^Gvs, Rb^Gvs
Gd, Gd, Gd, Gd, Gd, Gd, Gs, Gs, Re^Gvs, Re^Gvs, Re^Gvs, Re^Gvs, Rb^Gvs, Rb^Gvs, Rb^Gvs, Rb^Gvs, Gs, Gs, Gs, Gs, Gs, Re, Re, Re^Gvs, Re^Gvs, Rb^Gvs, Gs^Vh, Re^Gvs, Re^Gvs, Rb^Gvs, Gd, Rr, Rr, Rr, Gs, Ch, Gg, Ww, Ww, Ww, Ww, Ww, Ww, Ww, Wwr, Gg, Gg, Ds, Ds, Ds, Ds, Ds, Dd^Do, Ds, Rd, Rd, Gs, Gg, Gg, Gs, Gg, Gg, Re^Gvs, Re^Gvs, Re^Gvs, Re^Gvs, Re^Gvs, Re^Gvs, Re^Gvs, Re, Re, Re, Re, Gg, Rr, Ch, Ch, Ch, Rr, Re, Re^Gvs, Re, Re^Gvs, Rb^Gvs, Rb^Gvs, Re^Gvs, Rb^Gvs, Re^Gvs
Gd, Gd, Gd, Gd, Gd, Gd, Gd, Gd, Gd, Re^Gvs, Rb^Gvs, Rb^Gvs, Rb^Gvs, Rb^Gvs, Rb^Gvs, Rb^Gvs, Gs, Gs, Gs, Gs, Gs, Gs, Re, Gs, Gs, Gs, Gs, Gs, Gd, Gd, Rr, Rr, Gs, Gs, Gs, Gs, Gs, Gs, Gs, Ww, Ww, Ww, Ww, Ww, Ww, Wwr, Wwr, Gg, Ds, Ds, Ds, Ds, Ds, Ds, Rd, Rd, Rd, Gs, Gg, Gg, Re^Gvs, Re^Gvs, Re^Gvs, Re^Gvs, Re^Gvs, Rb^Gvs, Re^Gvs, Re^Gvs, Re^Gvs, Re^Gvs, Re, Gg, Gg, Re, Gg, Rr, Rr, Rr, Gg, Re^Gvs, Re^Gvs, Re^Gvs, Re^Gvs, Re^Gvs, Rb^Gvs, Rb^Gvs, Rb^Gvs, Rb^Gvs
Gd, Gd, Gd, Gs, Gd, Gd, Gd, Gs, Re^Gvs, Rb^Gvs, Re^Gvs, Re^Gvs, Rb^Gvs, Rb^Gvs, Re^Gvs, Re^Gvs, Gs, Hh, Hh, Hh, Hh^Es, Gs, Gs, Re, Re, Gs, Rr, Rr, Rr, Rr, Gs, Gs, Gs, Gs, Gs, Gs, Gs, Gs, Gs, Gs, Gg, Ww, Gg, Ww, Ww, Wwr, Ww, Gg, Gs, Gs, Ds, Ds, Ds, Ds^Esd, Ds, Rd, Gs, Gs, Re^Gvs, Re^Gvs, Re^Gvs, Re^Gvs, Re^Gvs, Re^Gvs, Re^Gvs, Re^Gvs, Re^Gvs, Re^Gvs, Re^Gvs, Rb^Gvs, Gg^Vh, Gg, Gg, Gg, Gg, Gg, Re, Gg, Re, Re^Gvs, Re, Re^Gvs, Re^Gvs, Re^Gvs, Rb^Eff, Rb^Gvs, Re^Eff, Rb^Eff
Gd, Gd, Gd, Gd, Gd^Es, Gd, Gd, Gd, Re^Gvs, Rb^Gvs, Rb^Gvs, Re^Gvs, Re^Gvs, Re^Gvs, Re^Gvs, Gs, Gs, Hh, Hh, Hh, Hh, Hh, Gs, Gs, Gs, Re, Rr, Rr, Gs, Gs, Gs, Gs, Gd, Gs, Gs, Gs, Gs, Gs, Gs, Gs, Gs, Gs, Gg^Vh, Gg, Gg, Ww, Ww, Ww, Gg, Gs, Gs, Rd, Gs, Rd, Rd, Rd, Rd, Gs, Re^Gvs, Re^Gvs, Re^Gvs, Re^Gvs, Re^Gvs, Re^Gvs, Re^Gvs, Rb^Gvs, Re^Gvs, Re^Gvs, Gg, Gg, Gg, Gg, Gg, Gs, Gs^Vh, Re, Gs, Re, Gg^Es, Rb^Gvs, Rb^Gvs, Re^Gvs, Rb^Gvs, Rb^Gvs, Re^Eff, Re^Eff, Re^Gvs, Re^Gvs
Gd, Gd, Gd, Gd, Gd, Gd, Gd, Gd, Gs, Re^Gvs, Rb^Gvs, Re^Gvs, Re^Gvs, Re^Gvs, Gs, Gs, Hh, Hh, Hh, Hh, Hh, Gs, Gs, Gs, Re, Rr, Re, Gd, Gs, Gs, Gd, Gd, Gd, Gd, Gd, Gd, Gd, Gs, Gs, Gs, Gs, Gs, Gs, Gg, Gs, Gg, Ww, Ww, Ww, Gg, Gg, Gg, Gs, Rd, Gs, Rd, Gs, Gg, Gg, Re^Gvs, Re^Gvs, Re^Gvs, Rb^Gvs, Rb^Gvs, Rb^Gvs, Re^Gvs, Gg, Gg, Gg, Gg, Gg, Gg, Gs, Gs, Gs, Gs, Gs, Gg, Gg, Gg, Gg, Rb^Gvs, Rb^Eff, Rb^Eff, Rb^Gvs, Re^Gvs, Rb^Gvs, Rb^Gvs
Rb, Rb, Rb, Gd, Rb, Gd, Gd, Gd, Gd, Re^Gvs, Re^Gvs, Rb^Gvs, Rb^Gvs, Gd, Gd, Gd, Gd, Gs, Gs, Gs, Gs, Gs, Gs, Gs, Re, Rr, Gs, Gs, Gs, Gs, Ds^Esd, Ds, Ds, Ds, Ds, Ds, Ds, Gs, Gs, Gs, Gs, Gs, Gs^Es, Gs, Gd, Gg, Gg, Ww, Ww, Ww, Ww, Gg, Gg, Gs, Gg, Gs, Gg, Gg, Gg, Rb^Gvs, Re^Gvs, Re^Gvs, Re^Gvs, Re^Gvs, Gg, Gg, Hh, Hh, Hh, Hh, Hh, Hh, Gs, Gs, Gd, Gd, Gll^Fdf, Gs, Gs, Gs, Gg, Gs, Gs, Rd^Eff, Gd^Eff, Rb^Gvs, Rb^Gvs, Rb^Gvs
Rb, Rb, Rb, Rb, Rb, Rb, Rb, Gd, Gd, Re^Gvs, Re^Gvs, Rb^Gvs, Rb^Gvs, Gd, Ch, Ch, Ch, Gd, Gs^Es, Gs, Gs, Gs, Rb, Rb, Re, Re, Gs, Gs^Es, Re^Gvs, Ds^Esd, Ds^Esd, Ds, Ds, Ds, Ds^Esd, Ds, Gd, Gd, Gs, Gs, Gs, Gs, Gd, Gd, Gs, Gg, Gll^Fdf, Gll^Fdf, Gll^Fdf, Ww, Ww, Ww, Ww, Gg, Gg, Gg, Gg, Gg, Gg, Gg, Gg, Re^Gvs, Gg, Gg, Gg, Hh, Hh, Hh, Hh, Hh, Hh, Hh, Gs, Gs, Gd, Gd, Gll^Fdf, Gll^Fdf, Gll^Fdf, Gll^Fdf, Gs, Gs, Rd, Gd, Gd, Rd^Eff, Rd^Eff, Rd
Gd, Gd, Gd, Gd, Gd^Eff, Rb, Rb, Rb, Gd, Rb^Gvs, Rb^Gvs, Re^Gvs, Gd, Gd, Ch, 4 Kh, Ch, Gs, Gs, Gs, Rb, Rb, Rb, Rb, Gs, Gs, Rb^Gvs, Re^Gvs, Gd^Wm, Ds, Ds, Ds, Ds, Ds, Ds, Ds, Ds, Gd, Gs, Gs, Gs, Gs, Gs, Gd, Gd, Gll^Fdf, Gll^Fdf, Gll^Fdf, Gll^Fdf, Gll^Fdf, Ww, Ww, Ww, Gg, Gg, Gg, Gg, Gg^Vh, Gg, Gg, Gg, Gg, Gg, Gg, Gg, Hh, Hh, Hh, Hh, Hh, Hh, Gg, Gs, Gd, Gs, Gll^Fdf, Gll^Fdf, Gll^Fdf, Gll^Fdf, Gs, Gs, Rd, Rd, Rd, Rd, Rd, Rd^Es, Rd^Eff
Re^Gvs, Gd, Re^Gvs, Rb^Gvs, Re^Eff, Gd^Eff, Rb, Rb, Rb, Gd, Gd, Gd, Rb, Rb, Rb, Ch, Rb, Rb, Rb, Rb, Rb, Rb, Gs, Gs, Rb^Gvs, Re^Gvs, Rb^Gvs, Rb^Gvs, Rb^Gvs, Gd, Ds, Ds, Ds, Ds, Ds, Ds, Gd, Gd, Gd, Gs, Gs, Gs, Gd, Gd, Gd, Gll^Fdf, Gd, Gll^Fdf, Gll^Fdf, Gll^Fdf, Wwr, Ww, Ww, Gg, Gg, Gg, Gg, Gg, Gg, Gg, Gg, Gg, Gg, Gg, Gg, Gg, Hh, Hh, Hh, Hh, Gg, Gs, Gg, Gs, Gs, Gg, Gs, Gs, Gg, Gs, Rd, Gs, Rd, Gd, Rd, Ds, Ds, Ds
Rb^Gvs, Rb^Gvs, Re^Gvs, Re^Gvs, Re^Gvs, Gd^Eff, Gd^Eff, Rb, Rb, Rb, Rb, Rb, Rb, Rb, Gs^Eff, Rb, Gs, Rb, Rb, Rb, Gs, Gs, Gs, Gs, Gd, Rb^Gvs, Rb^Gvs, Re^Gvs, Re^Gvs, Rb^Eff, Gd^Eff, Gd, Ds, Ds, Ds, Ds, Ds, Ds, Gd, Gs, Gs, Gs, Gd, Gd, Gd, Gd, Gs, Gll^Fdf, Gll^Fdf, Gll^Fdf, Wwr, Ww, Ww, Gg, Gg, Gg, Gg, Gg, Gg, Gg, Gg, Gg, Gg, Gg, Gg, Gg, Hh, Hh, Hh, Gg, Gg, Gs, Gs, Rd, Gs, Gs^Es, Gs, Gs, Rd, Gs, Gs, Gs, Rd, Rd, Ds, Ds, Ds, Ds
Gd, Re^Gvs, Re^Gvs, Re^Gvs, Re^Gvs, Re^Gvs, Re^Gvs, Gd^Eff, Gd^Eff, Rb, Rb, Rb, Rb^Eff, Gd^Eff, Rb^Gvs, Gs^Eff, Gd^Eff, Gs, Rb, Gs, Gs, Gs^Vh, Rb, Rb, Rb, Rb^Gvs, Rb^Gvs, Re^Gvs, Rb^Eff, Re^Eff, Re^Gvs, Gd^Eff, Gd^Eff, Ds, Ds, Ds, Ds, Gd, Gs, Gs, Gs, Gs, Gs, Gd, Gs, Gs^Es, Gs, Gs, Gg, Wwr, Ww, Ww, Gg, Gg, Gg, Gg, Gg, Gg, Gg, Gg^Es, Gg, Gg, Gs, Gg, Gg, Gg, Gg, Gs, Gs, Gs, Gs^Vh, Gs, Gs, Gs, Rd, Gs, Rd, Rd, Gd, Gs, Rd, Gd, Rd, Ds, Ds, Ds, Ds, Ds
Re^Gvs, Re^Gvs, Re^Gvs, Re^Gvs, Re^Gvs, Re^Gvs, Rb^Gvs, Gd, Gd, Gd, Gs^Eff, Rb^Eff, Rb^Gvs, Rb^Gvs, Re^Gvs, Rb^Gvs, Re^Gvs, Gs, Rb, Gs^Vh, Rb, Re, Gs, Gs^Vh, Gs, Rb, Gs^Eff, Re^Eff, Rb^Gvs, Re^Gvs, Rb^Gvs, Re^Gvs, Rb^Gvs, Gd^Eff, Gd, Gd, Gd, Gd, Gd, Gs, Gd, Gs, Gs, Gs, Gs, Gs, Gs, Gg, Gg, Wwr, Ww, Ww, Ww, Gg, Gg, Gg, Gg, Gg, Gg, Gg, Gg, Gg, Gg, Gg, Gg, Gg, Gs, Gs, Gs, Gg, Rd, Gd, Gd, Gd, Rd, Rd, Rd, Rd, Rd, Gs, Rd, Gd, Rd, Ds, Ds, Ds, Ds, Ds
Rb^Gvs, Re^Gvs, Rb^Gvs, Re^Gvs, Re^Gvs, Re^Gvs, Gd, Gs, Rb^Eff, Gs^Eff, Re^Gvs, Rb^Gvs, Re^Gvs, Re^Gvs, Re^Gvs, Re^Gvs, Re^Gvs, Re^Gvs, Gs, Rb, Gs, Gs, Gs, Gs, Gs, Rb^Gvs, Rb^Gvs, Re^Gvs, Rb^Gvs, Rb^Gvs, Rb^Gvs, Rb^Gvs, Rb^Gvs, Rb^Gvs, Re^Gvs, Gs, Rb^Gvs, Gs, Gs, Gd, Gd, Gd, Gd, Gs, Gs, Gs, Gs, Gs, Gs, Gg, Ww, Ww, Ww, Wwr, Gg, Gg, Gg, Gg, Gs, Gg, Gs, Gg, Gg, Gg, Gs, Gs, Rd, Rd, Gs, Gd, Gd, Rd, Rd, Gd, Rd, Rd, Rd, Rd, Ds, Ds, Rd, Rd, Ds, Ds, Ds, Ds, Ds, Ds
Gd, Rb^Gvs, Re^Gvs, Re^Gvs, Gd, Gd, Gd, Gd^Es, Rb^Gvs, Re^Gvs, Rb^Gvs, Rb^Gvs, Re^Gvs, Re^Gvs, Rb^Gvs, Re^Gvs, Re^Gvs, Rb^Gvs, Rb^Gvs, Gs, Gs, Hh, Hh, Hh, Gs, Rb^Gvs, Rb^Gvs, Rb^Gvs, Rb^Gvs, Rb^Gvs, Re^Gvs, Re^Gvs, Rb^Gvs, Re^Gvs, Rb^Gvs, Re^Gvs, Gs, Gs, Gll^Fdf, Gd, Gll^Fdf, Gd, Gd, Gs, Gs, Gg^Vh, Gs, Gg, Gs, Gg, Gg, Ww, Ww, Ww, Ww, Gg, Gg, Gg, Gs, Gs, Gg, Gg, Gg, Gg, Gs, Rd, Rd, Gs, Rd, Gd, Rd, Gd, Rd, Rd, Rd, Rd, Rd, Ds, Ds, Ds, Ds, Rd, Rd, Rd, Ds, Ds, Ds, Ds
Rb^Gvs, Rb^Gvs, Rb^Gvs, Gd, Rb^Gvs, Gd, Rb^Gvs, Rb^Gvs, Rb^Gvs, Rb^Gvs, Rb^Gvs, Rb^Gvs, Re^Gvs, Rb^Gvs, Rb^Gvs, Re^Gvs, Rb^Gvs, Rb^Gvs, Rb^Gvs, Hh, Hh, Hh, Hh, Hh, Hh, Gs^Es, Gs, Gs, Gs, Rb^Gvs, Rb^Gvs, Rb^Gvs, Rb^Gvs, Rb^Gvs, Gs, Gs, Gs, Gs, Gll^Fdf, Gll^Fdf, Gll^Fdf, Gll^Fdf, Gs, Gs, Gs, Gg, Gs, Gs, Gd, Gs, Gs, Gg, Ww, Ww, Ww, Gg, Gg, Gg, Gg, Gg, Gg, Gg, Gs, Gg, Gs, Gd, Gs, Rd, Gd, Gd, Rd, Rd, Rd, Rd, Ds, Ds, Ds, Ds, Ds, Ds, Ds, Ds, Ds, Ds, Ds, Ds, Ds, Ds
Rb^Gvs, Rb^Gvs, Gd, Gd, Rb^Gvs, Rb^Gvs, Rb^Gvs, Rb^Gvs, Rb^Gvs, Rb^Gvs, Re^Gvs, Re^Gvs, Rb^Gvs, Rb^Gvs, Rb^Gvs, Re^Gvs, Rb^Gvs, Rb^Gvs, Gs, Hh, Hh, Hh^Es, Hh, Hh, Hh, Hh, Hh, Hh, Hh, Gs, Gs, Rb^Gvs, Gs, Gs, Gll^Fdf, Gll^Fdf, Gll^Fdf, Gll^Fdf, Gll^Fdf, Gll^Fdf, Gll^Fdf, Gs, Gll^Fdf, Gs, Gs, Gg, Gd, Gd, Gd, Gs, Gs, Gg, Gg, Ww, Ww, Ww, Gg, Gg, Gg, Gg, Gg, Gg, Gs, Gs, Gd, Gs, Rd, Gd, Rd, Gd, Rd, Rd, Ds, Ds, Ds, Ds, Ds, Ds, Ds, Ds, Ds, Ds, Ds, Ds, Ds, Ds, Ds, Ds
Gd, Gd, Gd, Rb^Gvs, Gd, Rb^Gvs, Gd, Re^Gvs, Rb^Gvs, Rb^Gvs, Rb^Gvs, Rb^Gvs, Re^Gvs, Rb^Gvs, Rb^Gvs, Rb^Gvs, Gs, Gs, Gs, Hh, Hh, Hh, Hh, Hh, Hh, Hh, Hh, Hh^Es, Hh, Gs, Gs, Gs, Gs, Gs, Gs, Gll^Fdf, Gll^Fdf, Gll^Fdf, Gll^Fdf, Gll^Fdf, Gll^Fdf, Gll^Fdf, Gll^Fdf, Gs, Gs, Gg, Gs, Gd, Gd, Gd, Gs, Gg, Gg, Ww, Ww, Ww, Gg, Gg, Gg, Gg, Gg, Gg, Gg, Gs, Gg, Gs, Gd, Gd, Gd, Rd, Rd, Rd, Ds, Ds, Ds, Ds, Ds, Ds, Ds, Ds, Ds, Ds, Ds, Ds, Ds, Ds, Ds, Ds
