Rr^Edt, Rr, Ch, Rb, Rb, Rb^Es, Rr, Rb, Isa^Vhc, Isa^Edt, Ch^Qhux, Rb^Gvs, Gd^Eff, Gd^Eff, Gll^Fdf, Ww, Wo, Ww, Ww, Ww, Gd, Gd, Gd, Gll^Fdf, Gll^Fdf, Rb, Rb, Gll^Fdf, Gll^Fdf, Rb, Gd, Gd, Rb^Gvs, Re^Gvs, Re^Gvs, Re^Eff, Re^Eff, Rb^Gvs, Re^Gvs, Re^Gvs, Re^Eff, Re^Eff
Rr^Edt, Rr^Edt, Rb, Rb, Rb, Rb^Edt, Isa^Edt, Rb, Isa, Isa^Edt, Ch^Qhux, Gs, Gll^Fmf, Gll^Fdf, Gs^Efm, Ww, Wo, Wo, Gll^Fmf, Gd, Gll^Fdf, Gd, Gll^Fdf, Gll^Fdf, Gll^Fdf, Gll^Fdf, Rb, Gd, Gll^Fdf, Gll^Fdf, Re^Gvs, Rb^Gvs, Re^Gvs, Re^Gvs, Rb^Gvs, Re^Gvs, Re^Eff, Re^Eff, Re^Eff, Re^Eff, Rb^Gvs, Re^Gvs
Rr, Rb^Vhc, Rb, Isa, Isa, Isa^Edt, Isa^Vhc, Isa, Ch^Qhux, Ch^Qhux, Gll^Fdf, Gll^Fmf, Gll^Fmf, Gll^Fdf, Gs^Efm, Ww, Gll^Fdf, Ww, Gll^Fdf, Gll^Fdf, Gll^Fdf, Gll^Fdf, Gll^Fdf, Gll^Fdf, Gll^Fdf, Gll^Fdf, Gs^Vl, Rb, Ce, Re^Gvs, Re^Gvs, Re^Gvs, Rb^Gvs, Re^Gvs, Re^Eff, Re^Eff, Rb^Gvs, Rb^Gvs, Rb^Gvs, Re^Eff, Re^Vh, Re^Gvs
Ch, Rb, Rb, Isa^Vhc, Isa, Isa, Isa, Isa, Ch^Qhux, Gll^Fdf, Gll^Fmf, Gll^Fmf, Gd^Eff, Gd^Eff, Gd^Eff, Gd^Eff, Gd^Eff, Gll^Fdf, Gll^Fmf, Gll^Fmf, Gll^Fmf, Gll^Fmf, Gll^Fmf, Gll^Fmf, Gll^Fmf, Gll^Fmf, Gll^Fmf, 3 Ke, Ce, Re^Gvs, Re^Gvs, Re^Gvs, Rb^Gvs, Re^Vh, Re^Gvs, Rb^Gvs, Re^Gvs, Re^Gvs, Re^Gvs, Rb^Gvs, Rb^Gvs, Re^Gvs
Rr^Edt, Ch^Edt, Rb, Rb, Ch, Rb, Rb^Edt, Rb^Es, Ch^Qhux, Gll^Fdf, Gd^Eff, Gd^Eff, Rb^Gvs, Rb^Gvs, Rb^Gvs, Rb^Gvs, Rb^Gvs, Gd^Eff, Gll^Fdf, Gll^Fdf, Gll^Fdf, Gll^Fdf, Gll^Fdf, Gll^Fdf, Gll^Fdf, Gll^Fdf, Gll^Fdf, Ce^Edt, Rb, Gs, Re^Eff, Rb^Gvs, Re^Gvs, Rb^Gvs, Re^Gvs, Re^Gvs, Re^Gvs, Re^Gvs, Gd^Es, Rb^Gvs, Re, Re
Re^Edt, Rr^Edt, Rr, Rb, Rr^Vhc, Rb, Rb^Ebn, Rb^Edt, Ch^Qhux, Gll^Fdf, Rb^Gvs, Rb^Gvs, Rb^Gvs, Rb^Gvs, Rb^Gvs, Rb^Gvs, Gd^Wm, Gll^Fdf, Rb^Gvs, Gll^Fdf, Gll^Fdf, Gll^Fdf, Gll^Fdf, Gll^Fdf, Gll^Fdf, Gll^Fdf, Re^Gvs, Gll^Fdf, Gll^Fdf, Gll^Fdf, Gll^Fdf, Re^Eff, Re^Eff, Re^Gvs, Re^Gvs, Re^Gvs, Gd^Eff, Gd, Hh, Gd, Hh, Hh
Rb, Re, Ch, Rr, Rr, Rb, Rb^Es, Rb^Edt, Xos, Gs, Rb^Gvs, Rb^Gvs, Rb^Gvs, Rb^Gvs, Gll^Fdf, Gll^Fdf, Rb^Gvs, Rb^Gvs, Rb^Gvs, Rb^Gvs, Gll^Fdf, Gll^Fdf, Gll^Fdf, Gll^Fdf, Re^Gvs, Re^Gvs, Re^Gvs, Rb^Gvs, Re^Gvs, Rb^Gvs, Gg, Gll^Fdf, Gs, Re^Eff, Re^Vwm, Gs^Eff, Gs, Hh^Fdf, Hh^Fdf, Hh^Fdf, Hh^Fdf, Hh^Fdf
Rb, Rb, Rb^Ebn, Re, Rb, Rr, Rr^Pr/o, Rr^Pr/o, Gs, Gs, Re, Re^Vhr, Ce, Ce, Rb^Gvs, Rb^Gvs, Rb^Gvs, Rb^Gvs, Rb^Gvs, Rb^Gvs, Rb^Gvs, Re^Vh, Rb^Gvs, Rb^Gvs, Re^Gvs, Re^Gvs, Re^Gvs, Re^Gvs, Rb^Gvs, Rb^Gvs, Gg, Gg^Efm, Gs^Efm, Gs, Gs^Efm, Gs, Hh, Hh^Es, Hh, Gll^Fdf, Gll^Fmf, Hh^Fdf
Rr^Edt, Rb^Es, Rb, Re, Xos, Rr^Pr/o, Gd, Rr, Rr^Edt, Gs^Edt, Ce^Edt, 2 Ket, Ce^Edt, Rb^Gvs, Rb^Gvs, Rb^Gvs, Rb^Gvs, Rb^Gvs, Ce, Ce, Rb^Gvs, Rb^Gvs, Rb^Gvs, Rb^Es, Re^Gvs, Re^Gvs, Re^Gvs, Rb^Gvs, Rb^Gvs, Rb^Gvs, Re^Vh, Gs, Gs, Gs^Efm, Gg^Efm, Gs^Efm, Gs, Hh, Gs, Gll^Fmf, Gll^Fmf, Gll^Fmf
Rb^Edt, Re^Edt, Ch^Qhux, Ch^Qhux, Gd, Gd, Gd, Gs, Re^Eff, Rr^Edt, Rr, Ce, Re, Rb^Gvs, Rb^Gvs, Rb^Gvs, Ce, Ce^Edt, Rb^Gvs, Rb^Gvs, Rb^Gvs, Rb^Gvs, Re^Gvs, Re^Gvs, Rb^Gvs, Re^Gvs, Rb^Gvs, Rb^Gvs, Re, Re, Gll^Fmf, Gg, Gll^Fmf, Gg, Gs, Gs^Efm, Gs, Gd, Gd, Gs, Gll^Fdf, Gll^Fmf
Ch^Qhux, Ch^Qhux, Re, Re, Re^Eff, Re^Eff, Re^Eff, Re^Eff, Rb^Gvs, Re^Eff, Re^Eff, Rr, Rr, Re^Eff, Re^Eff, Rb^Gvs, Rb^Gvs, Rb^Gvs, Rb^Gvs, Rb^Gvs, Re^Gvs, Rb^Gvs, Re^Gvs, Re^Gvs, Gll^Fdf, Gll^Fdf, Re, Rb^Gvs, Chr, Gll^Fmf, Gll^Fmf, Gll^Fdf, Gll^Fmf, Gll^Fmf, Gll^Fdf, Gll^Fdf, Gll^Fdf, Gd, Gd, Gd^Es, Gd, Gs
Re, Re, Re^Eff, Re^Eff, Rb^Gvs, Rb^Gvs, Ce, Rb^Gvs, Rb^Gvs, Rb^Gvs, Re, Re, Re^Eff, Rr^Edt, Rr^Edt, Re^Eff, Re, Rb^Gvs, Gll^Fdf, Re^Gvs, Re^Gvs, Re^Gvs, Gll^Fdf, Rb^Gvs, Re^Gvs, Rb^Gvs, Re, Re^Vh, Chr^Kov, Chr^Dr, Hh^Fdf, Gll^Fdf, Gll^Fdf, Gll^Fmf, Gll^Fmf, Gll^Fmf, Gll^Fdf, Gs, Gs, Gs, Gs, Gs
Re^Eff, Re^Eff, Rb^Gvs, Rb^Gvs, Rb^Gvs, Ce^Edt, 4 Ke, Ce, Re, Re^Es, Re, Re^Vh, Rb^Gvs, Re^Eff, Re^Eff, Rr^Edt, Rr, Re^Eff, Re^Eff, Gll^Fdf, Gll^Fdf, Gll^Fdf, Rb^Gvs, Re^Gvs, Re^Gvs, Rb^Gvs, Hh, Hh^Fmf, Hh^Fmf, Hh^Fdf, Hh^Fmf, Hh, Gd, Gll^Fdf, Gll^Fmf, Gll^Fmf, Re^Eff, Re^Eff, Re^Eff, Re^Eff, Re^Eff, Re^Eff
Re^Eff, Rb^Gvs, Rb^Gvs, Rb^Gvs, Rb^Gvs, Ce^Edt, Re, Re^Edt, Re^Edt, Re^Edt, Ce^Edt, Ce, Rb^Gvs, Rb^Gvs, Rb^Gvs, Re, Re^Eff, Rr, Rr, Re^Eff, Re^Eff, Gll^Fdf, Re^Gvs, Re^Gvs, Re^Gvs, Re^Gvs, Hh, Hh, Hh, Hh^Fmf, Hh^Es, Gd, Gd, Gs, Re^Vh, Re^Eff, Re^Gvs, Re^Gvs, Re^Gvs, Re^Gvs, Re^Gvs, Re^Gvs
Rb^Gvs, Re^Eff, Re^Eff, Re^Vh, Re, Re, Rb^Gvs, Re, Ce^Edt, Ce^Edt, Rb^Gvs, Rb^Gvs, Rb^Gvs, Rb^Gvs, Rb^Gvs, Rb^Gvs, Rb^Gvs, Re^Eff, Re^Eff, Rr, Rr, Re, Re^Eff, Re^Gvs, Gs^Eff, Gs^Eff, Gs, Hh, Hh, Hh, Hh, Gs, Re^Eff, Re^Eff, Re^Gvs, Re^Eff, Re^Eff, Re^Gvs, Re^Gvs, Re^Es, Re^Gvs, Re^Gvs
Ce, Rb^Gvs, Re, Re, Re^Eff, Rb^Gvs, Rb^Es, Rb^Gvs, Rb^Gvs, Rb^Gvs, Rb^Gvs, Rb^Gvs, Rb^Gvs, Rb^Gvs, Rb^Gvs, Rb^Gvs, Rb^Gvs, Rb^Gvs, Rb^Gvs, Re^Eff, Re^Eff, Rr, Rr, Re^Eff, Gs, Gs^Edt, Ds, Ww, Wo, Ww, Ww, Gs, Re, Re^Gvs, Rb^Gvs, Re^Gvs, Rb^Gvs, Re^Eff, Re^Eff, Re^Eff, Re^Eff, Re^Eff
Ce, Ce, Re, Gll^Fdf, Gll^Fdf, Re^Eff, Re^Eff, Rb^Gvs, Rb^Gvs, Rb^Gvs, Rb^Gvs, Re^Gvs, Re^Gvs, Rb^Gvs, Re^Gvs, Rb^Gvs, Rb^Gvs, Rb^Gvs, Gll^Fdf, Gll^Fdf, Rb^Gvs, Rr, Rr^Edt, Rr, Rr, Gs, Ds, Ww^Ewf, Wo, Wo, Ww, Gg, Rb^Gvs, Rb^Gvs, Rb^Gvs, Rb^Gvs, Rb^Gvs, Rb^Gvs, Rb^Gvs, Rb^Gvs, Rb^Gvs, Rb^Gvs
Re, Re, Rb^Gvs, Rb^Gvs, Rb^Gvs, Gll^Fdf, Gll^Fdf, Re^Eff, Re^Eff, Rb^Gvs, Re^Gvs, Re^Gvs, Re^Gvs, Re^Es, Re^Gvs, Rb^Gvs, Gll^Fdf, Rb^Gvs, Rb^Gvs, Rb^Gvs, Rb^Gvs, Rb^Gvs, Re^Vh, Rr^Edt, Rr, Rr, Rr, Ds^Edt, Ds, Ww, Gs, Gs, Gs, Rb^Gvs, Gll^Fmf, Rb^Gvs, Rb^Gvs, Rb^Gvs, Rb^Gvs, Rb^Gvs, Rb^Gvs, Rb^Gvs
Rb^Gvs, Re^Es, Re, Rb^Gvs, Re^Vh, Rb^Gvs, Re^Eff, Re^Eff, Rb^Gvs, Re^Eff, Re^Eff, Re^Gvs, Re^Gvs, Re^Gvs, Gll^Fmf, Gll^Fmf, Gll^Fdf, Rb^Gvs, Rb^Gvs, Rb^Gvs, Re^Gvs, Re^Gvs, Re^Gvs, Rb^Gvs, Rb^Gvs, Rr, Rr, Rr, Rr, Gd, Gd, Gs^Efm, Gs^Efm, Gs, Gll^Fdf, Gll^Fmf, Gll^Fdf, Rb^Gvs, Rb^Gvs, Rb^Es, Rb^Gvs, Rb^Gvs
Rb^Gvs, Rb^Gvs, Rb^Gvs, Re, Re, Re^Eff, Rb^Gvs, Rb^Gvs, Rb^Gvs, Rb^Gvs, Rb^Gvs, Re, Re^Eff, Re^Vh, Rb^Gvs, Rb^Gvs, Rb^Gvs, Rb^Gvs, Rb^Gvs, Rb^Gvs, Rb^Gvs, Re^Gvs, Re^Gvs, Re^Gvs, Re, Re, Gs, Rr, Rr, Rr^Edt, Rr, Gs^Efm, Gg, Gg, Gg^Efm, Gll^Fdf, Gll^Fdf, Gll^Fdf, Gll^Fdf, Gll^Fdf, Rb^Gvs, Rb^Gvs
Rb^Gvs, Rb^Gvs, Re^Eff, Re^Eff, Rb^Gvs, Rb^Gvs, Re^Gvs, Re^Gvs, Re^Gvs, Rb^Gvs, Rb^Gvs, Rb^Gvs, Rb^Gvs, Re^Eff, Re^Eff, Rb^Gvs, Rb^Gvs, Rb^Gvs, Rb^Gvs, Rb^Es, Re^Gvs, Re^Gvs, Re^Gvs, Re^Gvs, Re^Gvs, Gll^Fdf, Gll^Fdf, Gll^Fmf, Gll^Fmf, Rr, Rr, Rr, Rr, Gs^Efm, Gd^Efm, Gd, Gs, Gll^Fdf, Gll^Fdf, Gll^Fdf, Gll^Fdf, Rb^Gvs
Gll^Fdf, Gll^Fmf, Gll^Fmf, Rb^Gvs, Rb^Gvs, Rb^Es, Re^Gvs, Re^Gvs, Re^Edt, Re^Gvs, Rb^Gvs, Rb^Gvs, Re^Eff, Re^Eff, Rb^Gvs, Re^Eff, Re^Eff, Rb^Gvs, Rb^Gvs, Rb^Gvs, Re^Gvs, Re^Gvs, Re^Gvs, Re^Gvs, Re^Gvs, Gs, Gs, Gll^Fmf, Gll^Fdf, Gll^Fdf, Gg, Rr, Rr^Edt, Gs, Gs, Gs, Gll^Fdf, Gll^Fdf, Gll^Fdf, Gll^Fmf, Gll^Fmf, Gll^Fdf
Gll^Fdf, Gll^Fdf, Gll^Fmf, Gll^Fmf, Re, Re^Gvs, Re, Re^Gvs, Re^Edt, Re^Edt, Gs, Re^Eff, Rb^Gvs, Rb^Gvs, Rb^Gvs, Rb^Gvs, Rb^Gvs, Re, Re^Eff, Re^Gvs, Re^Gvs, Re^Gvs, Re^Gvs, Re^Gvs, Gs^Eff, Gs, Gs, Gll^Fdf, Gll^Fdf, Gll^Fdf, Gll^Fmf, Rr, Rr, Gs, Gd, Gs, Gd, Gll^Fdf, Gll^Fdf, Gll^Fmf, Gll^Fdf, Gll^Fmf
Gll^Fdf, Gll^Fmf, Gll^Fdf, Gll^Fmf, Gll^Fdf, Re, Gs, Re, Gg, Gs, Gs, Re^Vh, Re, Rb^Gvs, Rb^Gvs, Rb^Gvs, Rb^Gvs, Rb^Gvs, Rb^Gvs, Re^Eff, Gs^Eff, Gs^Eff, Gs^Eff, Gs^Eff, Gg^Efm, Gg, Gd, Gd^Es, Gs, Gll^Fdf, Gs, Rr, Rr^Edt, Gg, Gs, Gd, Gd, Gd, Gd, Gll^Fdf, Gll^Fmf, Gll^Fdf
Gll^Fdf, Gll^Fmf, Gll^Fmf, Gll^Fmf, Gll^Fdf, Gll^Fmf, Gs, Gg, Gs^Efm, Gs^Efm, Gs, Rb^Gvs, Re^Gvs, Re^Gvs, Rb^Gvs, Rb^Gvs, Rb^Gvs, Rb^Gvs, Rb^Gvs, Gs, Gs, Gs, Gg, Gs^Efm, Gs^Efm, Gs^Efm, Gd^Efm, Gd^Efm, Gs, Gll^Fdf, Gs, Rr^Edt, Rr, Rr, Rr, Gs, Gs, Gg^Es, Gs, Gll^Fmf, Gll^Fmf, Gs
Gll^Fmf, Gll^Fdf, Gll^Fdf, Gll^Fdf, Gll^Fdf, Gll^Fmf, Gs^Es, Gg^Efm, Gs^Efm, Gs^Efm, Rb^Gvs, Re^Gvs, Rb^Gvs, Re^Gvs, Rb^Gvs, Rb^Es, Rb^Gvs, Rb^Gvs, Gll^Fmf, Gll^Fmf, Gll^Fdf, Gll^Fdf, Hh^Fdf, Gg, Hh, Gs, Gd, Gd^Efm, Gd^Efm, Gs, Gs, Gs^Edt, Gg^Edt, Rr, Rr, Rr, Rr^Edt, Gs, Gs, Gs, Gg, Gg
Gll^Fmf, Gll^Fdf, Gll^Fdf, Gll^Fdf, Rb^Gvs, Gs^Efm, Rb^Gvs, Gs, Rb^Gvs, Gs, Rb^Gvs, Rb^Gvs, Re, Rb^Gvs, Rb^Gvs, Rb^Gvs, Gll^Fmf, Gll^Fmf, Gs, Gll^Fmf, Hh^Fdf, Hh^Fdf, Hh^Fms, Hh^Fdf, Hh^Fms, Hh, Hh, Gd, Gs, Gs, Rb^Gvs, Gs, Gs, Gg, Rr, Rr, Rr^Edt, Rr^Edt, Rr, Gg, Gs, Gg
