Rr^Edt, Rr, Ch, Rb, Rb, Rb^Es, Rr, Rb, Aa^Vhca, Isa^Edt, Ch^Qhux, Aa, Aa^Eff, Aa^Eff, Aa^Fda, Ww, Wo, Ww, Ww, Ww, Aa, Aa, Aa, Aa^Fdw, Gll^Fdw, Rb, Rb, Aa^Fdw, Aa^Fda, Aa, Aa, Aa, Aa, Aa, Aa, Aa, Aa^Eff, Aa, Aa, Aa, Aa^Eff, Aa
Rr^Edt, Rr^Edt, Rb, Rb, Rb, Rb^Edt, Isa^Edt, Rb, Aa, Aa^Edt, Cha^Qhux, Aa, Aa^Fma, Aa^Fda, Aa, Ww, Wo, Wo, Aa^Fma, Aa, Aa^Fda, Aa, Aa^Fda, Aa^Fda, Gll^Fdw, Gll^Fdw, Rb, Aa, Aa^Fda, Aa^Fda, Aa, Aa, Aa, Aa, Aa, Aa, Re^Eff, Aa^Eff, Aa^Eff, Aa^Eff, Aa, Aa
Rr, Rb^Vhc, Rb, Isa, Isa, Isa^Edt, Isa^Vhc, Isa, Cha^Qhux, Cha^Qhux, Aa^Fda, Aa^Fma, Aa^Fma, Gll^Fdw, Aa, Ww, Gll^Fdw, Ww, Aa^Fda, Aa^Fda, Aa^Fda, Aa^Fda, Aa^Fda, Aa^Fda, Aa^Fda, Gll^Fdw, Gs^Vl, Rb, Cea, Aa, Aa, Aa, Aa, Re, Re^Eff, Re^Eff, Aa, Aa, Aa, Aa^Eff, Aa^Vha, Aa
Ch, Rb, Rb, Isa^Vhc, Isa, Isa, Isa, Isa, Cha^Qhux, Aa^Fda, Aa^Fma, Aa^Fma, Aa^Eff, Gd^Eff, Gd^Eff, Gd^Eff, Gd^Eff, Aa^Fda, Aa^Fma, Aa^Fma, Aa^Fma, Aa^Fma, Aa^Fma, Aa^Fma, Aa^Fmw, Gll^Fmw, Gll^Fmw, 3 Ke, Ce, Aa, Re, Re, Rb, Re^Vh, Re, Rb, Aa, Aa^Esa, Aa, Aa, Aa, Aa
Rr^Edt, Ch^Edt, Rb, Rb, Ch, Rb, Rb^Edt, Rb^Es, Ch^Qhux, Aa^Fda, Gd^Eff, Aa^Eff, Rb, Rb, Aa, Aa, Rb, Gd^Eff, Gll^Fdw, Gll^Fdw, Aa^Fda, Aa^Fda, Aa^Fda, Aa^Fda, Gll^Fdw, Gll^Fdw, Gll^Fdw, Ce^Edt, Rb, Gs, Re^Eff, Rb, Re, Rb, Re, Aa, Aa, Aa, Aa^Es, Aa, Aa, Aa
Re^Edt, Rr^Edt, Rr, Rb, Rr^Vhc, Rb, Rb^Ebn, Aa^Edt, Cha^Qhux, Gll^Fdw, Rb, Rb, Aa, Aa, Aa, Aa, Gd^Wm, Gll^Fdw, Aa, Gll^Fdw, Gll^Fdw, Aa^Fda, Gll^Fdw, Aa^Fda, Gll^Fdw, Gll^Fdw, Re, Gll^Fdw, Gll^Fdw, Gll^Fdw, Gll^Fdw, Re^Eff, Re^Eff, Re, Re, Aa, Aa^Eff, Aa, Hh, Aa, Hh, Hh
Aa, Aa, Ch, Rr, Rr, Rb, Aa^Es, Aa^Edt, Xos, Gs, Rb, Rb, Aa, Aa, Aa^Fdw, Aa^Fdw, Aa, Aa, Aa, Rb, Gll^Fdw, Gll^Fdw, Gll^Fdw, Gll^Fdw, Re, Re, Re, Rb, Re, Aa, Aa, Gll^Fdw, Aa, Re^Eff, Re^Vwm, Gs^Eff, Gs, Hh^Fdw, Hh^Fdw, Hh^Fdw, Hh^Fdw, Hh^Fdw
Aa, Aa, Rb^Ebn, Re, Rb, Rr, Rr^Pr/o, Aa^Pr/o, Gs, Gs, Re, Aa^Vha, Cea, Cea, Aa, Aa^Esa, Aa, Aa, Aa, Rb, Rb, Re^Vh, Rb, Rb, Re, Re, Re, Re, Rb, Rb, Aa, Aa, Aa, Aa, Aa, Aa, Hh, Hh^Es, Hh, Gll^Fdw, Gll^Fmw, Hh^Fdw
Rr^Edt, Rb^Es, Rb, Re, Xos, Rr^Pr/o, Gd, Rr, Rr^Edt, Gs^Edt, Ce^Edt, 2 Ket, Ce^Edt, Aa, Aa, Aa, Rb, Aa, Ce, Ce, Rb, Rb, Rb, Rb^Es, Re, Re, Re, Rb, Rb, Rb, Re^Vh, Aa, Aa, Aa, Aa, Aa, Aa, Hh, Gs, Gll^Fmw, Gll^Fmw, Gll^Fmw
Rb^Edt, Re^Edt, Ch^Qhux, Ch^Qhux, Gd, Gd, Gd, Gs, Re^Eff, Rr^Edt, Rr, Ce, Re, Rb, Rb, Rb, Ce, Ce^Edt, Rb, Rb, Rb, Rb, Re, Re, Rb, Re, Rb, Rb, Re, Re, Gll^Fmw, Aa, Gll^Fmw, Gd, Gs, Aa, Gs, Gd, Gd, Gs, Gll^Fdw, Gll^Fmw
Ch^Qhux, Ch^Qhux, Re, Re, Re^Eff, Re^Eff, Re^Eff, Re^Eff, Rb, Re^Eff, Re^Eff, Rr, Rr, Re^Eff, Re^Eff, Rb, Rb, Rb, Rb, Rb, Aa, Rb, Aa, Re, Gll^Fdw, Gll^Fdw, Re, Rb, Chr, Gll^Fmw, Gll^Fmw, Gll^Fdw, Gll^Fmw, Gll^Fmw, Gll^Fdw, Gll^Fdw, Gll^Fdw, Gd, Gd, Gd^Es, Gd, Gs
Re, Re, Re^Eff, Re^Eff, Rb, Rb, Ce, Rb, Rb, Rb, Re, Re, Re^Eff, Rr^Edt, Rr^Edt, Re^Eff, Re, Aa, Aa^Fda, Aa, Aa, Aa, Aa^Fda, Rb, Re, Rb, Re, Re^Vh, Chr^Kov, Chr^Dr, Hh^Fdw, Gll^Fdw, Gll^Fdw, Gll^Fmw, Gll^Fmw, Gll^Fmw, Gll^Fdw, Gs, Gs, Gs, Gs, Gs
Re^Eff, Re^Eff, Rb, Rb, Rb, Ce^Edt, 4 Ke, Ce, Re, Re^Es, Re, Re^Vh, Rb, Re^Eff, Re^Eff, Rr^Edt, Rr, Aa^Eff, Aa^Eff, Aa^Fda, Aa^Fda, Aa^Fda, Rb, Re, Re, Rb, Hh, Hh^Fmw, Hh^Fmw, Hh^Fdw, Hh^Fmw, Hh, Gd, Gll^Fdw, Gll^Fmw, Gll^Fmw, Re^Eff, Re^Eff, Re^Eff, Re^Eff, Re^Eff, Re^Eff
Re^Eff, Rb, Rb, Rb, Rb, Ce^Edt, Re, Aa^Edt, Aa^Edt, Aa^Edt, Cea^Edt, Ce, Rb, Rb, Rb, Re, Re^Eff, Rr, Rr, Aa^Eff, Aa^Eff, Gll^Fdw, Re, Re, Re, Re, Hh, Hh, Hh, Hh^Fmw, Hh^Es, Gd, Gd, Gs, Re^Vh, Re^Eff, Re, Re, Re, Re, Re, Re
Rb^Gvs, Re^Eff, Re^Eff, Re^Vh, Re, Re, Aa, Aa, Cea^Edt, Cea^Edt, Aa, Aa, Rb, Rb, Rb, Rb, Rb, Re^Eff, Re^Eff, Rr, Rr, Aa, Aa^Eff, Aa, Aa^Eff, Gd^Eff, Gd, Hh, Hh, Hh, Hh, Gs, Re^Eff, Re^Eff, Re, Re^Eff, Re^Eff, Re, Re, Re^Es, Re, Re
Ce, Rb^Gvs, Re, Re, Re^Eff, Rb, Rb^Es, Aa, Aa, Aa^Esa, Aa, Aa, Aa, Aa, Rb, Rb, Rb, Rb, Rb, Aa^Eff, Aa^Eff, Rr, Rr, Aa^Eff, Gd, Gd^Edt, Ds, Ww, Wo, Ww, Ai, Gs, Re, Re, Rb, Re, Rb, Re^Eff, Re^Eff, Re^Eff, Re^Eff, Re^Eff
Ce, Ce, Re, Gll^Fdw, Aa^Fda, Aa^Eff, Aa^Eff, Aa, Aa, Aa, Aa, Aa, Aa, Aa, Re, Rb, Rb, Rb, Aa^Fda, Aa^Fda, Aa, Rr, Rr^Edt, Rr, Rr, Gd, Ds, Ww^Ewf, Wo, Ai, Ai, Aa, Aa, Aa, Aa, Aa, Rb, Rb, Rb, Rb, Rb, Rb
Re, Re, Rb, Rb, Rb, Aa^Fda, Aa^Fda, Aa^Eff, Re^Eff, Rb, Aa, Aa, Aa, Aa^Es, Re, Rb, Gll^Fdw, Rb, Rb, Rb, Aa, Aa, Aa^Vha, Rr^Edt, Rr, Rr, Rr, Ds^Edt, Ds, Ai, Aa, Aa, Aa^Esa, Aa, Gll^Fmw, Rb, Rb, Rb, Rb, Rb, Rb, Rb
Aa, Aa^Es, Aa, Aa, Aa^Vha, Aa, Aa^Eff, Re^Eff, Rb, Re^Eff, Re^Eff, Re, Re, Re, Gll^Fmw, Gll^Fmw, Gll^Fdw, Rb, Rb, Rb, Re, Aa, Aa, Aa, Rb, Rr, Rr, Rr, Rr, Aa, Aa, Aa^Esa, Aa, Gd, Gll^Fdw, Gll^Fmw, Gll^Fdw, Rb, Aa, Aa^Es, Aa, Aa
Aa, Aa, Aa, Aa, Re, Aa^Eff, Rb, Rb, Rb, Rb, Rb, Re, Re^Eff, Re^Vh, Rb, Rb, Aa, Aa, Aa, Rb, Rb, Re, Aa, Aa, Re, Re, Gs, Rr, Rr, Rr^Edt, Rr, Aa, Gd, Gd, Aa, Gll^Fdw, Aa^Fda, Aa^Fda, Aa^Fda, Aa^Fda, Rb, Aa
Rb, Rb, Re^Eff, Re^Eff, Rb, Rb, Re, Re, Re, Rb, Aa, Rb, Aa, Re^Eff, Aa^Eff, Rb, Aa, Aa, Aa, Aa^Es, Re, Re, Re, Re, Re, Gll^Fdw, Gll^Fdw, Gll^Fmw, Gll^Fmw, Rr, Rr, Rr, Rr, Aa, Aa, Aa, Aa, Aa^Fda, Aa^Fda, Aa^Fda, Aa^Fda, Rb
Gll^Fdw, Gll^Fmw, Gll^Fmw, Rb, Rb, Rb^Es, Re, Re, Aa^Edt, Re, Aa, Aa, Aa^Eff, Aa^Eff, Aa, Aa^Eff, Aa^Eff, Aa, Aa, Rb, Re, Re, Re, Re, Re, Gd, Gd, Gll^Fmw, Gll^Fdw, Gll^Fdw, Gd, Rr, Rr^Edt, Aa, Aa, Aa, Aa^Fda, Aa^Fda, Aa^Fda, Aa^Fma, Aa^Fma, Aa^Fda
Gll^Fdw, Gll^Fdw, Gll^Fmw, Gll^Fmw, Re, Re, Re, Aa, Re^Edt, Aa^Edt, Aa, Aa^Eff, Aa, Aa, Aa, Aa^Esa, Aa, Aa, Aa^Eff, Re, Re, Re, Re, Re, Gs^Eff, Gs, Gs, Gll^Fdw, Gll^Fdw, Gll^Fdw, Gll^Fmw, Rr, Rr, Aa, Aa, Gs, Gd, Aa^Fda, Gll^Fdw, Aa^Fma, Aa^Fda, Aa^Fma
Gll^Fdw, Gll^Fmw, Gll^Fmw, Gll^Fmw, Gll^Fdw, Re, Gs, Aa, Aa, Aa, Aa, Aa^Vha, Aa, Aa, Aa, Aa, Aa, Aa, Rb, Re^Eff, Gs^Eff, Gs^Eff, Gs^Eff, Gs^Eff, Gd, Gs, Gd, Gd^Es, Gs, Gll^Fdw, Gd, Rr, Rr^Edt, Gd, Gs, Gd, Gd, Gd, Gd, Gll^Fdw, Gll^Fmw, Gll^Fdw
Gll^Fdw, Gll^Fmw, Gll^Fmw, Gll^Fmw, Gll^Fdw, Gll^Fmw, Gs, Gg, Aa, Aa, Aa, Aa, Aa, Aa, Rb, Rb, Rb, Rb, Rb, Gd, Gd, Gd, Gs, Gs, Gd, Gd, Gd, Gd, Gs, Gll^Fdw, Gd, Rr^Edt, Rr, Rr, Rr, Gs, Gd, Gd^Es, Gs, Gll^Fmw, Gll^Fmw, Gs
Gll^Fmf, Gll^Fdw, Gll^Fdw, Gll^Fdw, Gll^Fdw, Gll^Fmw, Aa^Es, Aa, Aa, Aa, Aa, Aa, Aa, Aa, Rb, Rb^Es, Rb, Rb, Gll^Fmw, Gll^Fmw, Gll^Fdw, Gll^Fdw, Hh^Fdw, Gs, Hh, Gs, Gd, Gd, Gd, Gs, Gd, Gs^Edt, Gd^Edt, Rr, Rr, Rr, Rr^Edt, Gd, Gs, Gs, Gd, Gg
Gll^Fmf, Gll^Fdw, Gll^Fdw, Gll^Fdw, Aa, Aa, Aa, Aa, Aa, Aa^Esa, Rb, Aa, Re, Rb, Rb, Rb, Gll^Fmw, Gll^Fmw, Gs, Gll^Fmw, Hh^Fdw, Hh^Fdw, Hh^Fms, Hh^Fdw, Hh^Fms, Hh, Hh, Gd, Gs, Gs, Rb^Gvs, Gs, Gd, Gd, Rr, Rr, Rr^Edt, Rr^Edt, Rr, Gd, Gd, Gd
