Rr^Edt, Rr, Ch, Rb, Rb, Rb^Es, Rr, Rb, Isa^Vhc, Isa^Edt, Ch^Qhux, Rb^Gvs, Gd^Eff, Gd^Eff, Gs^Fds, Ww, Wo, Ww, Ww, Ww, Gd, Gd, Gd, Gs^Fds, Gs^Fds, Rb, Rb, Gs^Fds, Gs^Fds, Rb, Gd, Gd, Rb^Gvs, Re^Gvs, Re^Gvs, Re^Eff, Re^Eff, Rb^Gvs, Re^Gvs, Re^Gvs, Re^Eff, Ww
Rr^Edt, Rr^Edt, Rb, Rb, Rb, Rb^Edt, Isa^Edt, Rb, Isa, Isa^Edt, Ch^Qhux, Gs, Gll^Fp, Gs^Fds, Gs^Efm, Ww, Wo, Wo, Gs^Fms, Gd, Gs^Fds, Gd, Gs^Fds, Gs^Fds, Gs^Fds, Gs^Fds, Rb, Gd, Gs^Fds, Gs^Fds, Re^Gvs, Rb^Gvs, Re^Gvs, Re^Gvs, Rb^Gvs, Re^Gvs, Re^Eff, Re^Eff, Re^Eff, Re^Eff, Rb^Gvs, Re^Gvs
Rr, Rb^Vhc, Rb, Isa, Isa, Isa^Edt, Isa^Vhc, Isa, Ch^Qhux, Ch^Qhux, Gs^Fds, Gll^Fp, Gll^Fp, Gs^Fds, Gs^Efm, Ww, Gs^Fds, Ww, Gs^Fds, Gs^Fds, Gs^Fds, Gs^Fds, Gs^Fds, Gs^Fds, Gs^Fds, Gs^Fds, Gs^Vl, Rb, Ce, Re^Gvs, Re^Gvs, Re^Gvs, Rb^Gvs, Re^Gvs, Re^Eff, Re^Eff, Rb^Gvs, Rb^Gvs, Rb^Gvs, Re^Eff, Re^Vh, Re^Gvs
Ch, Rb, Rb, Isa^Vhc, Isa, Isa, Isa, Isa, Ch^Qhux, Gs^Fds, Gs^Fms, Gs^Fms, Gd^Eff, Gd^Eff, Gd^Eff, Gd^Eff, Gd^Eff, Gs^Fds, Gs^Fms, Gs^Fms, Gs^Fms, Gs^Fms, Gs^Fms, Gs^Fms, Gs^Fms, Gs^Fms, Gs^Fms, 3 Ke, Ce, Re^Gvs, Re^Gvs, Re^Gvs, Rb^Gvs, Re^Vh, Re^Gvs, Rb^Gvs, Re^Gvs, Re^Gvs, Re^Gvs, Rb^Gvs, Rb^Gvs, Re^Gvs
Rr^Edt, Ch^Edt, Rb, Rb, Ch, Rb, Rb^Edt, Rb^Es, Ch^Qhux, Gs^Fds, Gd^Eff, Gd^Eff, Rb^Gvs, Rb^Gvs, Rb^Gvs, Rb^Gvs, Rb^Gvs, Gd^Eff, Gs^Fds, Gs^Fds, Gs^Fds, Gs^Fds, Gs^Fds, Gs^Fds, Gs^Fds, Gs^Fds, Gs^Fds, Ce^Edt, Rb, Gs, Re^Eff, Rb^Gvs, Re^Gvs, Rb^Gvs, Re^Gvs, Re^Gvs, Re^Gvs, Re^Gvs, Gg^Es, Rb^Gvs, Re, Re
Re^Edt, Rr^Edt, Rr, Rb, Rr^Vhc, Rb, Rb^Ebn, Rb^Edt, Ch^Qhux, Gs^Fds, Rb^Gvs, Rb^Gvs, Rb^Gvs, Rb^Gvs, Rb^Gvs, Rb^Gvs, Gd^Wm, Gs^Fds, Rb^Gvs, Gs^Fds, Gs^Fds, Gs^Fds, Gs^Fds, Gs^Fds, Gs^Fds, Gs^Fds, Re^Gvs, Gs^Fds, Gs^Fds, Gs^Fds, Gs^Fds, Re^Eff, Re^Eff, Re^Gvs, Re^Gvs, Re^Gvs, Gs^Eff, Gg, Hh, Gg, Hh, Hh
Rb, Re, Ch, Rr, Rr, Rb, Rb^Es, Rb^Edt, Xos, Gs, Rb^Gvs, Rb^Gvs, Rb^Gvs, Rb^Gvs, Gs^Fds, Gs^Fds, Rb^Gvs, Rb^Gvs, Rb^Gvs, Rb^Gvs, Gs^Fds, Gs^Fds, Gs^Fds, Gs^Fds, Re^Gvs, Re^Gvs, Re^Gvs, Rb^Gvs, Re^Gvs, Rb^Gvs, Gg, Gs^Fds, Gs, Re^Eff, Re^Vwm, Gs^Eff, Gs, Hh^Fds, Hh^Fds, Hh^Fds, Hh^Fds, Hh^Fds
Rb, Rb, Rb^Ebn, Re, Rb, Rr, Rr^Pr/o, Rr^Pr/o, Gs, Gs, Re, Re^Vhr, Ce, Ce, Rb^Gvs, Rb^Gvs, Rb^Gvs, Rb^Gvs, Rb^Gvs, Rb^Gvs, Rb^Gvs, Re^Vh, Rb^Gvs, Rb^Gvs, Re^Gvs, Re^Gvs, Re^Gvs, Re^Gvs, Rb^Gvs, Rb^Gvs, Gg, Gg^Efm, Gs^Efm, Gs, Gs^Efm, Gs, Hh, Hh^Es, Hh, Gs^Fds, Gs^Fms, Hh^Fds
Rr^Edt, Rb^Es, Rb, Re, Xos, Rr^Pr/o, Gd, Rr, Rr^Edt, Gs^Edt, Ce^Edt, 2 Ket, Ce^Edt, Rb^Gvs, Rb^Gvs, Rb^Gvs, Rb^Gvs, Rb^Gvs, Ce, Ce, Rb^Gvs, Rb^Gvs, Rb^Gvs, Rb^Es, Re^Gvs, Re^Gvs, Re^Gvs, Rb^Gvs, Rb^Gvs, Rb^Gvs, Re^Vh, Gs, Gs, Gs^Efm, Gg^Efm, Gs^Efm, Gs, Hh, Gg, Gs^Fms, Gs^Fms, Gs^Fms
Rb^Edt, Re^Edt, Ch^Qhux, Ch^Qhux, Gd, Gd, Gd, Gs, Re^Eff, Rr^Edt, Rr, Ce, Re, Rb^Gvs, Rb^Gvs, Rb^Gvs, Ce, Ce^Edt, Rb^Gvs, Rb^Gvs, Rb^Gvs, Rb^Gvs, Re^Gvs, Re^Gvs, Rb^Gvs, Re^Gvs, Rb^Gvs, Rb^Gvs, Re, Re, Gs^Fms, Gg, Gs^Fms, Gg, Gs, Gs^Efm, Gs, Gs, Gs, Gs, Gs^Fds, Gs^Fms
Ch^Qhux, Ch^Qhux, Re, Re, Re^Eff, Re^Eff, Re^Eff, Re^Eff, Rb^Gvs, Re^Eff, Re^Eff, Rr, Rr, Re^Eff, Re^Eff, Rb^Gvs, Rb^Gvs, Rb^Gvs, Rb^Gvs, Rb^Gvs, Re^Gvs, Rb^Gvs, Re^Gvs, Re^Gvs, Gs^Fds, Gs^Fds, Re, Rb^Gvs, Chr, Gs^Fms, Gs^Fms, Gs^Fds, Gs^Fms, Gs^Fms, Gs^Fds, Gs^Fds, Gs^Fds, Gs, Gs, Gs^Es, Gs, Gs
Re, Re, Re^Eff, Re^Eff, Rb^Gvs, Rb^Gvs, Ce, Rb^Gvs, Rb^Gvs, Rb^Gvs, Re, Re, Re^Eff, Rr^Edt, Rr^Edt, Re^Eff, Re, Rb^Gvs, Gs^Fds, Re^Gvs, Re^Gvs, Re^Gvs, Gs^Fds, Rb^Gvs, Re^Gvs, Rb^Gvs, Re, Re^Vh, Chr^Kov, Chr^Dr, Hh^Fms, Gs^Fds, Gs^Fds, Gs^Fms, Gs^Fms, Gs^Fms, Gs^Fds, Gs, Gs, Gs, Gs, Gs
Re^Eff, Re^Eff, Rb^Gvs, Rb^Gvs, Rb^Gvs, Ce^Edt, 4 Ke, Ce, Re, Re^Es, Re, Re^Vh, Rb^Gvs, Re^Eff, Re^Eff, Rr^Edt, Rr, Re^Eff, Re^Eff, Gs^Fds, Gs^Fds, Gs^Fds, Rb^Gvs, Re^Gvs, Re^Gvs, Rb^Gvs, Hh, Hh^Fds, Hh^Fds, Hh^Fms, Hh^Fds, Hh, Gg, Gs^Fds, Gs^Fms, Gs^Fms, Re^Eff, Re^Eff, Re^Eff, Re^Eff, Re^Eff, Re^Eff
Re^Eff, Rb^Gvs, Rb^Gvs, Rb^Gvs, Rb^Gvs, Ce^Edt, Re, Re^Edt, Re^Edt, Re^Edt, Ce^Edt, Ce, Rb^Gvs, Rb^Gvs, Rb^Gvs, Re, Re^Eff, Rr, Rr, Re^Eff, Re^Eff, Gs^Fds, Re^Gvs, Re^Gvs, Re^Gvs, Re^Gvs, Hh, Hh, Hh, Hh^Fds, Hh^Es, Gg, Gg, Gs, Re^Vh, Re^Eff, Re^Gvs, Re^Gvs, Re^Gvs, Re^Gvs, Re^Gvs, Re^Gvs
Rb^Gvs, Re^Eff, Re^Eff, Re^Vh, Re, Re, Rb^Gvs, Re, Ce^Edt, Ce^Edt, Rb^Gvs, Rb^Gvs, Rb^Gvs, Rb^Gvs, Rb^Gvs, Rb^Gvs, Rb^Gvs, Re^Eff, Re^Eff, Rr, Rr, Re, Re^Eff, Re^Gvs, Gs^Eff, Gs^Eff, Gs, Hh, Hh, Hh, Hh, Gg, Re^Eff, Re^Eff, Re^Gvs, Re^Eff, Re^Eff, Re^Gvs, Re^Gvs, Re^Es, Re^Gvs, Re^Gvs
Ce, Rb^Gvs, Re, Re, Re^Eff, Rb^Gvs, Rb^Es, Rb^Gvs, Rb^Gvs, Rb^Gvs, Rb^Gvs, Rb^Gvs, Rb^Gvs, Rb^Gvs, Rb^Gvs, Rb^Gvs, Rb^Gvs, Rb^Gvs, Rb^Gvs, Re^Eff, Re^Eff, Rr, Rr, Re^Eff, Gs, Gs^Edt, Ds, Ww, Wo, Ww, Ww, Gs, Re, Re^Gvs, Rb^Gvs, Re^Gvs, Rb^Gvs, Re^Eff, Re^Eff, Re^Eff, Re^Eff, Re^Eff
Ce, Ce, Re, Gs^Fds, Gs^Fds, Re^Eff, Re^Eff, Rb^Gvs, Rb^Gvs, Rb^Gvs, Rb^Gvs, Re^Gvs, Re^Gvs, Rb^Gvs, Re^Gvs, Rb^Gvs, Rb^Gvs, Rb^Gvs, Gs^Fds, Gs^Fds, Rb^Gvs, Rr, Rr^Edt, Rr, Rr, Gs, Ds, Ww^Ewf, Wo, Wo, Ww, Gg, Rb^Gvs, Rb^Gvs, Rb^Gvs, Rb^Gvs, Rb^Gvs, Rb^Gvs, Rb^Gvs, Rb^Gvs, Rb^Gvs, Rb^Gvs
Re, Re, Rb^Gvs, Rb^Gvs, Rb^Gvs, Gs^Fds, Gs^Fds, Re^Eff, Re^Eff, Rb^Gvs, Re^Gvs, Re^Gvs, Re^Gvs, Re^Es, Re^Gvs, Rb^Gvs, Gs^Fds, Rb^Gvs, Rb^Gvs, Rb^Gvs, Rb^Gvs, Rb^Gvs, Re^Vh, Rr^Edt, Rr, Rr, Rr, Ds^Edt, Ds, Ww, Gs, Gs, Gs, Rb^Gvs, Gs^Fms, Rb^Gvs, Rb^Gvs, Rb^Gvs, Rb^Gvs, Rb^Gvs, Rb^Gvs, Rb^Gvs
Rb^Gvs, Re^Es, Re, Rb^Gvs, Re^Vh, Rb^Gvs, Re^Eff, Re^Eff, Rb^Gvs, Re^Eff, Re^Eff, Re^Gvs, Re^Gvs, Re^Gvs, Gs^Fms, Gs^Fms, Gs^Fds, Rb^Gvs, Rb^Gvs, Rb^Gvs, Re^Gvs, Re^Gvs, Re^Gvs, Rb^Gvs, Rb^Gvs, Rr, Rr, Rr, Rr, Gs, Gg, Gs^Efm, Gs^Efm, Gs, Gs^Fds, Gs^Fms, Gs^Fds, Rb^Gvs, Rb^Gvs, Rb^Es, Rb^Gvs, Rb^Gvs
Rb^Gvs, Rb^Gvs, Rb^Gvs, Re, Re, Re^Eff, Rb^Gvs, Rb^Gvs, Rb^Gvs, Rb^Gvs, Rb^Gvs, Re, Re^Eff, Re^Vh, Rb^Gvs, Rb^Gvs, Rb^Gvs, Rb^Gvs, Rb^Gvs, Rb^Gvs, Rb^Gvs, Re^Gvs, Re^Gvs, Re^Gvs, Re, Re, Gs, Rr, Rr, Rr^Edt, Rr^Edt, Gg^Efm, Gg, Gg, Gg^Efm, Gs^Fds, Gs^Fds, Gs^Fds, Gs^Fds, Gs^Fds, Rb^Gvs, Rb^Gvs
Rb^Gvs, Rb^Gvs, Re^Eff, Re^Eff, Rb^Gvs, Rb^Gvs, Re^Gvs, Re^Gvs, Re^Gvs, Rb^Gvs, Rb^Gvs, Rb^Gvs, Rb^Gvs, Re^Eff, Re^Eff, Rb^Gvs, Rb^Gvs, Rb^Gvs, Rb^Gvs, Rb^Es, Re^Gvs, Re^Gvs, Re^Gvs, Re^Gvs, Re^Gvs, Gg^Fds, Gs^Fds, Gs^Fms, Gs^Fms, Rr, Rr, Rr, Rr, Gs^Efm, Gs^Efm, Gs, Gg, Gs^Fds, Gg^Fds, Gs^Fds, Gs^Fds, Rb^Gvs
Gs^Fds, Gs^Fms, Gs^Fms, Rb^Gvs, Rb^Gvs, Rb^Es, Re^Gvs, Re^Gvs, Re^Edt, Re^Gvs, Rb^Gvs, Rb^Gvs, Re^Eff, Re^Eff, Rb^Gvs, Re^Eff, Re^Eff, Rb^Gvs, Rb^Gvs, Rb^Gvs, Re^Gvs, Re^Gvs, Re^Gvs, Re^Gvs, Re^Gvs, Gg, Gg, Gg^Fms, Gg^Fds, Gg^Fds, Gg, Rr, Rr^Edt, Gs, Gg, Gs, Gg^Fds, Gg^Fds, Gg^Fds, Gg^Fms, Gs^Fms, Gs^Fds
Gs^Fds, Gs^Fds, Gs^Fms, Gs^Fms, Re, Re^Gvs, Re, Re^Gvs, Re^Edt, Re^Edt, Gs, Re^Eff, Rb^Gvs, Rb^Gvs, Rb^Gvs, Rb^Gvs, Rb^Gvs, Re, Re^Eff, Re^Gvs, Re^Gvs, Re^Gvs, Re^Gvs, Re^Gvs, Gs^Eff, Gg, Gg, Gg^Fds, Gg^Fds, Gg^Fds, Gs^Fms, Rr, Rr, Gg, Gs, Gs, Gg, Gg^Fds, Gg^Fds, Gs^Fms, Gs^Fds, Gs^Fms
Gs^Fds, Gs^Fms, Gs^Fds, Gs^Fms, Gs^Fds, Re, Gs, Re, Gg, Gs, Gs, Re^Vh, Re, Rb^Gvs, Rb^Gvs, Rb^Gvs, Rb^Gvs, Rb^Gvs, Rb^Gvs, Re^Eff, Gs^Eff, Gs^Eff, Gs^Eff, Gs^Eff, Gg^Efm, Gg, Gg, Gg^Es, Gg, Gg^Fds, Gs, Rr, Rr^Edt, Gg, Gs, Gs, Gs, Gg, Gg, Gs^Fds, Gs^Fms, Gs^Fds
Gs^Fds, Gs^Fms, Gs^Fms, Gs^Fms, Gs^Fds, Gs^Fms, Gs, Gg, Gs^Efm, Gs^Efm, Gs, Rb^Gvs, Re^Gvs, Re^Gvs, Rb^Gvs, Rb^Gvs, Rb^Gvs, Rb^Gvs, Rb^Gvs, Gs, Gs, Gs, Gg, Gs^Efm, Gs^Efm, Gs^Efm, Gs^Efm, Gg^Efm, Gg, Gs^Fds, Gs, Rr^Edt, Rr, Rr, Rr, Gg, Gs, Gg^Es, Gs, Gs^Fms, Gg^Fms, Gs
Gs^Fms, Gs^Fds, Gs^Fds, Gs^Fds, Gs^Fds, Gs^Fms, Gs^Es, Gg^Efm, Gs^Efm, Gs^Efm, Rb^Gvs, Re^Gvs, Rb^Gvs, Re^Gvs, Rb^Gvs, Rb^Es, Rb^Gvs, Rb^Gvs, Gs^Fms, Gs^Fms, Gs^Fds, Gs^Fds, Hh^Fds, Gg, Hh, Gs, Gg, Gg^Efm, Gs^Efm, Gs, Gg, Gs^Edt, Gg^Edt, Rr, Rr, Rr, Rr^Edt, Gs, Gs, Gs, Gg, Gg
Gs^Fms, Gs^Fds, Gs^Fds, Gs^Fds, Rb^Gvs, Gs^Efm, Rb^Gvs, Gs, Rb^Gvs, Gs, Rb^Gvs, Rb^Gvs, Re, Rb^Gvs, Rb^Gvs, Rb^Gvs, Gs^Fms, Gs^Fms, Gs, Gs^Fms, Hh^Fds, Hh^Fds, Hh^Fms, Hh^Fds, Hh^Fms, Hh, Hh, Gg, Gs, Gs, Rb^Gvs, Gg, Gg, Gg, Rr, Rr, Rr^Edt, Rr^Edt, Rr, Gg, Gs, Gg
