Gg, Gg, Gg, Gg, Gg, Gg, Gg, Gs, Gg^Es, Aa^Esa, Aa, Aa, Gg^Fdw, Gg^Fdw, Gd^Fms, Gg^Fdw, Gg^Fms, Gs^Fms, Gg, Gd, Gs, Gg, Gg, Gs^Es, Gg, Rr, Rr, Gs, Gg, Gg, Gg, Gg, Gg, Gg, Re, Re, Re^Gvs, Re^Gvs, Re^Eff, Gg, Gs, Gd^Vhr, Re^Gvs, Gd^Gvs, Re^Gvs, Re^Gvs, Re^Gvs, Re^Gvs, Re^Eff, Gg^Eff, Gll^Fms, Gd, Gg, Gs, Gs, Gll^Fdw, Gll^Fms, Gg, Gg, Gs, Gs, Gg, Gg
Gg, Gg, Gs, Gs, Gs, Gs, Gs, Gs, Gs, Gd, Aa, Gd, Gd^Fdw, Gd^Fms, Gg^Fms, Gg^Fdw, Gs^Fms, Gg, Gg, Gd, Gd, Gg, Gs, Gg^Es, Gg, Gg, Gg, Rr, Gg^Efm, Gg^Efm, Gg^Efm, Gg, Re, Re, Gg, Gg^Eff, Re^Eff, Re^Eff, Gs, Gd, Gs, Gd, Re^Gvs, Re^Gvs, Re^Gvs, Re^Gvs, Re^Eff, Re^Eff, Gs, Gs, Gll^Fms, Gs, Gll^Fms, Gll^Fms, Gll^Fms, Gll^Fms, Gll^Fms, Gs, Gg, Gs, Gs, Gs, Aa
Aa, Aa, Gg^Efm, Gs, Gs, Gg, Gs, Gs, Gs, Gd, Gd, Gd, Gg^Fdw, Gg^Fdw, Gd^Fms, Gg^Fms, Gs^Fms, Gg^Es, Gs, Gs, Gs, Gd, Gs, Gg, Gg, Gg, Gg, Rr, Rr, Gg^Efm, Gg^Efm, Re, Gg, Gg, Gg, Gg, Gg, Gs, Gs, Gs, Gs, Re, Re, Gg, Re^Eff, Re^Eff, Gs, Gg, Gll^Fms, Gll^Fms, Gll^Fms, Gll^Fms, Gll^Fms, Gll^Fms, Gs, Gll^Fms, Gll^Fms, Gs, Gs, Gs, Gd, Aa, Aa
Re^Gvs, Aa, Aa, Aa, Re^Gvs, Gg, Gg, Gs, Gs, Gs, Gg, Gd, Gd, Hh^Fdw, Hhd^Qhhf, Gd^Fms, Hh^Qhh, Gs, Gg^Es, Gs, Gg, Gs, Gg, Gg, Gg, Gg^Efm, Gg^Efm, Gg^Efm, Gg^Efm, Rr, Re, Re, Gg, Gg, Gg, Gd, Gg, Gs, Gs, Gs, Gs, Gs, Gs, Gs, Gs, Gs, Gs, Gs, Gll^Fms, Gll^Fms, Gll^Fms, Gll^Fms, Gll^Fms, Gll^Fms, Gg, Gll^Fms, Gll^Fms, Gg, Gs, Gs, Gd^_mh, Gs, Gd
Re^Gvs, Re^Gvs, Re^Gvs, Re^Gvs, Re^Gvs, Gg, Gg, Gg, Gg, Gg, Hhd, Hhd, Hhd^Qhh, Hhd^Qhh, Hhd^Qhh, Hhd^Qhhf, Hh^Qhh, Hh^Qhh, Hh^Vhhr, Hh^Es, Gs, Gs, Gg, Gg, Gg, Gg^Efm, Gg^Efm, Gg^Efm, Gg^Efm, Rr, Gg^Efm, Gg^Efm, Gd, Gg, Gg, Gg, Gs, Gg, Gs, Gs, Gs, Gs^Efm, Gs, Gs, Gs, Gs^Efm, Gs, Gs, Gll^Fms, Gll^Fms, Gll^Fms, Gs^Vl, Gll^Fms, Gg, Gg, Gg, Gg, Gg, Gs, Gs, Gd, Gd, Gd
Rr, Re^Gvs, Re^Gvs, Re^Gvs, Re, Gs, Gs, Gg, Gg, Hhd, Re, Dd, Dd^Es, Dd, Dd, Hhd^Qhh, Mm^Qhh, Mm^Qhh, Mm^Qhh, Hh^Qhh, Hh^Qhh, Gs, Gg, Gs, Gs, Gg^Efm, Gg^Efm, Gg, Gll^Fms, Rr, Gg, Gg^Efm, Gd, Gd, Gd, Gd, Gd, Gd, Gd, Gs, Gs^Efm, Gs^Efm, Gs^Efm, Gs, Gs^Efm, Gs^Efm, Gg, Gg, Gd, Gll^Fms, Gg, Gll^Fms, Gg, Gs, Gd, Gs, Gg, Gs, Gd, Gs, Gs, Gs, Rr^Qhh
Re^Gvs, Rr, Rr, Re^Gvs, Gs, Gs, Gg, Gg, Gg, Gg, Gg^Efm, Gd, Gd, Dd, Dd, Hhd^Qhh, Hhd^Qhh, Mm^Qhh, Hhd^Qhh, Hh^Qhh, Hh, Hh, Gs, Gs, Gs, Gs, Gg, Gg, Gg^Efm, Rr, Gg, Gg^Efm, Gll^Fms, Gll^Fms, Gll^Fms, Gd, Gd, Gd, Gd, Gs^Efm, Gg^Efm, Gg, Gg^Efm, Gg, Gg^Efm, Gg, Gd, Gd, Gd, Gd, Gg, Gg, Gg, Gd, Gd, Gs, Gg, Gd^Vhr, Rr, 2 Gs, Rr^Qhh, Rr^Qhh, Gg^Qhh
Re^Gvs, Re^Gvs, Re^Vhr, Rr, Rr, Gd^Vhr, Gs, Gs, Re^Gvs, Gg^Efm, Gg, Gg^Efm, Gd, Dd, Dd, Hhd, Hhd^Es, Hhd^Qhh, Hhd^Qhh, Hhd^Qhh, Gs, Hh, Gg, Gs, Gg, Gg, Gg^Efm, Gg^Efm, Gg^Efm, Rr, Gg, Gg, Gg, Gll^Fms, Gll^Fms, Gll^Fms, Gll^Fms, Gd, Gd, Gg, Gs, Gg, Gg^Efm, Gg^Efm, Gg, Gg, Aa, Gg, Gg, Gd, Aa, Aa, Aa, Gd, Gg, Gg, Rr, Rr, Gs, Rr^Qhh, Gd^Qhh, Gg^Qhh, Gd^Qhh
Re^Gvs, Re^Gvs, Re^Gvs, Re^Gvs, Gs, Rr, Re^Gvs, Re^Gvs, Re^Gvs, Re^Gvs, Re, Gg, Gs, Gd^Efm, Gd, Gs, Gs, Gs, Gs, Hhd, Gs, Gs, Gg, Gg, Gd, Gg, Gd, Gg, Gg^Efm, Rr, Gg, Gg, Gg, Gg, Gg, Gll^Fms, Gd, Gd, Gd, Gs, Gs, Gs, Gs, Gs, Gs, Aa, Aa, Aa, Aa, Gs, Gs, Aa, Gs, Gs, Gs, Gd, Rr, Gs, Gg^Qhh, Gd^Qhh, Gd^Qhh, Gd^Qhh, Re
Re^Gvs, Re^Gvs, Re^Gvs, Gs, Gs, Rr, Re^Gvs, Re^Gvs, Re^Gvs, Re^Gvs, Re, Gg, Gd, Gd, Gd, Gd, Gs, Gs, Gd, Gs, Gd, Gs, Gd, Gd, Gg, Gd, Gg^Es, Gg^Edt, Ce, Rr, Ce, Gg, Gg, Gg, Gs, Gd, Gd, Gd, Gs, Gs, Gd, Gs, Gd, Gs, Gs, Gs, Gs, Gs, Gs, Gs, Gd, Gs, Gs, Gd^Vhr, Rr, Rr, Gs^Qhh, Gg^Qhh, Gg, Gg^Qhh, Re, Re, Re^Gvs
Re, Re^Gvs, Re^Eff, Re^Eff, Gs, Rr, Rr, Re^Gvs, Re^Gvs, Re^Gvs, Re, Gs, Gd^Edb, Gd^Edt, Re, Gs, Gs, Gs, Gd, Gd, Cer^Qhh, Gd, Gd, Gd, Gg, Gg, Gg, Gg^Edt, Re, Rr, Rrc^Vhc, Gs, Gg, Gg, Gs^Efm, Gd, Gd, Gg, Gs, Gd, Gd, Gd, Gs^Edb, Gg^Eff, Gg^Eff, Gs, Gg^Eff, Gs, Gs, 9 Gs, Rr, Gd, Rr, Rr, Re^Qhh, Gs^Qhh, Re, Gs, Re, Re, Re^Gvs, Re^Gvs, Re^Gvs
Gg^Eff, Re^Eff, Gs, Gg, Gs, Gs, Gg, Rr, Rr, Rr, Rr, Gd^Vhr, Rr, Gs^Edt, Gs^Edt, Gd, Gs, Gll, Gd, Gd^Fds, Gd^Fds, Gd^Fds, Gd^Fds, Gll, Gll, Gg, Gs, Gg, Rr, Rr, Gs, Gs, Gd^Efm, Gg^Efm, Re^Gvs, Gd^Efm, Gd^Efm, Gs, Gd, Gd, Gs, Gd, Re^Gvs, Re^Gvs, Re^Gvs, Gg^Eff, Gd^Vhr, Gs^Eff, Rr, Rr, Gs, Rr, Gd, Gd, Re^Qhh, Re, Re^Gvs, Re^Gvs, Re^Gvs, Re^Gvs, Rb^Gvs, Rb^Gvs, Rb
Gg, Gs, Gs, Gs, Gs, Gg, Gg^Eff, Gg^Eff, Re^Gvs, Re^Gvs, Re^Gvs, Rr, Gs, Rr, Rr, Gs, Gs, Gd, Gll, Gd^Fds, Gd^Fds, Gd^Fds, Gd^Fds, Gd^Fds, Re^Gvs, Re^Gvs, Re, Gg, Rr, Gg, Re, Re, Re^Gvs, Re^Gvs, Re^Gvs, Gd^Efm, Gd, Gd, Gd, Gs, Re, Re, Re^Gvs, Re^Gvs, Re^Gvs, Re^Gvs, Rr, Rr, Re, Gg^Eff, Gg^Eff, Gd, Gs^Qhh, Gd^Qhh, Re, Re^Gvs, Re^Gvs, Re^Gvs, Re^Gvs, Rb^Gvs, Re^Gvs, Rb^Gvs, Rb^Gvs
Re, Re, Re, Gs, Gg, Gg, Gd, Re^Eff, Re^Eff, Re^Gvs, Re^Gvs, Re^Gvs, Gs^Ecf, Gg^Edt, Gs^Edt, Rr, Rr, Gs, Gs, Gd^Fds, Gd^Fds, Gll, Re^Gvs, Re^Gvs, Re^Gvs, Re^Gvs, Re^Gvs, Gg, Rr, Re, Re^Gvs, Re^Gvs, Re^Gvs, Re^Gvs, Re^Gvs, Gd^Efm, Gs, Gs, Re^Gvs, Re^Gvs, Re^Gvs, Re^Gvs, Re^Gvs, Re^Gvs, Re^Gvs, Re^Gvs, Rr, Gd^Vhr, Re^Gvs, Re, Re, Gd, Gs^Qhh, Gs, Re^Gvs, Re^Gvs, Re^Gvs, Re^Gvs, Re^Vhr, Rb^Gvs, Re^Gvs, Re^Gvs, Re^Gvs
Re^Gvs, Re^Gvs, Re^Gvs, Re, Gg, Gg, Gg, Gd, Gg, Re, Re^Gvs, Re^Gvs, Gs^Es, Gs, Gg, Gg, Rr, Gs, Gs, Gs^Es, Re, Re^Gvs, Re^Gvs, Re^Gvs, Re^Gvs, Re^Gvs, Re^Gvs, Gg, Rr, Re, Re^Gvs, Re^Gvs, Re^Gvs, Re^Gvs, Re^Gvs, Re, Re, Re^Gvs, Re, Re^Gvs, Re^Gvs, Re^Gvs, Re, Re^Gvs, Gg, Gg, Rr, Re^Gvs, Re^Gvs, Re^Gvs, Re^Gvs, Gs^Qhh, Re^Gvs, Re^Gvs, Re^Gvs, Re^Gvs, Re^Gvs, Re^Gvs, Re^Gvs, Re, Re^Gvs, Re^Gvs, Gs^Gvs
Re^Gvs, Re^Gvs, Re^Gvs, Gg, Gs, Gg, Gg, Gg^Es, Gg^Es, Gd, Gd, Gs, Gs, Gg, Gg, Gg, Gg^Es, Rr, Rr, Gg, Gg, Re, Re^Gvs, Re^Gvs, Re^Gvs, Re^Gvs, Re^Gvs, Gg, Rr, Re, Re^Gvs, Re^Gvs, Re^Gvs, Re^Gvs, Re^Gvs, Re^Gvs, Gs, Re, Gs, Re, Gs, Gg, Gg, Gg, Rr, Rr, Re^Gvs, Re^Gvs, Re^Gvs, Re^Gvs, Re^Gvs, Gs^Qhh, Gd, Re^Gvs, Gd, Re^Gvs, Gs, Gg, Gg^Eff, Re^Vhr, Gd^Eff, Re^Eff, Re^Gvs
Re^Gvs, Re^Gvs, Re^Gvs, Gg, Gs, Gs, Re, Re, Re, Gs, Gs, Gd, Gd, Gs, Gs, Gg, Gg, Gg, Gg, Rr, Rr, Gd^Fds, Re, Re^Gvs, Re^Gvs, Re^Gvs, Ce, Gg, Rr, Re, Re^Gvs, Re^Gvs, Re^Gvs, Re^Gvs, Re^Gvs, Re, Gg, Gs, Gg, Gs, Rr, Ce, Rr, Rr, Re, Re^Gvs, Re^Gvs, Re^Gvs, Re^Gvs, Re^Gvs, Gd^Qhh, Gd^Qhh, Gd, Gd, Gs, Ds, Rb^Gvs, Rb^Gvs, Rb^Gvs, Gs^Eff, Rb^Gvs, Re^Gvs, Re^Gvs
Re^Gvs, Re^Gvs, Re^Gvs, Re^Gvs, Re, Gs, Gd, Re, Gd, Re, Gs, Gg, Gg, Gd, Gg, Gs, Gd, Gs, Gg, Gg, Gg, Rr, Rr, Re, Ce, Ce, Rrc^Vhc, Rr^Vhc, Rr, Rrc, Rrc^Vhc, Ce, Ce, Re^Gvs, Re^Gvs, Re^Gvs, Gg, Gg, Rr, Rr, Rr^Vhc, Rr, Ce, Rr, Rr, Re, Re, Re^Gvs, Gg^Es, Gd, Gd^Qhh, Gd, Rb^Gvs, Rb^Gvs, Rb^Gvs, Rb^Gvs, Rb^Gvs, Rb^Gvs, Re^Gvs, Re^Gvs, Re^Gvs, Re^Gvs, Re^Gvs
Re^Gvs, Re^Gvs, Re^Gvs, Re^Gvs, Re, Gs, Gd, Gd, Gd, Gd, Gll, Gd^Fds, Gd^Fds, Gd^Fds, Gd^Vhr, Gs, Gd, Gd, Gd^Fds, Gg, Re, Re, Ce, Rr, Rr^Vhc, Re^Ebn, Rrc, Rrc, Ww^Bsb|, Rrc, Rrc, Ke, Rr^Vhc, Ce, Gg, Gg, Rp, Rr, Gg, Gs, Re^Gvs, Gg^Edt, Gg^Edt, Gd, Rr, Gd, Re^Qhh, Re^Qhh, Gs^Qhh, Gd^Qhh, Gs, Gs, Rb^Gvs, Rb^Gvs, Rb^Gvs, Rb^Gvs, Rb^Gvs, Re^Gvs, Re^Gvs, Re^Gvs, Re^Gvs, Re^Gvs, Re^Gvs
Rr, Re^Gvs, Re^Gvs, Re^Gvs, Re^Gvs, Re, Gd, Gd, Gd, Gll, Gd^Fds, Gd^Fds, Gd^Fds, Gd^Fds, Gd^Fds, Gll, Re, Re, Re, Gd^Fds, Re, Ce, Ke, Rr, Rr, Rrc, Ww, Ww, Isa, Ww, Ww, Rr, Rr, Rr^Ebn, Rr, Rr, Gg, Gg, Re^Gvs, Re^Gvs, Re^Gvs, Gd, Gs^Edt, Gg, Rr, Gd^Qhh, Gs, Gd, Gs, Gs, Gs, Gs, Gs, Rb^Gvs, Rb^Gvs, Rb^Gvs, Rb^Gvs, Rb^Gvs, Gs, Re^Gvs, Re^Gvs, Re^Gvs, Re^Gvs
Gs, Rr, Rr, Re^Gvs, Re^Vhr, Re, Gd, Gd, Gd, Gd, Gd^Fds, Gd^Fds, Gd^Fds, Gd^Fds, Gd^Fds, Re, Re^Gvs, Re^Gvs, Re^Gvs, Gg, Gg, Ce, Re, Rr, Ww^Bsb\, Ww, Isa^Vhc, Isa^Vhc, Isa, Isa^Vhc, Isa^Vhc, Ww, Ww^Bsb/, Rr, Rr^Vhc, Gg, Re^Gvs, Re^Gvs, Re^Gvs, Re^Gvs, Re^Eff, Gg^Eff, Gg, Gg, Rr, Gs, Gs, Gs, Gs, Gs, Gs, Gs, Gs, Rb^Gvs, Gs, Gs, Rr, 3 Rr, Rr, Rr, Rr, Gs, Rr
Gs^Qhh, Gs, Gg, Rr, Rr, Gs, Gd, Gs, Gs, Gs, Gs, Gd^Fds, Re, Gd^Fds, Re^Gvs, Re^Gvs, Re^Gvs, Re^Gvs, Re^Gvs, Gg^Eff, Gs^Eff, Re, Rr^Vhc, Rrc, Ww, Isa, Gg^Ebn, Ch, Ch, Ch, Gg^Ebn, Isa, Ww, Rr, Rr^Vhc, Ce, Re^Gvs, Re^Gvs, Re^Gvs, Re^Gvs, Re^Eff, Gs^Eff, Gs, Gg, Gg, Rr, Rr, Gs, Rr, Gs, Rr, Gs, Rr, Rr, Rr, Rr, Gs, Gs, Gs, Gs, Ww, Rr, Ww
Gg^Qhh, Gg^Qhh, Gg, Gg, Gg, Rr, Rr, Rr, Rr, Cer, Rr, Gg, Re, Re^Gvs, Re^Gvs, Re^Gvs, Re^Gvs, Re^Gvs, Re^Eff, Re^Eff, Re, Ce, Rr^Vhc, Rrc, Ww, Isa^Vhc, Isr, Isr^Vhc, 1 Kh, Isr^Vhc, Isr, Isa^Vhc, Ww, Rrc, Rr, Ce, Re^Gvs, Re^Gvs, Gs^Fms, Re^Eff, Gg, Gs, Gg^Es, Gg, Gg, Gs, Gs, Rr, Dd, Rr, Ds, Rr, Gs, Gs, Gs, Gs, Ww, Gs, Ww, Ww, Ww, Ww, Wo
Hhd^Qhh, Gd^Qhh, Gd, Gg, Gg, Gg, Gs, Gs, Gs, Rr, Gg, Rr, Rr, Rr, Rr, Re^Gvs, Re^Gvs, Re, Gg, Gg, Re, Ce, Rr, Rr, Ww, Isa^Vhc, Gg^Ebn, Isr^Vhc, Ch, Isr^Vhc, Gg^Ebn, Isa^Vhc, Ww, Rr, Rr^Vhc, Ce, Re^Gvs, Re^Gvs, Re, Gs, Gs^Fms, Gs, Gs, Ds, Ds, Gs, Ds, Dd, Ds, Ds, Ww, Ww, Ww, Ww, Ww, Ww, Ww, Ww, Ww, Ww, Ww, Ww, Wo
Hhd^Qhh, Hhd^Qhh, Gd^Qhh, Gd, Gs, Gs^Es, Gg, Gd, Gg, Gg, Re^Gvs, Re^Gvs, Gs, Gg, Gs, Rr, Rr, Rr, Rr, Gd^Fds, Gg, Ce, Rr^Ebn, Rr, Ww^Bsb/, Isa, Isa^Vhc, Ch, Isa, Ch, Isa^Vhc, Isa, Ww^Bsb\, Rr, Re^Ebn, Re, Gs, Re, Gg, Gs^Fms, Gg, Gs, Ds, Ds, Ds, Ds, Ds, Ds, Ww, Ww, Ww, Ww, Ww, Ww, Ww, Ww, Ww, Ww, Wo, Ww, Ww, Ww, Ww
Hhd^Qhh, Hhd, Gd^Qhh, Gg, Hh, Hh, Hh, Gd, Gs, Re^Gvs, Re^Gvs, Re^Gvs, Re^Gvs, Gs, Gd, Gd, Gd^Fds, Gs, Gg, Rr, Gg, Gs, Rp, Rr, Rrc, Ww, Ww, Isa^Vhc, Isa, Isa^Vhc, Ww, Ww, Ww, Rrc, Rr, Rr, Rr, Gg, Gg, Gg, Gg, Ds, Gg, Ds, Ww, Ww, Ww, Ww, Ww, Ww, Ww, Ww, Ww, Ww, Ww, Ww, Ww, Wo, Wo, Wo, Ww, Ww, Gg
Hhd^Qhh, Hhd^Fdw, Hh^Fdw, Hh^Qhh, Hh^Qhh, Hh^Qhh, Hh^Qhh, Gs, Gd, Gs, Gs, Re^Gvs, Re, Re, Gg, Gg, Ce, Gs, Gs, Rr, Rr, Rp, Gg, Rrc^Vhc, Rrc, Rrc^Vhc, Rr, Ww, Ww^Bsb|, Ww, Rr^Vhc, Rr, Ww, Rr^Vhc, Ww, Ce, Gs^Edt, Rr, Rr, Gg, Ds, Ds, Ww, Ww, Ww, Ww, Wo, Wo, Ww, Ww, Ww, Ww, Ww, Ww, Ww, Ww, Ww, Ww, Ww, Ww, Ww, Gg, Gg
Hh^Qhh, Hh^Fdw, Gs, Gs, Hhd^Fdw, Hh^Vhr, Hh^Qhh, Gg^Qhh, Gg, Gs, Gs, Re, Gg^Es, Gg, Gs, Re, Ce, Re, Rr, Rr, Gs, Gg, Gg, Gg, Gg^Edt, Rrc, Rrc^Vhc, Rr, Rr, Rr, Rr^Vhc, Ch^Kov, Ch, Ww, Ww, Ww, Ww, Gg, Ww, Wwf^Bsb\, Ww^Bsb\, Ww, Ww, Ww, Ww, Ww, Ww, Ww, Ww, Ww, Gg, Ww, Gg, Gg, Gg, Gg, Gg, Gg, Gg, Gg, Gg, Gg, Gg
Hh, Hh^Qhh, Gg, Gs, Hhd, Hh, Gll, Gg^Qhh, Hh^Qhh, Gg, Gs, Gs, Gd, Gs, Re, Re, Rr, Rr, Rr^Vhc, Gs, Gg, Gd, Gs, Gg, Gg^Efm, Ce, Ce, Rr^Vhc, Rr, Rrc^Ebn, Rr, Ch, Ww, Ww, Ww, Ww, Ww, Ww, Wo, Ww, Ww, Ww^Bsb\, Wwf^Bsb\, Ww, Ce, Ww, Gg, Gg, Gg, Gg, Gg, Gg, Gg, Gg, Gg, Gg, Gd^Fms, Gg, Gg, Gg, Gg, Gg, Gg
Hh, Hh^Qhh, Hh^Qhh, Gs, Gg, Gll^_mh, Gd, Hh, Hhd, Hhd^Qhh, Hhd^Qhh, Gg^Qhh, Hhd^Qhh, Hhd, Rr, Rr, Re, Ce, Gg, Gg, Gd, Gd, Gd^Efm, Gg^Efm, Gg^Efm, Ds, Ww, Ww, Ww, Ch, Ww^Bh|, Wwg, Wo, Ww, Ww, Ww, Ww, Wo, Ww, Wwg, Ww, Rr^Vhc, Rr, Rr, Rb, Gg, Gg, Gg, Gg, Gd, Gd^Fms, Gd^Fms, Gd^Fms, Gd^Fms, Gd^Fms, Gd^Fms, Gg, Gg, Gg, Gg, Gg, Gg, Gg
Hh, Hh, Hh^Qhh, Gg, Gg, Gd, Gs, Gs, Gs, Gd, Gd, Hhd, Hhd^Qhh, Rr, Gg^Em, Re, Gs^Es, Gs, Gg, Gg, Gs, Gg, Ww, Ww, Ww, Ww, Wo, Ww, Ww, Ww, Ww^Bh|, Wwg, Ww, Ww, Ww, Ww, Ds, Ww, Ds, Gs, Gs, Gs, Gs, Rr, Gg, Rb, Gd, Gg, Gg, Gd, Gg, Gd^Fms, Gg, Gd^Fms, Gd^Fms, Gd^Fms, Gd^Fms, Gd^Fms, Gd^Fms, Gg, Gg, Gg, Gg
Hh^Qhh, Hh, Gg, Gs^Qhh, Hh^Qhh, Gd^Qhh, Gs^Qhh, Gd, Gd, Gs, Gd^Qhh, Hhd^Qhh, Rr, Rr, Gd, Gs^Em, Gd, Gd, Ds, Ww, Ww, Ww, Ww, Ww, Wo, Wo, Ww, Ww, Ww, Ww, Rr, Ww, Ds, Ds, Ds, Ds, Ds, Ds, Ds, Ds, Gs, Gs, Gg, Gs, Gs, Rr, Gd, Gg, Gg, Gg, Gg, Gg, Gg, Gg, Gd^Fms, Gd^Fms, Gd^Fms, Gg, Gg, Gg, Gg, Gg, Gg
Hh^Qhhf, Hh^Qhhf, Hhd^Qhhf, Gg^Qhh, Hh, Hhd, Gd^Qhh, Gd, Gd, Gd^Qhh, Gd, Rr, Gd, Gd, Ds, Gd, Ww, Ww, Ww, Ww, Ww, Ww, Ww, Ww, Ww, Ww, Wwg, Ww, Gg, Gg^Vhr, Rr, Ds, Gg, Gg, Gg, Ds, Gg, Ds, Gs, Gs, Gs, Gs, Gs, Gs, Gd^Vhr, Rr, Rb, Gg, Gg, Gg, Gg, Gg, Gg, Gd^Vhr, Gs^Es, Gll, Gg, Gg, Gg, Gg, Gs, Gs, Gg
Mm, Mm, Mm, Hh^Qhh, Hh, Hhd^Qhh, Gd, Gd, Gd^Qhh, Gd^Qhh, Rr, Rr, Ds, Ds, Ww, Ww, Ww, Ww, Ww, Ww, Ww, Ww, Ww, Ww, Gg, Gg, Gg, Gg, Gd, Re, Gs, Rb, Rb, Gg, Gg, Gg, Gg, Gg, Gd, Gs^Es, Gs, Gg, Gg, Gd, Gd, Gs, Gd^Qhu, Rb, Rr, Gs, Gs, Gg, Gg, Gg, Gs^Em, Gd, Gg, Gg, Gd, Gg, Gs, Gg^Fms, Gg^Fms
Hh^Fds, Hh^Qhhf, Hh^Qhhf, Hh^Fms, Gd, Hh^Qhh, Hhd^Qhh, Hh, Gs^Qhh, Gd, Rr, Gd, Gs, Wwf, Ww, Ww, Wo, Ww, Ww, Ww, Gs, Ds, Gg, Gg, Gg, Gg, Gg, Gg, Gs, Gs, Gs, Gg, Rb, Gg, Gg, Gg, Gg, Gg, Gg, Gd, Gs, Gs, Gg, Gs, Gd^Qhu, Gd^Qhu, Gd, Gd, Gd, Rb, Rr, Gd, Gd, Gd^Em, Gd, Gg, Gg, Gg, Gd^Fms, Gd, Gs, Gd, Gg
Mm^Qhh, Hhd^Fds, Hhd^Fds, Hhd^Qhhf, Gd^Qhh, Hhd^Fdw, Mm^Qhh, Gs^Qhh, Gs, Gs, Rr, Gd, Wwg, Wwg, Wo, Wo, Ww, Ww, Gd, Gd, Gs, Gs, Gg, Gg, Gg, Gg, Gs, Gs, Gs, Gs, Gs, Gg, Rr, Gg, Gg, Gs, Gs, Gs, Gs, Gg, Gs, Gg, Gd, Gs, Gs^Qhu, Gd, Gs, Gd, Gs, Gs, Gs^Es, Rr, Gs, Gs, Gs, Gg, Gs, Gg, Gg^Fms, Gs^Fms, Gs, Gs, Gd
Mm^Qhh, Mm, Mm, Mm, Hhd^Qhhf, Hhd^_mhh, Mm^Qhh, Gs, Gs, Rr, Ds, Ds, Wwg, Wwg, Wwg, Wwg, Ds, Gs, Gs, Gs, Gs, Gs, Gd^Fds, Gg^Em, Gd^Fds, Gg^Em, Gs, Gs, Gs, Gs, Gs, Gs, Rr, Gs, Gs, Gs, Gs, Gd, Gd, Gd, Gs, Gd, Gd^Qhu, Gs^Qhu, Gs, Gg, Gg, Gd, Gs^Fms, Gs^Fms, Gs^Fms, Rb, Rr, Gs, Gs, Gs, Gg^Efm, Gg^Fms, Gd^Fms, Gs, Gg, Gs^Fms, Gd^Fms
Mm^Qhh, Mm, Mm, Hhd^Fds, Hh^Qhhf, Hh^Qhh, Hh^Fdw, Hh^Qhhf, Rr, Rr, Wwg, Wwg, Wog, Wog, Wwg, Wwf, Gs, Gs, Gd^Fds, Gd^Fds, Gd^Fds, Gd^Fds, Gd^Fds, Gd^Fds, Gd^Fds, Gd^Fds, Gg, Gg^Em, Gg^Qhu, Gd, Gs, Gs, Rr, Gs, Gs, Gs, Gs, Gs, Gs, Gg^Em, Gs, Gs^Qhu, Gs, Gs, Gs, Gs, Gd, Gd, Gs^Fms, Gs^Fms, Gs^Fms, Gs^Fms, Gg^Qhu, Rr, Rr, Gg^Qhu, Gg^Qhu, Gg, Gg, Gs, Gs, Gg^Fms, Gd^Fms
Mm^Qhh, Mm, Mm, Mm, Hh^Qhh, Hhd^Vhh, Rr, Rr, Gs^Fds, Ds, Wwg, Wo, Wog, Wwg, Wwg, Gg, Gd^Fds, Gd^Fds, Gd^Fds, Gd^Fds, Gd^Fds, Gd^Fds, Gd^Fds, Gd^Fds, Gd^Fds, Gg, Gs, Gg^Qhu, Gg^Em, Gd^Qhu, Gs^Qhu, Gs, Rb, Gs, Gs, Gs, Gs, Gs, Gs, Gs, Gs^Qhu, Gs^Qhu, Gs, Gs, Gs, Gs, Gs, Gd, Gs^Fms, Gs^Fms, Gs^Fms, Gs^Fms, Gs^Fms, Gg^Qhu, Gg^Qhu, Rr, Rr, Gd^Vhr, Gs, Gg, Gg^Fms, Gg^Fms, Gg^Fms
Hh^Qhhf, Hhd^Fds, Hh, Mm, Hh^Qhhf, Hhd^Fds, Rr, Gs, Wwf, Wwf, Ww, Ww, Wwf, Wwg, Gg, Gs, Gd^Fds, Gd^Fds, Gd^Fds, Gd^Fds, Gs^Vl, Gd^Fds, Gg, Gg, Gd^Qhu, Gd, Gs^Qhu, Gd^Qhu, Gd, Gs, Gg^Vhr, Gs^Qhu, Rr, Gs, Gs, Gs, Gg, Gg, Gs^Qhu, Gs^Qhu, Gs, Gs, Gs, Gs, Gs, Gd, Gs, Gs^Fms, Gd, Gs^Qhu, Gg^Qhu, Gs, Gs, Gg^Qhu, Gd^Vhr, Gg^Efm, Gg, Rr, Rr, Gs, Gg, Gg^Fms, Gg^Fms
Mm, Mm, Gs^Qhhf, Hh^Qhh, Rr, Rr, Gd^Qhh, Gs^Qhhf, Ww, Ww, Ww, Wwf, Wwf, Ds, Gg, Gg, Gg, Gd^Vl, Gd, Gs, Gs^Qhu, Gg^Qhu, Gs^Qhu, Gs^Qhu, Gg, Gd^Qhu, Gs, Gs, Gs, Gs, Gs^Qhu, Gs^Qhu, Gs, Rb, Gs^Vhr, Gs, Gs^Qhu, Gs^Qhuf, Gs, Gs, Gs, Gs, Gg, Gs, Gs^Fms, Gg, Gs^Fms, Gs, Gs^Fds, Gg^Fds, Gg^Fms, Gg^Qhu, Gs^Qhu, Gg^Qhu, Gs^Qhu, Gs^Efm, Gs^Efm, Gg, Gg, Rb, Rr, Gg, Gg
Mm, Mm^Qhh, Rr, Rr, Gg^Fds, Gg^Qhhf, Wwf, Wwf, Ww, Ww, Ww, Wwf, Ds, Ds, Gs^Fms, Gs, Gs, Gg, Gg, Gd^Qhu, Gs, Gs, Gs, Gd, Gs, Gg, Gs, Gs, Gd^Fms, Gs^Fds, Gs^Qhuf, Gs, Rr, Rb, Gg, Gs, Gg^Qhuf, Gs^Fms, Gg^Fms, Gs, Gs, Gs, Gs, Gg^Fms, Gg^Fms, Gs^Fms, Gg^Fds, Gs^Fms, Gg^Fds, Gs^Fms, Gs^Fds, Gs^Fms, Gs^Fms, Gs^Qhu, Gs^Fms, Gs^Qhu, Gs^Qhu, Gg, Gg, Gs, Gg, Rr, Rr
Gg, Rr, Hh, Hh, Gg^Fds, Gg^Qhhf, Wwf, Ww, Wo, Ww, Wwf, Wwf, Gg, Gs^Fms, Gs^Fds, Gs^Fds, Gs^Fds, Gg, Gg^Qhu, Gg^Qhu, Gg^_ml, Gs, Gg, Gs^Fms, Gg^Fms, Gs^Fds, Gg^Fds, Gd^Fds, Gg, Gd^Fms, Gd^Fms, Gs, Rr, Gs, Gg^Qhu, Gg^Qhuf, Gg^Fms, Gg, Gg^Fms, Gg, Gg, Gg, Gg, Gg^Fms, Gg^Fms, Gg^Fds, Gg, Gg^Fds, Gg, Gg, Gg^Fds, Gs^Fds, Gg^Fds, Gs^Fds, Gg^_mll, Gg^Fms, Gg, Gs^Qhu, Gg^Qhu, Gs, Gg, Gg, Gg
