Gg, Gg, Gg, Gg, Gg, Gg, Gg, Gs, Gg^Es, Aa^Esa, Aa, Aa, Gg^Fdw, Gg^Fdw, Gd^Fms, Gg^Fdw, Gg^Fms, Gs^Fms, Gg, Gd, Gs, Gg, Gg, Gs^Es, Gg, Rr, Rr, Gs, Gg, Gg, Gg, Gg, Gg, Gg, Re, Re, Re^Gvs, Re^Gvs, Re^Eff, Gg, Gs, Gd^Vhr, Re^Gvs, Gd^Gvs, Re^Gvs, Re^Gvs, Re^Gvs, Re^Gvs, Re^Eff, Gg^Eff, Gll^Fms, Gd, Gg, Gs, Gs, Gll^Fdw, Gll^Fdw, Gg, Gg, Gs, Gs, Gg, Gg
Gg, Gg, Gs, Gs, Gs, Gs, Gs, Gs, Gs, Gd, Aa, Gd, Gd^Fdw, Gd^Fms, Gg^Fms, Gg^Fdw, Gs^Fms, Gg, Gg, Gd, Gd, Gg, Gs, Gg^Es, Gg, Gg, Gg, Rr, Gg^Efm, Gg^Efm, Gg^Efm, Gg, Re, Re, Gg, Gg^Eff, Re^Eff, Re^Eff, Gs, Gd, Gs, Gd, Re^Gvs, Re^Gvs, Re^Gvs, Re^Gvs, Re^Eff, Re^Eff, Gs, Gs, Gll^Fdw, Gs, Gll^Fdw, Gll^Fdw, Gll^Fms, Gll^Fms, Gs^Fms, Gs, Gg, Gs, Gs, Gs, Aa
Aa, Aa, Gg^Efm, Gs, Gs, Gg, Gs, Gs, Gs, Gd, Gd, Gd, Gg^Fdw, Gg^Fdw, Gd^Fms, Gg^Fms, Gs^Fms, Gg^Es, Gs, Gs, Gs, Gd, Gs, Gg, Gg, Gg, Gg, Rr, Rr, Gg^Efm, Gg^Efm, Re, Gg, Gg, Gg, Gg, Gg, Gs, Gs, Gs, Gs, Re, Re, Gg, Re^Eff, Re^Eff, Gs, Gg, Gll^Fdw, Gll^Fdw, Gll^Fms, Gll^Fdw, Gll^Fms, Gll^Fdw, Gs, Gll^Fms, Gs^Fdw, Gs, Gs, Gs, Gd, Aa, Aa
Re^Gvs, Aa, Aa, Aa, Re^Gvs, Gg, Gg, Gs, Gs, Gs, Gg, Gd, Gd, Hh^Fdw, Hhd^Qhhf, Gd^Fms, Hh^Qhh, Gs, Gg^Es, Gs, Gg, Gs, Gg, Gg, Gg, Gg^Efm, Gg^Efm, Gg^Efm, Gg^Efm, Rr, Re, Re, Gg, Gg, Gd, Gd, Gg, Gs, Gs, Gs, Gs, Gs, Gs, Gs, Gs, Gs, Gs, Gs, Gll^Fdw, Gll^Fms, Gll^Fdw, Gll^Fdw, Gll^Fdw, Gll^Fdw, Gg, Gll^Fdw, Gll^Fdw, Gg, Gs, Gs, Gd^_mh, Gs, Gd
Re^Gvs, Re^Gvs, Re^Gvs, Re^Gvs, Re^Gvs, Gg, Gg, Gg, Gg, Gg, Hhd, Hhd, Hhd^Qhh, Hhd^Qhh, Hhd^Qhh, Hhd^Qhhf, Hh^Qhh, Hh^Qhh, Hh^Vhhr, Hh^Es, Gs, Gs, Gg, Gg, Gg, Gg^Efm, Gg^Efm, Gg^Efm, Gg^Efm, Rr, Gg^Efm, Gg^Efm, Gd, Cer, Gd, Gd, Gs, Gg, Gs, Gs, Gs, Gs^Efm, Gs, Gs, Gs, Gs^Efm, Gs, Gs, Gll^Fdw, Gll^Fms, Gll^Fdw, Gs^Vl, Gll^Fdw, Gg, Gg, Gg, Gg, Gg, Cer, Gs, Gd, Gd, Gd
Rr, Re^Gvs, Re^Gvs, Re^Gvs, Re, Cer, Cer, Gg, Gg, Hhd, Re, Dd, Dd^Es, Dd, Dd, Hhd^Qhh, Mm^Qhh, Mm^Qhh, Mm^Qhh, Hh^Qhh, Hh^Qhh, Gs, Gg, Gs, Gs, Gg^Efm, Gg^Efm, Gg, Gg^Fdw, Rr, Cer, Gg^Efm, Gd, Gd, Gd, Gd, Gd, Cer, Cer, Gs, Gs^Efm, Gs^Efm, Gs^Efm, Gs, Gs^Efm, Gs^Efm, Gg, Gg, Gd, Gll^Fdw, Gg, Gll^Fdw, Gg, Gs, Gd, Cer, Gg, Gs, Gd, Cer, Cer, Gs, Rr^Qhh
Re^Gvs, Rr, Rr, Re^Gvs, Cer, 7 Ker, Gg, Gg, Gg, Gg, Gg^Efm, Gd, Gd, Dd, Dd, Hhd^Qhh, Hhd^Qhh, Mm^Qhh, Hhd^Qhh, Hh^Qhh, Hh, Hh, Gs, Gs, Gs, Gs, Gg, Gg, Gg^Efm, Rr, Gg, Gg^Efm, Gg^Fdw, Gs^Fdw, Cer, 8 Ker, Cer, Gd, Cer, Gs^Efm, Gg^Efm, Gg, Gg^Efm, Gg, Gg^Efm, Gg, Gd, Gd, Gd, Gd, Gg, Gg, Gg, Gd, Gd, Cer, Gg, Gd^Vhr, Rr, 2 Ker, Rr^Qhh, Rr^Qhh, Gg^Qhh
Re^Gvs, Re^Gvs, Re^Vhr, Rr, Rr, Gd^Vhr, Cer, Cer, Re^Gvs, Gg^Efm, Gg, Gg^Efm, Gd, Dd, Dd, Hhd, Hhd^Es, Hhd^Qhh, Hhd^Qhh, Hhd^Qhh, Gs, Hh, Gg, Gs, Gg, Gg, Gg^Efm, Gg^Efm, Gg^Efm, Rr, Gg, Gg, Gg, Gg^Fdw, Gg^Fdw, Cer, Gg^Fdw, Gd, Gd, Gg, Gs, Gg, Gg^Efm, Gg^Efm, Gg, Gg, Aa, Gg, Gg, Gd, Aa, Aa, Aa, Gd, Gg, Gg, Rr, Rr, Cer^Qhh, Rr^Qhh, Gd^Qhh, Gg^Qhh, Gd^Qhh
Re^Gvs, Re^Gvs, Re^Gvs, Re^Gvs, Cer, Rr, Re^Gvs, Re^Gvs, Re^Gvs, Re^Gvs, Re, Gg, Gs, Gd^Efm, Gd, Cer, Ker, Cer, Gs, Hhd, Gs, Gs, Gg, Gg, Gd, Gg, Gd, Gg, Gg^Efm, Rr, Gg, Gg, Gg, Gg, Gg, Gd^Fdw, Gd, Gd, Gd, Gs, Gs, Gs, Gs, Gs, Gs, Aa, Aa, Aa, Aa, Gs, Gs, Aa, Gs, Gs, Gs, Gd, Rr, Cer^Qhh, Gg^Qhh, Gd^Qhh, Gd^Qhh, Gd^Qhh, Re
Re^Gvs, Re^Gvs, Re^Gvs, Gs, Gs, Rr, Re^Gvs, Re^Gvs, Re^Gvs, Re^Gvs, Re, Gg, Gd, Gd, Gd, Gd, Gs, Cer, Gd, Gs, Gd, Gs, Gd, Gd, Gg, Gd, Gg^Es, Gg^Edt, Ce^Edt, Rr, Ce^Dr, Gg, Gg, Gg, Gs, Gd, Gd, Gd, Gs, Gs, Gd, Gs, Gd, Gs, Gs, Gs, Gs, Gs, Gs, Cer, Gd, Gs, Gs, Gd^Vhr, Rr, Rr, Gs^Qhh, Gg^Qhh, Gg, Gg^Qhh, Re, Re, Re^Gvs
Re, Re^Gvs, Re^Eff, Re^Eff, Gs, Rr, Rr, Re^Gvs, Re^Gvs, Re^Gvs, Re, Gs, Gd^Edb, Gd^Edt, Re, Cer^Qhh, Gs, Gs, Gd, Gd, Cer^Qhh, Gd, Gd, Gd, Gg, Gg, Gg, Gg^Edt, Re, Rr, Rr^Vhcr, Gs^Edt, Gg, Gg, Gs^Efm, Gd, Gd, Gg, Gs, Gd, Gd, Gd, Gs^Edb, Gg^Eff, Gg^Eff, Gs, Gg^Eff, Cer, Cer, 9 Ker, Rr, Gd, Rr, Rr, Re^Qhh, Gs^Qhh, Re, Gs, Re, Re, Re^Gvs, Re^Gvs, Re^Gvs
Gg^Eff, Re^Eff, Gs, Gg, Gs, Gs, Gg, Rr, Rr, Rr, Rr, Gd^Vhr, Rr, Gs^Edt, Gs^Edt, Gd, Gs, Gll, Gd, Gll^Fdw, Gll^Fdw, Gll^Fdw, Gll^Fdw, Gll, Gll, Gg, Gs, Gg, Rr, Rr, Gd^Edt, Gg^Edt, Gd^Efm, Gg^Efm, Re^Gvs, Gd^Efm, Gd^Efm, Gs, Gd, Gd, Gs, Gd, Re^Gvs, Re^Gvs, Re^Gvs, Gg^Eff, Gd^Vhr, Gs^Eff, Rr, Rr, Cer, Rr, Gd, Gd, Re^Qhh, Re, Re^Gvs, Re^Gvs, Re^Gvs, Re^Gvs, Re^Gvs, Re^Gvs, Re
Gg, Gs, Gs, Gs, Gs, Gg, Gg^Eff, Gg^Eff, Re^Gvs, Re^Gvs, Re^Gvs, Rr, Gs, Rr, Rr, Gs, Gs, Gd, Gll, Gll^Fdw, Gd^Fdw, Gll^Fdw, Gll^Fdw, Gs^Fdw, Re^Gvs, Re^Gvs, Re, Gg, Rr, Gg, Re, Re, Re^Gvs, Re^Gvs, Re^Gvs, Gd^Efm, Gd, Gd, Gd, Gs, Re, Re, Re^Gvs, Re^Gvs, Re^Gvs, Re^Gvs, Rr, Rr, Re, Gg^Eff, Gg^Eff, Gd, Gs^Qhh, Gd^Qhh, Re, Re^Gvs, Re^Gvs, Re^Gvs, Re^Gvs, Re^Gvs, Re^Gvs, Re^Gvs, Re^Gvs
Re, Re, Re, Gs, Gg, Gg, Gd, Re^Eff, Re^Eff, Re^Gvs, Re^Gvs, Re^Gvs, Gs^Ecf, Gg^Edt, Gs^Edt, Rr, Rr, Gs, Gs, Gll^Fdw, Gll^Fdw, Gll, Re^Gvs, Re^Gvs, Re^Gvs, Re^Gvs, Re^Gvs, Gg, Rr, Re, Re^Gvs, Re^Gvs, Re^Gvs, Re^Gvs, Re^Gvs, Gd^Efm, Gs, Gs, Re^Gvs, Re^Gvs, Re^Gvs, Re^Gvs, Re^Gvs, Re^Gvs, Re^Gvs, Re^Gvs, Rr, Gd^Vhr, Re^Gvs, Re, Re, Gd, Gs^Qhh, Gs, Re^Gvs, Re^Gvs, Re^Gvs, Re^Gvs, Re^Vhr, Re^Gvs, Re^Gvs, Re^Gvs, Re^Gvs
Re^Gvs, Re^Gvs, Re^Gvs, Re, Gg, Gg, Gg, Gd, Gg, Re, Re^Gvs, Re^Gvs, Gs^Es, Gs, Gg, Gg, Rr, Gs, Gs, Gs^Es, Re, Re^Gvs, Re^Gvs, Re^Gvs, Re^Gvs, Re^Gvs, Re^Gvs, Gg, Rr, Re, Re^Gvs, Re^Gvs, Re^Gvs, Re^Gvs, Re^Gvs, Re, Re, Re^Gvs, Re, Re^Gvs, Re^Gvs, Re^Gvs, Re, Re^Gvs, Gg, Gg, Rr, Re^Gvs, Re^Gvs, Re^Gvs, Re^Gvs, Gs^Qhh, Re^Gvs, Re^Gvs, Re^Gvs, Re^Gvs, Re^Gvs, Re^Gvs, Re^Gvs, Re, Re^Gvs, Re^Gvs, Gs^Gvs
Re^Gvs, Re^Gvs, Re^Gvs, Gg, Gs, Gg, Gg, Gg^Es, Gg^Es, Gd, Gd, Gs, Gs, Gg, Gg, Gg, Gg^Es, Rr, Rr, Gg, Gg, Re, Re^Gvs, Re^Gvs, Re^Gvs, Re^Gvs, Re^Gvs, Gg, Rr, Re, Re^Gvs, Re^Gvs, Re^Gvs, Re^Gvs, Re^Gvs, Re^Gvs, Gs, Re, Gs, Re, Gs, Gg, Gg, Gg, Rr, Rr, Re^Gvs, Re^Gvs, Re^Gvs, Re^Gvs, Re^Gvs, Gs^Qhh, Gd, Re^Gvs, Gd, Re^Gvs, Gs, Gg, Gg^Eff, Re^Vhr, Gd^Eff, Re^Eff, Re^Gvs
Re^Gvs, Re^Gvs, Re^Gvs, Gg, Gs, Gs, Re, Re, Re, Gs, Gs, Gd, Gd, Gs, Gs, Gg, Gg, Gg, Gg, Rr, Rr, Gg^Fdw, Re, Re^Gvs, Re^Gvs, Re^Gvs, Ce, Gg, Rr, Re, Re^Gvs, Re^Gvs, Re^Gvs, Re^Gvs, Re^Gvs, Re, Gg, Gs, Gg, Gs, Rr, Ce, Rr, Rr, Re, Re^Gvs, Re^Gvs, Re^Gvs, Re^Gvs, Re^Gvs, Gd^Qhh, Gd^Qhh, Gd, Gd, Gs, Ds, Ds, Ds, Ds, Gs^Eff, Dd, Re^Gvs, Ss
Re^Gvs, Re^Gvs, Re^Gvs, Re^Gvs, Re, Gs, Gd, Re, Gd, Re, Gs, Gg, Gg, Gd, Gg, Gs, Gd, Gs, Gg, Gg, Gg, Rr, Rr, Re, Ce, Ce, Rrc^Vhc, Rr^Vhc, Rr, Rrc, Rrc^Vhc, Ce, Ce, Re^Gvs, Re^Gvs, Re^Gvs, Gg, Gg, Rr, Rr, Rr^Vhc, Rr, Ce^Dr, Rr, Rr, Re, Re, Re^Gvs, Gg^Es, Gd, Gd^Qhh, Gd, Ds, Gs^Edb, Dd, Ds, Sm^Qhu, Gg, Wwg^Qhu, Re^Gvs, Re^Gvs, Re^Gvs, Re^Gvs
Re^Gvs, Re^Gvs, Re^Gvs, Re^Gvs, Re, Gs, Gd, Gd, Gd, Gd, Gll, Gll^Fdw, Gll^Fdw, Gs^Fdw, Gd^Vhr, Gs, Gd, Gd, Gll^Fdw, Gg, Re, Re, Ce, Rr, Rr^Vhc, Re^Ebn, Rrc, Rrc, Ww^Bsb|, Rrc, Rrc, Ke, Rr^Vhc, Ce, Gg, Gg, Rp, Rr, Gg, Gs, Re^Gvs, Gg^Edt, Gg^Edt, Gd, Rr, Gd, Re^Qhh, Re^Qhh, Gs^Qhh, Gd^Qhh, Ds, Gs, Ds, Dd, Cer, Dd, Sm^Qhu, Sm^Qhu, Dd, Dd, Dd, Re^Gvs, Ss
Rr, Re^Gvs, Re^Gvs, Re^Gvs, Re^Gvs, Re, Gd, Gd, Gd, Gll, Gll^Fdw, Gll^Fdw, Gll^Fdw, Gll^Fdw, Gll^Fdw, Gll, Re, Re, Re, Gll^Fdw, Re, Ce, Ke, Rr, Rr, Rrc, Ww, Ww, Isa, Ww, Ww, Rr, Rr, Rr^Ebn, Rr, Rr, Gg, Gg, Re^Gvs, Re^Gvs, Re^Gvs, Gd, Gs^Edt, Gg, Rr, Gd^Qhh, Gs, Gd, Re, Ds, Dd, Gd, Sm, Cer, Ds^Vhr, Gd, Cer, Cer, Dd, Wwg, Wwg, Wwg, Wwg
Gs, Rr, Rr, Re^Gvs, Re^Vhr, Re, Gd, Gd, Gd, Gd, Gll^Fdw, Gll^Fdw, Gll^Fdw, Gs^Fdw, Gll^Fdw, Re, Re^Gvs, Re^Gvs, Re^Gvs, Gg, Gg, Ce, Re, Rr, Ww^Bsb\, Ww, Isa^Vhc, Isa^Vhc, Isa, Isa^Vhc, Isa^Vhc, Ww, Ww^Bsb/, Rr, Rr^Vhc, Gg, Re^Gvs, Re^Gvs, Re^Gvs, Re^Gvs, Re^Eff, Gg^Eff, Gg, Gg, Rr, Gs, Ds, Gd, Gd^Em, Re, Dd^Vhr, Wwrg, Dd, Dd, Dd, Ds, Cer, 3 Ker, Wwg, Sm, Wwg, Gs, Rr
Gs^Qhh, Gs, Gg, Rr, Rr, Gs, Gd, Gs, Gs, Gs, Gs, Gll^Fdw, Re, Gll^Fdw, Re^Gvs, Re^Gvs, Re^Gvs, Re^Gvs, Re^Gvs, Gg^Eff, Gs^Eff, Re, Rr^Vhc, Rrc, Ww, Isa, Gg^Ebn, Ch, Ch, Ch, Gg^Ebn, Isa, Ww, Rr, Rr^Vhc, Ce, Re^Gvs, Re^Gvs, Re^Gvs, Re^Gvs, Re^Eff, Gs^Eff, Gs, Gg, Ds, Rr, Rr, Wwrg^Qhu, Ww^Qhu, Dd, Rr, Wwg, Ww, Cer, Ww, Rr, Rr, Rb, Sm, Wwg, Wwg, Rr, Ww
Gg^Qhh, Gg^Qhh, Gg, Gg, Gg, Rr, Rr, Rr, Rr, Cer, Rr, Gg, Re, Re^Gvs, Re^Gvs, Re^Gvs, Re^Gvs, Re^Gvs, Re^Eff, Re^Eff, Re, Ce, Rr^Vhc, Rrc, Ww, Isa^Vhc, Isr, Isr^Vhc, 1 Kh, Isr^Vhc, Isr, Isa^Vhc, Ww, Rrc, Rr, Ce, Re^Gvs, Re^Gvs, Gll^Fdw, Re^Eff, Gg, Gs, Gg^Es, Gg, Gg, Dd, Dd, Rb, Dd, Rr, Ds, Rb, Sm, Ww, Cer, Wwg, Wwg, Ss, Ss, Sm, Wwg, Ss, Wo
Hhd^Qhh, Gd^Qhh, Gd, Gg, Gg, Gg, Gs, Gs, Gs, Rr, Gg, Rr, Rr, Rr, Rr, Re^Gvs, Re^Gvs, Re, Gg, Gg, Re, Ce, Rr, Rr, Ww, Isa^Vhc, Gg^Ebn, Isr^Vhc, Ch, Isr^Vhc, Gg^Ebn, Isa^Vhc, Ww, Rr, Rr^Vhc, Ce, Re^Gvs, Re^Gvs, Re, Gll, Gll^Fdw, Gll, Gs, Ds, Ds, Ss, Ds, Dd, Sm, Ss, Sm, Ss, Gd^Es, Sm, Ds, Ds, Wwg, Wwg, Ss, Ss, Wwg, Ww, Wo
Hhd^Qhh, Hhd^Qhh, Gd^Qhh, Gd, Gs, Gs^Es, Gg, Gd, Gg, Gg, Re^Gvs, Re^Gvs, Gs, Gg, Gs, Rr, Rr, Rr, Rr, Gll^Fdw, Gg, Ce, Rr^Ebn, Rr, Ww^Bsb/, Isa, Isa^Vhc, Ch, Isa, Ch, Isa^Vhc, Isa, Ww^Bsb\, Rr, Re^Ebn, Re, Gs, Re, Gg, Gll^Fdw, Gg, Gs, Ds, Ds, Ss, Ds^Vhhr, Sm, Sm, Sm, Wwf, Ww, Wwf, Wwf, Ww, Wwf, Wwg, Ww, Ww, Wo, Wwg, Ww, Ww, Ww
Hhd^Qhh, Hhd, Gd^Qhh, Gg, Hh, Hh, Hh, Gd, Gs, Re^Gvs, Re^Gvs, Re^Gvs, Re^Gvs, Gs, Gd, Gd, Gs^Fdw, Gs, Gg, Rr, Gg, Gs, Rp, Rr, Rrc, Ww, Ww, Isa^Vhc, Isa, Isa^Vhc, Ww, Ww, Ww, Rrc, Rr, Rr, Rr, Gg, Gg, Gg, Gg, Ds, Gg, Ss, Ww, Ww, Ww, Ww, Ww, Wwf, Ww, Ww, Ww, Ww, Ww, Ww, Ww, Wo, Wo, Wo, Ww, Wwg, Ss
Hhd^Qhh, Hhd^Fdw, Hh^Fdw, Hh^Qhh, Hh^Qhh, Hh^Qhh, Hh^Qhh, Gs, Gd, Gs, Gs, Re^Gvs, Re, Re, Gg, Gg, Ce, Gs, Gs, Rr, Rr, Rp, Gg, Rrc^Vhc, Rrc, Rrc^Vhc, Rr, Ww, Ww^Bsb|, Ww, Rr^Vhc, Rr, Ww, Rr^Vhc, Ww, Ce, Gs^Edt, Rr, Rr, Gg, Ds, Ds, Ww^Edb, Wwg, Ww, Ww, Wo, Wo, Ww, Ww, Wwf, Wwg, Wwf, Ww, Ww, Ww, Wwg, Ww, Wwg, Ww, Ww, Ss, Ss
Hh^Qhh, Hh^Fdw, Gs, Gs, Hhd^Fdw, Hh^Vhr, Hh^Qhh, Gg^Qhh, Gg, Gs, Gs, Re, Gg^Es, Gg, Gs, Re, Ce, Re, Rr, Rr, Gs, Gg, Gg, Gg, Gg^Edt, Rrc, Rrc^Vhc, Rr, Rr, Rr, Rr^Vhc, Ch^Kov, Ch, Ww, Ww, Ww, Ww, Gg, Ww, Wwf^Bsb\, Ww^Bsb\, Ww, Ww, Wwg, Wwg^Edb, Ww, Ww, Ww, Wwf, Wwf, Gg, Sm, Ss, Gg, Ss, Ss, Ss, Sm, Sm, Ss, Gg, Wwg, Ss
Hh, Hh^Qhh, Gg, Gs, Hhd, Hh, Gll, Gg^Qhh, Hh^Qhh, Gg, Gs, Gs, Gd, Gs, Re, Re, Rr, Rr, Rr^Vhc, Gs, Gg, Gd, Gs, Gg, Gg^Efm, Ce, Ce, Rr^Vhc, Rr, Rrc^Ebn, Rr, Ch, Ww, Ww, Ww, Ww, Ww, Ww, Wo, Ww, Ww, Ww^Bsb\, Wwf^Bsb\, Ww, Ce^Edt, Wwg, Sm, Ds, Sm, Wwg, Ss, Ss, Gs^Fdw, Gll^Fdw, Gll^Fdw, Ss, Gs^Fdw, Wwg, Sm, Sm, Wwg, Wwg, Ww
Hh, Hh^Qhh, Hh^Qhh, Gs, Gg, Gll^_mh, Gd, Hh, Hhd, Hhd^Qhh, Hhd^Qhh, Gg^Qhh, Hhd^Qhh, Hhd, Rr, Rr, Re, Ce, Gg, Gg, Gd, Gd, Gd^Efm, Gg^Efm, Gg^Efm, Ds, Ww, Ww, Ww, Ch, Ww^Bh|, Wwg, Wo, Ww, Ww, Ww, Ww, Wo, Ww, Wwg, Ww, Rr^Vhc, Rr, Rr, Rb, Sm, Ss, Sm, Wwg, Gd, Gll^Fdw, Gll^Fdw, Gll^Fdw, Gs^Fdw, Gll^Fdw, Gs^Fdw, Sm, Sm, Ww, Gs^Fdw, Ss, Ss, Gs
Hh, Hh, Hh^Qhh, Gg, Gg, Gd, Gs, Gs, Gs, Gd, Gd, Hhd, Hhd^Qhh, Rr, Gg^Em, Re, Gs^Es, Gs, Gg, Gg, Gs, Gg, Ww, Ww, Ww, Ww, Wo, Ww, Ww, Ww, Ww^Bh|, Wwg, Ww, Ww, Ww, Ww, Ds, Ww, Ds, Gs, Gs, Gs, Gs, Rr, Gg, Rb, Gd, Ss, Wwg, Gd, Wwg, Gll^Fdw, Ss, Gll^Fdw, Gll^Fdw, Gll^Fdw, Gs^Fdw, Gs^Fdw, Gg^Fdw, Gs^Fdw, Wwg, Ss, Ww
Hh^Qhh, Hh, Gg, Gs^Qhh, Hh^Qhh, Gd^Qhh, Gs^Qhh, Gd, Gd, Gs, Gd^Qhh, Hhd^Qhh, Rr, Rr, Gd, Gs^Em, Gd, Gd, Ds, Wwf^Dr, Wwg^Edb, Ww, Ww, Ww, Wo, Wo, Ww, Ww, Ww, Ww, Rr, Ww, Ds, Ds, Ds, Ds, Ds, Ds, Ds, Ds, Gs, Gs, Gg, Gs, Gs, Rr, Gd, Wwg, Wwg, Ss, Ss, Ss, Wwg, Ss, Gll^Fdw, Gll^Fdw, Gll^Fdw, Gg, Ss, Gg, Gg, Wwg, Ss
Hh^Qhhf, Hh^Qhhf, Hhd^Qhhf, Gg^Qhh, Hh, Hhd, Gd^Qhh, Gd, Gd, Gd^Qhh, Gd, Rr, Gd, Gd, Ds, Gd, Ww, Wwf^Edb, Wwg^Dr, Wwf, Wwf^Dr, Wwg, Wwg, Ww, Ww, Ww, Wwg, Ww, Gg, Gg^Vhr, Rr, Ds, Gg, Gg, Gg, Ds, Gg, Ds, Gs, Gs, Gs, Gs, Gs, Gs, Gd^Vhr, Rr, Rb, Sm, Sm^Qhu, Sm, Ss, Wwg, Sm, Gd^Vhr, Gs^Es, Gll, Ss, Ss, Ss, Gg, Gs, Gs, Gg
Mm, Mm, Mm, Hh^Qhh, Hh, Hhd^Qhh, Gd, Gd, Gd^Qhh, Gd^Qhh, Rr, Rr, Ds, Ds, Ww, Ww^Dr, Ww, Ww, Wwg^Edb, Wwf, Wwf^Dr, Wwf, Wwf^Edt, Wwf, Gg, Gg, Gg, Gg, Gd, Re, Gs, Rb, Rb, Gg, Gg, Gg, Gg, Gg, Gd, Gs^Es, Gs, Gg, Gg, Gd, Gd, Gs, Gd^Qhu, Rb^Qhu, Rr, Gs, Gs, Ss, Ss, Ss, Gs^Em, Gd, Ss, Gg, Gd, Gg, Gs, Gg^Fms, Gg^Fms
Hh^Fds, Hh^Qhhf, Hh^Qhhf, Hh^Fms, Gd, Hh^Qhh, Hhd^Qhh, Hh, Gs^Qhh, Gd, Rr, Gd, Gs, Wwf, Ww, Ww, Wo, Wwg, Wwrg, Wwf^Dr, Gs, Ds^Edb, Gg, Gg, Gg, Gg, Gg, Gg, Wwg^Qhu, Wwg^Qhu, Ss, Gg, Rb, Gg, Gg, Gg, Gg, Gg, Gg, Gd, Gs, Gs, Gg, Gs, Gd^Qhu, Gd^Qhu, Gd, Gd, Gd, Rb, Rr, Gd, Gd, Gd^Em, Gd, Ss, Gg, Ss, Gd^Fms, Gd, Gs, Gd, Gg
Mm^Qhh, Hhd^Fds, Hhd^Fds, Hhd^Qhhf, Gd^Qhh, Hhd^Fdw, Mm^Qhh, Gs^Qhh, 6 Gs, Gs, Rr, Gd, Wwg, Wwg, Wo, Wo, Ww, Ww, Gd, Gd, Gs, Gs, Gg, Gg, Gg, Gg, Ss, Wwrg^Qhu, Wwg^Qhu, Wwrg^Qhu, Ss, Gg, Ss, Gg, Gg, Gs, Gs, Gs, Gs, Gg, Gs, Gg, Gd, Gs, Gs^Qhu, Gd, Gs, Gd, Gs, Gs, Gs^Es, Rr, Gs, Gs, Gs, Gg, Gs, Gg, Gg^Fms, Gs^Fms, Gs, Gs, Gd
Mm^Qhh, Mm, Mm, Mm, Hhd^Qhhf, Hhd^_mhh, Mm^Qhh, Gs, Gs, Rr, Ds, Ds, Wwg, Wwg, Wwg, Wwg, Ds, Gs, Gs, Gs, Gs, Gs, Gll^Fdw, Gg^Em, Gs^Fdw, Gg^Em, Gs, Ss, Ss, Sm^Qhu, Ss, Ss, Sm^Qhu, Wwg^Qhu, Wwrg^Qhu, Wwrg^Qhu, Gs, Gd, Gd, Gd, Gs, Gd, Gd^Qhu, Gs^Qhu, Gs, Gg, Gg, Gd, Gg^Fdw, Gd^Fdw, Gs^Fdw, Rb, Rr, Gs, Gs, Gs, Gg^Efm, Gg^Fms, Gd^Fms, Gs, Gg, Gs^Fms, Gd^Fms
Mm^Qhh, Mm, Mm, Hhd^Fds, Hh^Qhhf, Hh^Qhh, Hh^Fdw, Hh^Qhhf, Rr, Rr, Wwg, Wwg, Wog, Wog, Wwg, Wwf, Gs, Gs, Gll^Fdw, Gll^Fdw, Gs^Fdw, Gs^Fdw, Gs^Fdw, Gll^Fdw, Gd^Fdw, Gs^Fdw, Gg, Gg^Em, Gg^Qhu, Gd, Ss, Ss, Rb, Wwg^Qhu, Sm^Qhu, Sm^Qhu, Sm^Qhu, Sm^Qhu, Ss, Gg^Em, Gs, Gs^Qhu, Ss, Gs, Ss, Gs, Gd, Gd, Gd^Fdw, Gs^Fdw, Gs^Fdw, Gs^Fdw, Cer, Rr, Rr, Cer, Cer, Gg, Gg, Gs, Gs, Gg^Fms, Gd^Fms
Mm^Qhh, Mm, Mm, Mm, Hh^Qhh, Hhd^Vhh, Rr, Rr, Gs^Fds, Ds, Wwg, Wo, Wog, Wwg, Wwg, Gg, Gs^Fdw, Gd^Fdw, Gll^Fdw, Gd^Fdw, Gs^Fdw, Gs^Fdw, Gd^Fdw, Gs^Fdw, Gd^Fdw, Gg, Gs, Gg^Qhu, Gg^Em, Gd^Qhu, Cer^Qhu, Ss, Rb, Cer, 5 Ker, Cer, Ss, Ss, Ss, Gs, Gs^Qhu, Gs^Qhu, Gs, Ss, Gs, Gs, Gs, Gd, Gd^Fdw, Gs^Fdw, Gd^Fdw, Gg^Fdw, Gg^Fdw, Cer, 4 Ker, Rr, Rr, Gd^Vhr, Gs, Gg, Gg^Fms, Gg^Fms, Gg^Fms
Hh^Qhhf, Hhd^Fds, Hh, Mm, Hh^Qhhf, Hhd^Fds, Rr, Gs, Wwf, Wwf, Ww, Ww, Wwf, Wwg, Gg, Gs, Gd^Fdw, Gd^Fdw, Gll^Fdw, Gd^Fdw, Gs^Vl, Gd^Fdw, Gg, Gg, Gd^Qhu, Gd, Gs^Qhu, Gd^Qhu, Gd, Cer, Gg^Vhr, Cer^Qhu, Rr, Gs, Gs, Cer, Gg, Gg, Gs^Qhu, Gs^Qhu, Gs, Gs, Gs, Gs, Gs, Gd, Gs, Gs^Fdw, Gd, Gs^Qhu, Gg^Qhu, Gs, Gs, Cer, Gd^Vhr, Gg^Efm, Gg, Rr, Rr, Gs, Gg, Gg^Fms, Gg^Fms
Mm, Mm, Gs^Qhhf, Hh^Qhh, Rr, Rr, Gd^Qhh, Gs^Qhhf, Ww, Ww, Ww, Wwf, Wwf, Ds, Gg, Gg, Gg, Gd^Vl, Gd, Gs, Gs^Qhu, Gg^Qhu, Gs^Qhu, Gs^Qhu, Gg, Gd^Qhu, Gs, Gs, Gs, Gs, Gs^Qhu, Gs^Qhu, Gs, Rb, Gs^Vhr, Gs, Gs^Qhu, Gs^Qhuf, Gs, Gs, Gs, Gs, Gg, Gs, Gs^Fms, Gg, Gs^Fms, Gs, Gs^Fds, Gg^Fds, Gg^Fms, Gg^Qhu, Gs^Qhu, Cer, Gs^Qhu, Gs^Efm, Gs^Efm, Gg, Gg, Rb, Rr, Gg, Gg
Mm, Mm^Qhh, Rr, Rr, Gg^Fds, Gg^Qhhf, Wwf, Wwf, Ww, Ww, Ww, Wwf, Ds, Ds, Gs^Fms, Gs, Gs, Gg, Gg, Gd^Qhu, Gs, Gs, Gs, Gd, Gs, Gg, Gs, Gs, Gd^Fms, Gs^Fds, Gs^Qhuf, Cer, Rr, Rb, Gg, Gs, Gg^Qhuf, Gs^Fms, Gg^Fms, Gs, Gs, Gs, Gs, Gg^Fms, Gg^Fms, Gs^Fms, Gg^Fds, Gs^Fms, Gg^Fds, Gs^Fms, Gs^Fds, Gs^Fms, Gs^Fms, Gs^Qhu, Gs^Fms, Gs^Qhu, Gs^Qhu, Gg, Gg, Gs, Gg, Rr, Rr
Gg, Rr, Hh, Hh, Gg^Fds, Gg^Qhhf, Wwf, Ww, Wo, Ww, Wwf, Wwf, Gg, Gs^Fms, Gs^Fds, Gs^Fds, Gs^Fds, Gg, Gg^Qhu, Gg^Qhu, Gg^_ml, Gs, Gg, Gs^Fms, Gg^Fms, Gs^Fds, Gg^Fds, Gd^Fds, Gg, Gd^Fms, Gd^Fms, Gs, Rr, Gs, Gg^Qhu, Gg^Qhuf, Gg^Fms, Gg, Gg^Fms, Gg, Gg, Gg, Gg, Gg^Fms, Gg^Fms, Gg^Fds, Gg, Gg^Fds, Gg, Gg, Gg^Fds, Gs^Fds, Gg^Fds, Gs^Fds, Gg^_mll, Gg^Fms, Gg, Gs^Qhu, Gg^Qhu, Gs, Gg, Gg, Gg
