Aa^Fda, Aa^Fda, Aa^Fda, Aa^Fda, Aa^Fda, Gll^Fmw, Aa^Fda, Aa^Fda, Aa, Aa, Aa, Aa, Aa, Aa, Gs, Rr, Rr, Gs, Gs, Gs, Aa, Aa, Aa, Gg, Re, Re, Aa, Re, Aa^Eff, Aa, Aa, Gd^Vhr, Re, Gd^Gvs, Re, Re, Re, Re, Re^Eff, Gg^Eff, Gll^Fdw, Gd, Aa, Aa, Aa, Gll^Fdw, Aa^Fda, Aa^Fda, Aa^Fda, Aa^Fda, Aa^Fda, Gg, Aa^Fda, Aa^Fda, Gg, Gg, Gg, Gg, Gg, Gg, Rr, Rr, Gg
Aa, Aa^Fda, Aa^Fda, Aa^Fda, Aa^Fda, Aa^Fda, Aa^Fda, Aa, Aa, Aa, Aa, Aa, Aa, Aa^Es, Aa, Gs, Gs^Vh, Rr, Gs, Gs, Gd, Aa, Re, Re, Aa, Aa^Eff, Aa^Eff, Aa^Eff, Aa, Aa, Aa, Aa, Re, Re, Re, Re, Re^Vh, Re^Eff, Gs, Gs, Gll^Fdw, Gs, Gll^Fmw, Aa^Fda, Aa^Fda, Aa^Fda, Aa^Fda, Aa^Fda, Aa^Fda, Aa^Fda, Aa^Fda, Aa^Fda, Aa, Aa, Aa, Gs, Gs, Gs, Rr, Rr, Gs, Gs, Gs
Aa, Aa, Aa^Fda, Aa^Fda, Ha^Fda, Aa^Fda, Ha^Fda, Aa^Fda, Aa, Aa, Aa, Aa, Aa, Aa, Gs, Gd, Gd, Rr, Rr, Gd, Gd, Re, Gs, Aa, Aa, Aa, Aa, Aa, Aa, Aa, Gs, Gs, Cer, Cer, Re^Eff, Re^Eff, Cer, Gg, Gll^Fdw, Gll^Fdw, Gll^Fdw, Gll^Fdw, Gll^Fmw, Gll^Fmw, Aa, Aa^Fda, Aa^Fda, Aa^Fda, Gs, Aa, Aa, Aa, Aa, Gs, Gd, Gs, Rb, Rb, Hhd, Gs, Hh, Gs, Hh^Qhh
Gg, Gd, Gd, Hh^Fmw, Ha^Qhhf, Ha^Fda, Hh^Qhh, Aa, Aa^Es, Aa, Aa, Aa, Aa, Aa, Aa, Gs, Gs, Gs, Gs, Rr, Re, Re, Aa, Aa, Aa, Aa^Vha, Aa, Aa, Aa, Aa, Gs, Gs, Cer, Ker, Cer, Gs, Gs, Gs, Gll^Fdw, Gll^Fdw, Gll^Fdw, Gll^Fmw, Gll^Fmw, Gll^Fmw, Gg, Aa^Fda, Aa^Fda, Aa, Gs, Aa, Gs^_mh, Gs, Gd, Gd, Gd, Rr, Rr, Gd, Hhd^Qhh, Hhd^Qhh, Hh^Qhh, Hh^Qhh, Ha
Hhd, Hhd, Hhd^Qhh, Hhd^Qhh, Hhd^Qhh, Ha^Qhhf, Hh^Qhh, Hh^Qhh, Ha^Vhha, Ha, Aa, Aa, Aa, Aa, Gs, Gs, Gs, Gs, Gs, Rr, Gd, Gd, Aa, Aa, Gd, Gd, Aa, Aa, Aa, Aa, Gs, Gs^Efm, Gs, Cer, Gs, Gs^Efm, Gs, Gs, Gll^Fmw, Gll^Fdw, Gll^Fmw, Gs^Vl, Gll^Fmw, Gg, Gg, Gg, Gg, Gg, Gs, Gs, Gd, Gd, Gd, Gd, Rr, Rr, Hhd^Qhh, Hhd^Qhh, Ha, Ha, Ha, Ha, Ha
Re, Dd, Dd^Es, Dd, Dd, Hhd^Qhh, Mm^Qhh, Mm^Qhh, Mm^Qhh, Hh^Qhh, Hh^Qhh, Aa, Gg, Gs, Gs, Gs, Gs, Gs, Gll^Fmw, Rr, Gs, Gd, Gd, Gd, Gd, Gd, Gd, Gd, Gd, Gs^Vh, Aa, Aa, Aa, Gs, Gs^Efm, Gs^Efm, Gg, Gg, Gd, Gll^Fmw, Gg, Gll^Fdw, Re, Re, Re, Gs, Gg, Gs, Gd, Gs, Gs, Gs, Rb, Rr, Hhd^Qhh, Gd^Qhh, Hhd^Qhh, Ha, Ha, Ha, Aa, Ha, Ha
Gg^Efm, Gd, Gd, Dd, Dd, Hhd^Qhh, Hhd^Qhh, Mm^Qhh, Hhd^Qhh, Hh^Qhh, Hh, Hh, Gs, Gs, Gs, Gs, Gg, Gg, Gg^Efm, Rr, Gs, Gs, Gll^Fmw, Gll^Fmw, Gll^Fdw, Gs^Vwm, Gd, Gd, Rb, Aa, Aa, Aa, Aa, Gg, Gg^Efm, Gg, Gd, Gd, Gll^Fdw, Gd, Rb, Rb, Re, Re, Rb, Rb, Gg, Gd^Vh, Rr, Gs, Rr, Rr, Gs, Gd^Qhh, Ha, Ha, Ha, Ha, Ha, Aa, Aa, Aa, Aa
Gg, Gg^Efm, Gd, Dd, Dd, Hhd, Hhd^Es, Hhd^Qhh, Hhd^Qhh, Hhd^Qhh, Gs, Hh^Vhh, Gs, Gs, Gs, Gs, Gs, Gs, Gg^Efm, Rr, Gd, Gd, Aa, Aa^Fda, Aa^Fda, Gll^Fdw, Gll^Fdw, Rb, Aa, Rb, Aa, Aa, Aa, Aa, Aa, Gg, Rb, Rb, Rb, Gll^Fdw, Gll^Fdw, Rb, Rb, Rb, Rb, Re, Rb, Rb, Gs, Rr, Gd, Gd, Gd^Qhh, Hhd^Qhh, Cea, Cea, Ha, Ha, Aa, Aa, Aa, Aa, Aa
Re, Gg, Gs, Gd^Efm, Gd, Gs, Gs, Gs, Gs, Hh, Gs, Gs, Gs, Gs, Gd, Gs, Gd, Gg, Gs, Rr, Gd, Aa, Aa, Aa, Aa, Gll^Fdw, Rb, Rb, Rb, Aa, Aa, Rb, Rb, Aa, Aa, Aa, Re, Re, Rb, Rb, Rb, Gll^Fdw, Gll^Fdw, Rb, Gs, Gd, Rr, Gs, Gg^Qhh, Gs, Hh^Qhh, Hhd^Qhh, Hh, Hh, Cea, Kea, Ha, Ha, Ha, Rb, Aa, Aa, Aa
Re, Gg, Gd, Gd, Gd, Gs, Gs, Gg, Gs, Gs, Gd, Gs, Gs, Gd, Gg, Gd, Gg^Es, Gs^Edt, Ce, Rr, Ce, Gd, Aa, Aa, Aa, Gd, Re, Rb, Rb, Aa, Re, Aa, Gd, Gs, Gs, Re, Re, Rb, Rb, Rb, Rb, Rb, Gs, Gd^Vwm, Rr, Rr, Gs^Qhh, Gg^Qhh, Aa^Fda, Gg^Qhh, Hh, Hh, Gs, Ce, Cea, Ha, Cea, Gs, Re^Eff, Re, Aa, Aa, Rb
Gs, Rr, Rr, Gd^Edt, Re, Gs, Gs, Gs, Gd, Gd, Gd^Vl, Gd, Gd, Gd, Gs, Gs, Gd, Gs^Edt, Re, Rr, Rrc^Vhc, Gs, Gs, Aa, Aa, Aa, Aa, Re, Rb, Rb, Re, Re, Gll^Fdw, Gg^Eff, Gd^Eff, Gs, Gg^Eff, Re, Re, Rb, Rr, Gd, Rr, Rr, Re^Qhh, Gs^Qhh, Aa^Fda, Aa^Fda, Aa, Re, Re, Gs, Re, Re, Re, Gs, Gs, Re^Eff, Aa^Eff, Aa, Aa, Aa, Ww
Re, Gd^Edt, Rr, Gs^Vwm, Gs^Edt, Gd, Gs, Gll, Gd, Gll^Fdw, Gll^Fdw, Gll^Fdw, Gll^Fdw, Gll, Gll, Gg, Gs, Gd, Rr, Rr, Gd, Gd, Gd, Aa, Re, Aa, Re, Re, Re, Re, Gll^Fdw, Gll^Fdw, Re, Re, Re, Gd^Eff, Gd^Vh, Gs^Eff, Rr, Rr, Gs, Rr, Gd, Gd, Re^Qhh, Aa^Fda, Aa, Aa^Fda, Aa^Fda, Re, Rb, Rb, Rb, Re, Re, Re, Re^Ecf, Gg, Ce, Aa^Eff, Aa, Aa, Ww
Re, Re, Gs, Rr, Rr, Gs, Gs, Gd, Gll, Gll^Fdw, Gll^Fdw, Gll^Fdw, Gll^Fdw, Gll^Fdw, Rb, Rb, Re^Vwm, Gd, Rr, Gs, Rb, Rb, Rb, Gll^Fdw, Gll^Fdw, Re, Re, Rb, Gll^Fdw, Gll^Fdw, Re, Re, Re, Re, Re, Re, Rr, Rr, Re, Gg^Eff, Gg^Eff, Gd, Gs^Qhh, Gd^Qhh, Re, Aa, Re, Aa, Re, Gll^Fdw, Re, Rb, Rb, Rb, Rb, Re, Gs, Gg, Ke, Ce, Aa, Ww, Ww
Re, Re, Gs, Gg^Edt, Gs^Edt, Rr, Rr, Gs, Gs, Gll^Fdw, Gll^Fdw, Gll, Rb, Rb, Rb, Rb, Rb, Gd, Rr, Rb, Rb, Rb, Rb, Rb, Rb, Gll^Fdw, Gs^Vwm, Gll^Fdw, Re, Re, Re, Re, Re, Re, Re, Re, Aa, Aa^Vha, Aa, Re, Re, Gd, Gs^Qhh, Gs, Re, Re, Re, Re, Rb, Rb, Re, Re, Re, Re, Gll^Fdw, Gs, Gll^Fdw, Ce, Ce, Ce, Ww, Ww, Ww
Re, Re, Gs^Es, Gs, Gs, Gs, Rr, Gs, Gs, Gs^Es, Rb, Rb, Rb, Rb, Rb, Rb, Rb, Rb, Rr, Rb, Rb, Rb, Rb, Rb, Rb, Rb, Rb, Gll^Fdw, Gll^Fdw, Re, Re, Re, Re, Re, Gd, Gd, Rb, Aa, Aa, Re, Re, Gs^Qhh, Re, Re, Re, Re, Re, Re, Re, Re, Re, Re, Gll^Fdw, Gll^Fdw, Gll^Fdw, Gll^Fdw, Gg, Gg, Gs, Ww, Ww, Ww, Wo
Gd, Gs, Gs, Gs, Aa, Gd, Gd^Es, Rr, Rr, Gd, Gd, Rb, Rb, Rb, Rb, Rb, Rb, Rb, Rr, Rb, Rb, Rb, Aa, Rb, Aa, Aa, Aa, Rb, Gs, Gll^Fdw, Gll^Fdw, Gs, Gd, Gs, Rr, Rr, Re, Re, Re, Re, Re, Gs^Qhh, Gd, Re, Gd, Re, Gs, Gg, Gg^Eff, Re^Vh, Gd^Eff, Re^Eff, Gs, Gg, Gg, Gg, Gll^Fdw, Gs, Ww, Ww, Ww, Ww, Wo
Gs, Gd, Gd, Gs, Aa, Aa, Aa, Gd, Gd, Rr, Rr, Gll^Fdw, Rb, Rb, Rb, Rb, Ce, Rb, Rr, Aa, Aa, Aa, Aa, Aa, Aa, Aa, Aa, Gs, Gg, Gs, Rr, Ce, Rr, Rr, Re, Re, Re, Re, Re, Re, Gd^Qhh, Gd^Qhh, Gd^Fdw, Gd, Gs, Ds, Rb, Rb, Rb, Gs^Eff, Aa, Re, Re, Gs, Gll^Fdw, Gg, Gll^Fdw, Gll^Fdw, Ww, Ww, Ww, Wo, Wo
Gs, Gg, Aa, Aa, Aa, Aa, Aa, Aa, Gs, Gd, Gd, Rr, Rr, Rb, Ce, Ce, Rrc^Vhc, Rr^Vhc, Rr, Rrc, Rrc^Vhc, Cea, Cea, Aa, Aa, Aa, Aa, Gg, Rr, Rr, Rr^Vhc, Rr, Cea, Rr, Rr, Re, Re, Re, Gg^Es, Gd, Gd^Qhh, Gd, Rb, Gll^Fdw, Gll^Fdw, Rb, Aa, Rb, Re, Aa, Aa, Aa, Re, Re, Re, Gll^Fdw, Gll^Fdw, Gll^Fdw, Ww, Ww, Ww, Wo, Wo
Aa, Aa^Fda, Aa^Fda, Aa^Fda, Aa^Vla, Aa, Aa, Aa, Aa^Fda, Gd, Aa, Re, Ce, Rr, Rr^Vhc, Re^Ebn, Rrc, Rrc, Wo^Bsb|, Rrc, Aa, Kea, Rr^Vhc, Cea, Gg, Aa, Rp, Rr, Gg, Aa, Aa, Aa^Edt, Aa^Edt, Gd, Rr, Gd, Re^Qhh, Re^Qhh, Gs^Qhh, Gd^Qhh, Gs, Gs, Rb, Rb, Rb, Gll^Fdw, Aa^Fda, Aa, Gs, Aa, Re, Aa, Aa, Aa, Re, Re, Gll^Fdw, Ww, Ww, Ww, Wo, Wo, Wo
Gll^Fdw, Aa^Fda, Aa^Fda, Gll^Fdw, Gll^Fdw, Aa, Aa, Aa, Aa, Aa^Fda, Aa, Cea, Ke, Rr, Rr, Rrc, Wo, Wo, Isa, Ww, Ww, Aa, Rr, Rr^Ebn, Rr, Rr, Aa, Gg, Rb, Rb, Aa, Aa, Aa^Edt, Aa, Rr, Gd^Qhh, Aa, Aa, Aa, Aa, Aa, Rb, Re, Aa, Aa, Aa, Gll^Fdw, Aa^Fda, Aa, Re, Aa, Aa, Aa, Re, Wwf, Ww, Ww, Ww, Wo, Wo, Wo, Wo, Ww
Gll^Fdw, Gll^Fdw, Gll^Fdw, Gll^Fdw, Gll^Fdw, Aa, Aa, Aa, Aa, Aa, Aa, Cea, Re, Rr, Ww^Bsb\, Ww, Isa^Vhc, Isa^Vhc, Isa, Isa^Vhc, Isa^Vhc, Ww, Wo^Bsb/, Rr, Rr^Vhc, Gg, Aa, Rb, Rb, Rb, Rb^Eff, Aa^Eff, Aa, Aa, Aa, Aa, Aa, Aa, Aa, Aa^Vhca, Rb, Re, Aa, Aa, Aa, Aa, Aa, Aa, Aa, Aa, Aa, Aa, Aa, Wwf, Wwf, Wwf, Ww, Ww, Wo, Wo, Wo, Ww, Ww
Gs, Gll^Fdw, Gd^Vwm, Gll^Fdw, Aa, Aa, Aa, Aa, Aa, Aa^Eff, Aa^Eff, Aa, Rr^Vhc, Rrc, Wo, Isa, Gg^Ebn, Ch, Ch, Ch, Gg^Ebn, Isa, Wo, Rrc, Rrc^Vhc, Cea, Aa, Aa, Rb, Rb, Rb^Eff, Aa^Eff, Rr, Rr, Aa, Aa, Rr, Aa, Ch, Rr, Rr, Ch, Rr^Vhc, Aa, Aa, Aa, Ds, Aa, Wwf, Ds, Wwf, Wwf, Wwf, Wwf, Wwf, Ww, Ww, Ww, Wo, Wo, Ww, Ww, Hh^Qhh
Rr, Gg, Rb, Aa, Aa, Aa, Aa, Aa, Aa^Eff, Aa^Eff, Aa, Cea, Rr^Vhc, Rrc, Ww, Isa^Vhc, Isr, Isr^Vhc, 2 Kh, Isr^Vhc, Isr, Isa^Vhc, Ww, Aa, Aa, Cea, Aa, Aa, Gll^Fmw, Rb^Eff, Gg, Gs, Gg^Es, Rr, Rr, Cea, Rr, Rr, Ch, Ch, Aa, Rr, Ai, Ww^Bw\, Ww, Ds, Ww, Wwf, Ww, Ww, Ww, Ww, Ww, Wwf, Ww, Ww, Ww, Wo, Ww, Ww, Hh^Qhh, Hh^Qhh, Hh^Qhh
Aa, Aa, Aa, Aa, Aa, Aa, Aa, Aa, Aa, Aa, Aa, Cea, Rr, Aa, Ww, Isa^Vhc, Gg^Ebn, Isr^Vhc, Ch, Isr^Vhc, Gg^Ebn, Isa^Vhc, Ww, Aa, Rr^Vhc, Cea, Aa, Aa, Rb, Gs, Gll^Fmw, Gs, Gs, Ds, Ce, Rr, Rr^Vhc, Ch, Kh, Kh, Ww^Bw\, Ai, Ai, Ai, Ww, Ww, Ww, Ww, Ww, Ww, Ww, Ww, Ww, Ww, Ww, Ww, Ww, Ww, Ww, Ww^Vm, Hh^Qhh, Hh^_mh, Hh^Qhh
Aa, Aa, Aa, Aa, Aa, Aa, Rr, Aa, Aa, Aa^Fda, Aa, Cea, Rr^Ebn, Rr, Ww^Bsb/, Isa, Isa^Vhc, Ch, Isa, Ch, Isa^Vhc, Isa, Wo^Bsb\, Rr, Re^Ebn, Aa, Gs, Aa, Gd, Gll^Fmw, Gd, Gs, Aa, Ds, Ds, Rr^Vhc, Ai, Ai, Ww^Bw|, Ai, Wo, Ww, Wo, Ww, Wo, Wo, Wo, Ww, Wo, Ww, Ww, Ww, Wwf, Wwf, Wwf, Wwf, Wwf, Ww, Hh^Qhh, Hh^Qhh, Hh, Hh, Hh^Qhh
Re, Aa, Re, Gs, Aa, Aa, Gll^Fdw, Gs, Gg, Aa, Gg, Gs, Rp, Rr, Rrc, Ww, Wo, Isa^Vhc, Isa, Isa^Vhc, Ww, Wo, Wo, Rrc, Rr, Rr, Aa, Gs, Gd, Gd, Aa, Gd, Aa, Aa, Ww, Ww, Ww, Ww, Wo, Wo, Wo, Wo, Wo, Wo, Ww, Wo, Ww, Ww, Ww, Ww, Wwf, Ww, Wwf, Wwf, Wwf, Wwf, Gs^Qhhf, Hh^Qhh, Hh, Hh^Qhh, Hh, Hh, Hh^Qhh
Gs, Re, Re, Re, Gg, Aa, Ce, Gs, Gs, Rr, Rr, Rp, Aa, Rrc^Vhc, Aa, Rrc^Vhc, Rr, Wo, Wo^Bsb|, Ww, Rr^Vhc, Rr, Ww, Rr^Vhc, Ww, Cea, Aa^Edt, Aa, Rr, Gs, Aa, Aa, Ww, Ww, Ww, Ww, Wo, Wo, Ww, Wo, Ww, Ww, Ww, Ww, Ww, Ww, Gll^Fdw, Ww, Wwf^Vm, Wwf, Gg, Wwf, Gs, Gs, Gs^Qhhf, Gs^Qhhf, Hh^Fdw, Gs, Hh^Qhh, Hh, Hh^Qhh, Hh^Qhh, Gs
Aa, Re, Aa^Es, Gg, Gs, Re, Ce, Re, Rr, Rr, Aa, Gg, Aa, Aa, Aa^Edt, Aa, Rrc^Vhc, Rr, Rr, Rr, Rr^Vhc, Ch^Kov, Ch, Ww, Wo, Ww, Ww, Gs, Ww, Wwf^Bsb\, Ww^Bsb\, Ww, Ww, Ww, Ww, Ww, Ww, Ww, Ww, Ww, Gd, Ww, Gs, Gd, Gd, Gd, Gll^Fdw, Gll^Fdw, Gg, Gg, Gg, Gg, Gs, Gs, Gs^Qhh, Hh^Fdw, Gs^Vl, Hh^Fdw, Gd, Gs^Qhh, Gs, Gg, Gg
Gs, Aa, Aa, Gs, Re, Re, Rr, Rr, Aa^Vhca, Aa, Aa, Aa, Aa, Aa, Aa, Cea, Cea, Rr^Vhc, Rr, Rrc^Ebn, Rr, Ch, Ww, Ww, Wo, Wo, Wo, Ww, Wo, Ww, Ww, Ww^Bsb\, Wwf^Bsb\, Ww, Ce, Ww, Gd, Gd, Gs, Gd, Gs, Gs, Gs, Gs, Gs, Gll^Fdw, Gll^Fdw, Gll^Fdw, Gs, Gs, Gs, Hh, Hh, Hh, Hh, Gs^Qhh, Gd, Gs, Gd, Gs, Cer, Hh, Hh
Hhd, Aa, Hhd, Hhd, Rr, Rr, Re, Ce, Aa, Aa, Gd, Aa, Aa, Aa, Aa, Aa, Ww, Ww, Ww, Ch, Ww^Bh|, Ww, Wo, Wo, Wo, Wo, Ww, Wo, Ww, Ww, Ww, Rr^Vhc, Rr, Rr, Rb, Gd, Gs, Gs, Gs, Gd, Gll^Fdw, Gll^Fdw, Gll^Fdw, Gll^Fmw, Gll^Fmw, Gll^Fmw, Gg, Gg, Gs, Gs, Gs, Gd, Gd, Hh, Hh, Hh, Hh, Gs, Gs, Gs, Hh, Hh, Hh
Gd, Hhd, Hhd, Rr, Gg^Em, Re, Gs^Es, Gs, Gg, Gg, Gs^Vh, Gg, Ww, Ww, Ww, Ww, Wo, Ww, Ww, Ww, Ww^Bh|, Ww, Ww, Ww, Ww, Ww, Ds, Ww, Ds, Gs, Gs, Gs, Gs, Rr, Gg, Rb, Rr^Vhc, Gs, Gg^Efm, Gd, Gs, Gll^Fdw, Gs, Gll^Fmw, Gll^Fdw, Gll^Fdw, Gll^Fdw, Gll^Fmw, Gll^Fmw, Gs, Gd, Gd, Gs, Gd, Hh, Hh, Hh, Gs, Hh^Vhh, Gs, Gg, Hh, Gg
Gd, Hhd, Rr, Rr, Gd, Gs^Em, Gd, Gd, Ds, Ww, Ww, Ww, Ww, Ww, Wo, Wo, Ww, Ww, Ww, Ww, Rr, Ww, Ds, Ds, Ds, Ds, Ds, Ds, Ds, Ds, Gs, Gs, Gg, Gs, Gs, Rr, Gd, Gg, Gs, Gg^Efm, Gs, Gs, Gg^Efm, Gg, Gll^Fdw, Gll^Fdw, Gll^Fdw, Gg, Gs, Gs, Gs, Gd, Gs, Gd, Gs, Gs, Gg, Cer, Cer, Gg, Cer, Gg, Hh
Gd, Rr, Gd, Gd, Ds, Gd^Vh, Ww, Ww, Ww, Ww, Ww, Ww, Ww, Ww, Ww, Ww, Wwg, Ww, Gg, Gg^Vh, Rr, Ds, Gd, Gs, Gd, Ds, Gs^Eff, Ds, Rb^Eff, Gs, Aa, Aa, Re, Gs, Gd^Vwm, Rr, Rb, Gs, Rr^Vhc, Ce, Gg, Gg, Gg, Gd^Vh, Gs^Es, Gll, Gs, Gs, Gs, Gs, Gs^Es, Gs, Gg^Vl, Gs, Rb, Rb, Rb, Cer, Gg, Gg, Ker, Cer, Aa
Rr, Rr, Ds, Ds, Ww, Ww, Ww, Ww, Ww, Ww, Ww, Ww, Ww^Vm, Ww, Gd, Gs, Gs, Gs, Gd, Re, Gs, Rb, Rb, Gd, Re^Eff, Re^Eff, Rb, Rb^Eff, Rb, Gs^Es, Aa, Aa, Aa, Aa, Aa, Cea, Aa^Qhu, Rb, Rr, Ce, Gs, Gg, Gs, Gg, Gs^Em, Gd, Gd, Gs, Gd, Gg, Gs, Gll^Fmw, Gll^Fmw, Rb, Rb, Re, Re, Rb, Rb, Cer, Cer, Aa, Aa
Rr, Gd, Gs, Wwf, Ww, Ww, Wo, Ww, Ww, Ww, Gs, Ds, Gs, Gd, Gs, Gs, Re, Re, Re, Rb, Gs, Gg, Rb, Re^Eff, Re, Re, Re, Re, Aa, Aa, Aa, Aa, Gg, Aa, Aa^Qhu, Aa^Qhu, Aa, Aa, Gd, Rb, Rr, Gd, Gd, Gd^Em, Gd, Gs, Gd, Gd, Gll^Fmw, Gd, Gs, Gd, Aa, Aa, Aa, Re, Re, Re, Re, Rb, Re, Re^Eff, Aa^Eff
Rr, Gd, Ww, Ww, Wo, Wo, Ww, Ww, Aa, Aa, Aa, Gs, Aa, Aa, Aa, Aa, Aa, Re, Rb, Re, Rb, Gg, Rr, Re, Rb, Re, Rb, Aa, Aa, Aa, Aa, Aa, Gd, Gs, Aa^Qhu, Gd, Aa, Aa, Gs, Gs, Gs^Es, Rr, Gs, Gs, Gs, Gs, Gs, Gd, Gll^Fmw, Gll^Fmw, Aa, Aa, Aa, Aa, Aa, Aa, Rb, Re, Rb, Rb, Rb, Aa, Aa
Ds, Ds, Ww, Ww, Ww, Ww, Ds, Aa, Aa, Aa, Aa, Aa, Aa^Fda, Aa, Aa^Fda, Aa, Re, Rb, Rb, Re, Rb, Rb, Rr, Re, Re, Re, Re, Aa, Rb, Rb, Gs, Gd, Rb^Qhu, Re^Qhu, Gs, Aa, Aa, Gd, Gll^Fmw, Gll^Fmw, Gll^Fmw, Rb, Rr, Gs, Gs, Gs, Gs^Qhu, Gll^Fmw, Gll^Fmw, Gs, Aa, Aa^Fda, Aa^Fda, Aa^Fda, Aa^Fda, Gll^Fmw, Gll^Fmw, Rb, Rb, Re, Re, Aa, Aa^Eff
Ww, Ww^Vm, Wo, Wo, Ww, Wwf, Aa, Aa, Aa^Fda, Aa^Fda, Aa^Fda, Aa^Fda, Aa^Fda, Aa^Fda, Aa^Fda, Gll^Fdw, Gg, Gg^Em, Rb, Re, Re, Rb, Rr, Re, Re, Re, Rb, Rb, Rb, Rb, Gs, Rb^Qhu, Rb, Gs, Aa, Aa, Gd, Gd, Gll^Fmw, Gll^Fmw, Gll^Fmw, Gll^Fmw, Gs^Qhu, Rr, Rr, Gg^Qhu, Gs^Qhu, Gs^Qhu, Aa, Aa, Aa, Aa^Fda, Aa^Fda, Aa^Fda, Aa^Fda, Aa^Fda, Gll^Fmw, Gd, Gd, Rb, Rb^Eff, Aa^Eff, Aa
Ww, Wo, Wo, Ww, Ww, Aa, Gll^Fdw, Aa^Fda, Gll^Fdw, Aa^Fda, Aa^Fda, Aa^Fda, Gll^Fdw, Aa^Fda, Gll^Fdw, Gg, Rb, Re, Re, Re, Re, Gs, Rb, Re, Re, Rb, Rb, Rb, Gs, Gs, Rb^Qhu, Re^Qhu, Aa, Aa, Aa, Aa, Gs, Gg^Vl, Gll^Fmw, Gll^Fmw, Gll^Fmw, Gll^Fmw, Gll^Fmw, Gd^Qhu, Gs^Qhu, Rr, Rr, Gs^Vh, Aa, Aa, Aa^Fda, Aa^Fda, Aa^Fda, Aa^Fda, Gll^Fmw, Gll^Fmw, Gll^Fmw, Gll^Fmw, Gs^Vwm, Rb^Eff, Re, Re^Eff, Re^Eff
Ww, Ww, Wwf, Ww, Aa, Aa, Gll^Fdw, Gll^Fdw, Gll^Fdw, Gll^Fdw, Gs^Vl, Gll^Fdw, Rb, Re, Re, Rb, Re, Re, Re, Re, Gg^Vwm, Gs, Rr, Re, Gs, Gs, Gg, Gg, Re^Qhu, Re^Qhu, Re, Re, Gs, Aa, Gs, Aa^Es, Gs, Gll^Fmw, Gd, Gs^Qhu, Gs^Qhu, Gs, Gs, Gd^Qhu, Gd^Vh, Gs, Gs, Rr, Rr, Aa, Aa, Aa^Fda, Aa^Fda, Gll^Fmw, Gll^Fmw, Gll^Fmw, Gll^Fmw, Gll^Fmw, Gll^Fmw, Rb, Re, Re, Aa
Ww, Wwf, Wwf, Ds, Gg, Gg, Gg^Es, Gd^Vl, Gd, Gs, Rb, Rb, Rb, Re, Re, Re, Re, Rb, Rb, Gs, Rb, Gs, Gs, Rb, Gs^Vh, Gs, Rb^Qhu, Gs^Qhuf, Gll^Fdw, Re, Gs, Re, Gg, Gs, Gll^Fmw, Gg, Gll^Fmw, Gs, Gll^Fdw, Gll^Fdw, Gll^Fmw, Gd^Qhu, Gs, Gd^Qhu, Gs^Qhu, Gs, Gs, Gs, Gs, Rb, Rr, Gg, Gg, Gg, Gg, Gg, Gg, Gg, Aa, Re, Aa, Aa, Aa
Ww, Wwf, Ds, Ds, Gll^Fmw, Gs, Gs, Gg, Gg, Rb, Aa, Aa, Rb, Re, Gll^Fmw, Re, Gs, Gs, Rb, Rb, Re, Re, Rr, Rb, Gg, Gll^Fdw, Gll^Qhuf, Gll^Fmw, Gll^Fmw, Gs, Gs, Gs, Gs, Gll^Fmw, Gll^Fmw, Gll^Fmw, Gll^Fdw, Gll^Fmw, Gll^Fdw, Gll^Fmw, Gll^Fdw, Gll^Fmw, Gll^Fmw, Gs^Qhu, Gll^Fmw, Gs^Qhu, Gs^Qhu, Gs, Gs, Gs, Gg, Rr, Rr, Rr, Rr, Gg, Gg, Aa, Aa^Fmw, Aa^Fmw, Aa^Fmw, Aa, Aa^Fmw
Wwf, Wwf, Gg, Gll^Fmw, Gll^Fdw, Gll^Fdw, Gll^Fdw, Gg, Aa, Aa, Rb, Aa, Aa, Gll^Fmw, Gll^Fmw, Gll^Fmw, Rb, Rb, Re, Re, Re, Gs, Rr, Gs, Gg^Qhu, Gll^Qhuf, Gll^Qhuf, Gs^Qhu, Gll^Fmw, Gll^Fdw, Gg, Gg, Gg, Gll^Fmw, Gll^Fmw, Gll^Fdw, Gg, Gll^Fdw, Gg, Gg, Gll^Fdw, Gll^Fdw, Gll^Fdw, Gll^Fdw, Gg^_mll, Gll^Fmw, Gg, Gs^Qhu, Gg^Qhu, Gs, Gg, Gg, Gg, Gg, Gg, Rr, Rr, Aa, Aa, Aa^Fmw, Gll^Fmw, Aa^Fmw, Gll^Fmw
