Gd, Gd, Gg^Fdw, Gg^Fdw, Gd^Fms, Gg^Fdw, Gg^Fms, Gs^Fms, Gg, Gd, Gs, Gg, Gg, Gs^Es, Gg, Rr, Rr, Gs, Gg, Gg, Gg, Gg, Gg, Gg, Re, Re, Re^Gvs, Re^Gvs, Re^Eff, Gg, Gs, Gd^Vhr, Re^Gvs, Gd^Gvs, Re^Gvs, Re^Gvs, Re^Gvs, Re^Gvs, Re^Eff, Gg^Eff, Gs^Fds, Gd, Gg, Gs, Gs, Gll^Fdw, Gll^Fms, Gg, Gll^Fms, Gs, Gll^Fms, Gg, Gs^Fds, Gll^Fms, Gg, Gg, Gg, Gg, Gg, Gg, Rr, Rr, Gg
Gd, Gd, Gd^Fdw, Gd^Fms, Gg^Fms, Gg^Fdw, Gs^Fms, Gg, Gg, Gd, Gd, Gg, Gs, Gg^Es, Gg, Gg, Gs^Vh, Rr, Gg^Efm, Gg^Efm, Gg^Efm, Gg, Re, Re, Gg, Gg^Eff, Re^Eff, Re^Eff, Gs, Gd, Gs, Gd, Re^Gvs, Re^Gvs, Re^Gvs, Re^Gvs, Re^Vh, Re^Eff, Gs, Gs, Gs^Fds, Gs, Gll^Fms, Gll^Fms, Gll^Fms, Gll^Fms, Gll^Fms, Gll^Fms, Gs^Fds, Gll^Fms, Gs^Fds, Gs^Fds, Gs, Gs, Gs, Gs, Gs, Gs, Rr, Rr, Gs, Gs, Gs
Gd, Gd, Gg^Fdw, Gg^Fdw, Gd^Fms, Gg^Fms, Gs^Fms, Gg^Es, Gs, Gs, Gs, Gd, Gs, Gg, Gg, Gg, Gg, Rr, Rr, Gg^Efm, Gg^Efm, Re, Gg, Gg, Gg, Gg, Gg, Gs, Gs, Gs, Gs, Gs, Cer, Cer, Re^Eff, Re^Eff, Cer, Gg, Gs^Fds, Gs^Fds, Gs^Fds, Gs^Fds, Gll^Fms, Gll^Fms, Gs, Gs^Fds, Gs^Fds, Gs^Fds, Gs, Gs, Gd, Gs, Gs, Gs, Gd, Gs, Rb, Rb, Hh, Gs, Hh, Gs, Hh^Qhh
Gg, Gd, Gd, Hh^Fdw, Hhd^Qhhf, Gd^Fms, Hh^Qhh, Gs, Gg^Es, Gs, Gg, Gs, Gg, Gg, Gg, Gg^Efm, Gg^Efm, Gg^Efm, Gg^Efm, Rr, Re, Re, Gg, Gg, Gg, Gs^Vh, Gg, Gs, Gs, Gs, Gs, Gs, Cer, Ker, Cer, Gs, Gs, Gs, Gs^Fds, Gs^Fds, Gs^Fds, Gll^Fms, Gll^Fms, Gll^Fms, Gg, Gs^Fds, Gs^Fds, Gg, Gs, Gs, Gs^_mh, Gs, Gd, Gd, Gd, Rr, Rr, Gd, Hh^Qhh, Hh^Qhh, Hh^Qhh, Hh^Qhh, Hh
Hhd, Hhd, Hhd^Qhh, Hhd^Qhh, Hhd^Qhh, Hhd^Qhhf, Hh^Qhh, Hh^Qhh, Hh^Vhh, Hh^Es, Gs, Gs, Gg, Gg, Gg, Gg^Efm, Gg^Efm, Gg^Efm, Gg^Efm, Rr, Gg^Efm, Gg^Efm, Gd, Gg, Gg, Gg, Gs, Gg, Gs, Gs, Gs, Gs^Efm, Gs, Cer, Gs, Gs^Efm, Gs, Gs, Gll^Fms, Gs^Fds, Gll^Fms, Gs^Vl, Gll^Fms, Gg, Gg, Gg, Gg, Gg, Gs, Gs, Gd, Gd, Gd, Gd, Rr, Rr, Hh^Qhh, Hh^Qhh, Hh, Hh, Hh, Hh, Hh
Re, Dd, Dd^Es, Dd, Dd, Hhd^Qhh, Mm^Qhh, Mm^Qhh, Mm^Qhh, Hh^Qhh, Hh^Qhh, Gs, Gg, Gs, Gs, Gg^Efm, Gg^Efm, Gg, Gll^Fms, Rr, Gg, Gg^Efm, Gd, Gd, Gd, Gd, Gd, Gd, Gd, Gs^Vh, Gs^Efm, Gs^Efm, Gs^Efm, Gs, Gs^Efm, Gs^Efm, Gg, Gg, Gd, Gll^Fms, Gg, Gs^Fds, Re^Gvs, Re^Gvs, Re^Gvs, Gs, Gg, Gs, Gd, Gs, Gs, Gs, Rb, Rr, Hh, Gs, Hh^Qhh, Hh, Hh, Hh, Gs, Hh, Hh
Gg^Efm, Gd, Gd, Dd, Dd, Hhd^Qhh, Hhd^Qhh, Mm^Qhh, Hhd^Qhh, Hh^Qhh, Hh, Hh, Gs, Gs, Gs, Gs, Gg, Gg, Gg^Efm, Rr, Gg, Gg^Efm, Gll^Fms, Gll^Fms, Gs^Fds, Gs^Vwm, Gd, Gd, Rb^Gvs, Gs^Efm, Gg^Efm, Gg, Gg^Efm, Gg, Gg^Efm, Gg, Gd, Gd, Gs^Fds, Gd, Rb^Gvs, Rb^Gvs, Re^Gvs, Re^Gvs, Rb^Gvs, Rb^Gvs, Gg, Gd^Vh, Rr, Gs, Rr, Rr, Gs, Gs, Hh^Qhh, Hh^Qhh, Hh, Hh, Hh, Gs, Rb^Gvs, Rb^Gvs, Rb^Gvs
Gg, Gg^Efm, Gd, Dd, Dd, Hhd, Hhd^Es, Hhd^Qhh, Hhd^Qhh, Hhd^Qhh, Gs, Hh^Vhh, Gg, Gs, Gg, Gg, Gg^Efm, Gg^Efm, Gg^Efm, Rr, Gg, Gg, Gg, Gll^Fms, Gs^Fds, Gd^Fds, Gd^Fds, Rb^Gvs, Rb^Gvs, Rb^Gvs, Re^Gvs, Gg, Rb^Gvs, Rb^Gvs, Rb^Gvs, Gg, Rb^Gvs, Rb^Gvs, Rb^Gvs, Gs^Fds, Gs^Fds, Rb^Gvs, Rb^Gvs, Rb^Gvs, Rb^Gvs, Re^Gvs, Rb, Rb, Gs, Rr, Gs, Gs, Gd^Qhh, Gd^Qhh, Hh, Hh, Hh, Hh, Gs, Rb^Gvs, Rb^Gvs, Rb^Gvs, Rb^Gvs
Re, Gg, Gs, Gd^Efm, Gd, Gs, Gs, Gs, Gs, Hhd, Gs, Gs, Gg, Gg, Gd, Gg, Gd, Gg, Gg^Efm, Rr, Gg, Gg, Gg^Efm, Gg, Gg, Gs^Fds, Rb^Gvs, Rb^Gvs, Rb^Gvs, Re^Gvs, Rb^Gvs, Rb^Gvs, Rb^Gvs, Rb^Gvs, Gs, Rb^Gvs, Re^Gvs, Re^Gvs, Rb^Gvs, Rb^Gvs, Rb^Gvs, Gs^Fds, Gs^Fds, Rb^Gvs, Gs, Gd, Rr, Gs, Gg^Qhh, Gs, Hh^Qhh, Hh^Qhh, Hh, Hh, Hh, Hh, Hh, Hh, Hh, Rb^Gvs, Rb^Gvs, Rb^Gvs, Rb^Gvs
Re, Gg, Gd, Gd, Gd, Gd, Gs, Gs, Gd, Gs, Gd, Gs, Gd, Gd, Gg, Gd, Gg^Es, Gg^Edt, Ce, Rr, Ce, Gg, Gg^Efm, Gg^Efm, Gs, Gd, Re^Gvs, Rb^Gvs, Rb^Gvs, Rb^Gvs, Re^Gvs, Rb^Gvs, Gd, Gs, Gs, Re^Gvs, Re^Gvs, Rb^Gvs, Rb^Gvs, Rb^Gvs, Rb^Gvs, Rb^Gvs, Gs, Gd^Vwm, Rr, Rr, Gs^Qhh, Gg^Qhh, Gs^Fds, Gg^Qhh, Hh, Hh, Gs, Gs, Hh, Hh, Gs, Gs, Re^Eff, Re^Gvs, Re^Gvs, Rb^Gvs, Rb^Gvs
Re, Gs, Gd^Edb, Gd^Edt, Re, Gs, Gs, Gs, Gd, Gd, Gd^Vl, Gd, Gd, Gd, Gg, Gg, Gg, Gg^Edt, Re, Rr, Rrc^Vhc, Gs, Gg, Gg^Efm, Gs^Efm, Rb^Gvs, Rb^Gvs, Re^Gvs, Rb^Gvs, Rb^Gvs, Re^Gvs, Re^Gvs, Gs^Fds, Gg^Eff, Gg^Eff, Gs, Gg^Eff, Re^Gvs, Re^Gvs, Rb^Gvs, Rr, Gd, Rr, Rr, Re^Qhh, Gs^Qhh, Gs^Fds, Gs^Fds, Re, Re, Re^Gvs, Gs, Re^Gvs, Re^Gvs, Re, Gs, Gs, Re^Eff, Re^Eff, Rb^Gvs, Re^Gvs, Re^Gvs, Rb^Gvs
Rr, Gd^Vwm, Rr, Gs^Edt, Gs^Edt, Gd, Gs, Gll, Gd, Gd^Fds, Gd^Fds, Gd^Fds, Gd^Fds, Gll, Gll, Gg, Gs, Gg, Rr, Rr, Gs, Gs, Gs, Gg^Efm, Re^Gvs, Re^Gvs, Re^Gvs, Re^Gvs, Re^Gvs, Re^Gvs, Gs^Fds, Gs^Fds, Re^Gvs, Re^Gvs, Re^Gvs, Gg^Eff, Gd^Vh, Gs^Eff, Rr, Rr, Gs, Rr, Gd, Gd, Re^Qhh, Gs^Fds, Re^Gvs, Gs^Fds, Gs^Fds, Re^Gvs, Rb^Gvs, Rb^Gvs, Rb, Re^Gvs, Re^Gvs, Re, Re, Gg^Ecf, Gg, Rb^Eff, Re, Rb^Gvs, Rb^Gvs
Re^Gvs, Rr, Gs, Rr, Rr, Gs, Gs, Gd, Gll, Gd^Fds, Gd^Fds, Gd^Fds, Gd^Fds, Gd^Fds, Re^Gvs, Re^Gvs, Re^Vwm, Gg, Rr, Gg, Re, Re, Re^Gvs, Gs^Fds, Gs^Fds, Re^Gvs, Re^Gvs, Rb^Gvs, Gs^Fds, Gs^Fds, Re, Re, Re^Gvs, Re^Gvs, Re^Gvs, Re^Gvs, Rr, Rr, Re, Gg^Eff, Gg^Eff, Gd, Gs^Qhh, Gd^Qhh, Re, Re^Gvs, Re^Gvs, Re^Gvs, Re^Gvs, Gs^Fds, Re^Gvs, Rb^Gvs, Rb^Gvs, Rb^Gvs, Rb^Gvs, Re^Gvs, Gs, Gg, Gg, Ce, Re, Re, Ww
Re^Gvs, Re^Gvs, Gs, Gg^Edt, Gs^Edt, Rr, Rr, Gs, Gs, Gd^Fds, Gd^Fds, Gll, Re^Gvs, Re^Gvs, Re^Gvs, Re^Gvs, Re^Gvs, Gg, Rr, Re, Re^Gvs, Re^Gvs, Re^Gvs, Re^Gvs, Re^Gvs, Gs^Fds, Gs^Vwm, Gs^Fds, Re^Gvs, Re^Gvs, Re^Gvs, Re^Gvs, Re^Gvs, Re^Gvs, Re^Gvs, Re^Gvs, Rb, Gd^Vh, Re^Gvs, Re, Re, Gd, Gs^Qhh, Gs, Re^Gvs, Re^Gvs, Re^Gvs, Re^Gvs, Rb^Gvs, Rb^Gvs, Re^Gvs, Re^Gvs, Re^Gvs, Re^Gvs, Gs^Fds, Gs^Fds, Gs, Ce, Ce, Ke, Ce, Ww, Ww
Re^Gvs, Re^Gvs, Gs^Es, Gs, Gg, Gg, Rr, Gs, Gs, Gs^Es, Re, Re^Gvs, Re^Gvs, Re^Gvs, Re^Gvs, Re^Gvs, Re^Gvs, Gg, Rr, Re, Re^Gvs, Re^Gvs, Re^Gvs, Re^Gvs, Re^Gvs, Re, Re, Gs^Fds, Gs^Fds, Re^Gvs, Re^Gvs, Re^Gvs, Re, Re^Gvs, Gg, Gg, Rb, Re^Gvs, Re^Gvs, Re^Gvs, Re^Gvs, Gs^Qhh, Re^Gvs, Re^Gvs, Re^Gvs, Re^Gvs, Re^Gvs, Re^Gvs, Re^Gvs, Re, Re^Gvs, Re^Gvs, Gs^Fds, Gs^Fds, Gg, Ce, Gg, Gg, Gs, Ce, Ww, Ww, Ww
Gd, Gs, Gs, Gg, Gg, Gg, Gg^Es, Rr, Rr, Gg, Gg, Re, Re^Gvs, Re^Gvs, Re^Gvs, Re^Gvs, Re^Gvs, Gg, Rr, Re, Re^Gvs, Re^Gvs, Re^Gvs, Re^Gvs, Re^Gvs, Re^Gvs, Gs, Re, Gs, Gs^Fds, Gs^Fds, Gg, Gg, Gg, Rr, Rr, Re^Gvs, Re^Gvs, Re^Gvs, Re^Gvs, Re^Gvs, Gs^Qhh, Gd, Re^Gvs, Gd, Re^Gvs, Gs, Gg, Gg^Eff, Re^Vh, Gd^Eff, Re^Eff, Gs, Gg, Gg, Gg, Ce, Ce, Ce, Ww, Ww, Ww, Ww
Gs, Gd, Gd, Gs, Gs, Gg, Gg, Gg, Gg, Rr, Rr, Gd^Fds, Re, Re^Gvs, Re^Gvs, Re^Gvs, Ce, Gg, Rr, Re, Re^Gvs, Re^Gvs, Re^Gvs, Re^Gvs, Re^Gvs, Re, Gg, Gs, Gg, Gs, Rr, Ce, Rr, Rr, Re, Re^Gvs, Re^Gvs, Re^Gvs, Re^Gvs, Re^Gvs, Gd^Qhh, Gd^Qhh, Gd, Gd, Gs, Ds, Rb^Gvs, Rb^Gvs, Rb^Gvs, Gs^Eff, Rb^Gvs, Re^Gvs, Re^Gvs, Gs, Gs, Gg, Ce, Ke, Ww, Ww, Ww, Ww, Wo
Gs, Gg, Gg, Gd, Gg, Gs, Gd, Gs, Gg, Gg, Gg, Rr, Rr, Re, Ce, Ce, Rrc^Vhc, Rr^Vhc, Rr, Rrc, Rrc^Vhc, Ce, Ce, Re^Gvs, Re^Gvs, Re^Gvs, Gg, Gg, Rr, Rr, Rr^Vhc, Rr, Ce, Rr, Rr, Re, Re, Re^Gvs, Gg^Es, Gd, Gd^Qhh, Gd, Rb^Gvs, Gs^Fds, Gs^Fds, Rb^Gvs, Rb^Gvs, Rb^Gvs, Re^Gvs, Re^Gvs, Re^Gvs, Re^Gvs, Re^Gvs, Re^Gvs, Re^Gvs, Gs, Gs, Ce, Ww, Ww, Ww, Wo, Wo
Gll, Gd^Fds, Gd^Fds, Gd^Fds, Gd^Vl, Gs, Gd, Gd, Gd^Fds, Gg, Re, Re, Ce, Rr, Rr^Vhc, Re^Ebn, Rrc, Rrc, Ww^Bsb|, Rrc, Rrc, Ke, Rr^Vhc, Ce, Gg, Gg, Rp, Rr, Gg, Gs, Re^Gvs, Gg^Edt, Gg^Edt, Gd, Rr, Gd, Re^Qhh, Re^Qhh, Gs^Qhh, Gd^Qhh, Gs, Gs, Rb^Gvs, Rb^Gvs, Rb^Gvs, Gs^Fds, Gs^Fds, Re^Gvs, Gs, Re^Gvs, Re^Gvs, Re^Gvs, Re^Gvs, Re^Gvs, Re^Gvs, Re^Gvs, Gs, Ww, Ww, Ww, Wo, Wo, Wo
Gd^Fds, Gd^Fds, Gd^Fds, Gd^Fds, Gd^Fds, Gll, Re, Re, Re, Gd^Fds, Re, Ce, Ke, Rr, Rr, Rrc, Ww, Ww, Isa, Ww, Ww, Rr, Rr, Rr^Ebn, Rr, Rr, Gg, Gg, Re^Gvs, Re^Gvs, Re^Gvs, Gd, Gs^Edt, Gg, Rr, Gd^Qhh, Rb^Gvs, Re^Gvs, Re^Gvs, Gs, Re^Gvs, Rb^Gvs, Re^Gvs, Rb^Gvs, Rb^Gvs, Rb^Gvs, Gs^Fds, Gs^Fds, Gs, Re^Gvs, Gs, Re^Gvs, Re^Gvs, Re^Gvs, Wwf, Ww, Ww, Ww, Wo, Wo, Wo, Wo, Ww
Gd^Fds, Gd^Fds, Gd^Fds, Gd^Fds, Gd^Fds, Re, Re^Gvs, Re^Gvs, Re^Gvs, Gg, Gg, Ce, Re, Rr, Ww^Bsb\, Ww, Isa^Vhc, Isa^Vhc, Isa, Isa^Vhc, Isa^Vhc, Ww, Ww^Bsb/, Rr, Rr^Vhc, Gg, Re^Gvs, Re^Gvs, Re^Gvs, Re^Gvs, Re^Eff, Gg^Eff, Gg, Rr, Re^Gvs, Rb^Gvs, Re^Gvs, Rb^Gvs, Rb^Gvs, Rr^Vhc, Rb^Gvs, Re^Gvs, Re^Gvs, Rb^Gvs, Gs, Gs, Ds, Gs, Ds, Ds, Ds, Ds, Ds, Wwf, Wwf, Wwf, Ww, Ww, Wo, Wo, Wo, Ww, Ww
Gs, Gd^Fds, Gd^Vwm, Gd^Fds, Re^Gvs, Re^Gvs, Re^Gvs, Re^Gvs, Re^Gvs, Gg^Eff, Gs^Eff, Re, Rr^Vhc, Rrc, Ww, Isa, Gg^Ebn, Ch, Ch, Ch, Gg^Ebn, Isa, Ww, Rr, Rr^Vhc, Ce, Re^Gvs, Re^Gvs, Re^Gvs, Re^Gvs, Re^Eff, Gs^Eff, Rr, Rr, Gg, Re^Gvs, Rr, Rb^Gvs, Ch, Rr, Rr, Ch, Rr^Vhc, Gs, Gs, Ds, Ds, Ds, Wwf, Ds, Wwf, Wwf, Wwf, Wwf, Wwf, Ww, Ww, Ww, Wo, Wo, Ww, Ww, Hh^Qhh
Rr, Gg, Re, Re^Gvs, Re^Gvs, Re^Gvs, Re^Gvs, Re^Gvs, Re^Eff, Re^Eff, Re, Ce, Rr^Vhc, Rrc, Ww, Isa^Vhc, Isr, Isr^Vhc, 2 Kh, Isr^Vhc, Isr, Isa^Vhc, Ww, Rrc, Rr, Ce, Re^Gvs, Re^Gvs, Gs^Fms, Re^Eff, Gg, Gs, Gg^Es, Rr, Rr, Ce, Rr, Rr, Ch, Ch, Gs, Rr, Ww, Ww^Bw\, Ww, Ds, Ww, Wwf, Ww, Ww, Ww, Ww, Ww, Wwf, Ww, Ww, Ww, Wo, Ww, Ww, Hh^Qhh, Hh^Qhh, Hh^Qhh
Gg, Rr, Rr, Rr, Rr, Re^Gvs, Re^Gvs, Re, Gg, Gg, Re, Ce, Rr, Rr, Ww, Isa^Vhc, Gg^Ebn, Isr^Vhc, Ch, Isr^Vhc, Gg^Ebn, Isa^Vhc, Ww, Rr, Rr^Vhc, Ce, Re^Gvs, Re^Gvs, Re, Gs, Gs^Fms, Gs, Gs, Ds, Ce, Rr, Rr^Vhc, Ch, Kh, Kh, Ww^Bw\, Ww, Ww, Ww, Ww, Ww, Ww, Ww, Ww, Ww, Ww, Ww, Ww, Ww, Ww, Ww, Ww, Ww, Ww, Ww^Vm, Hh^Qhh, Hh^_mh, Hh^Qhh
Re^Gvs, Re^Gvs, Gs, Gg, Gs, Rr, Rr, Rr, Rr, Gd^Fds, Gg, Ce, Rr^Ebn, Rr, Ww^Bsb/, Isa, Isa^Vhc, Ch, Isa, Ch, Isa^Vhc, Isa, Ww^Bsb\, Rr, Re^Ebn, Re, Gs, Re, Gg, Gs^Fms, Gg, Gs, Ds, Ds, Ds, Rr^Vhc, Ww, Ww, Ww^Bw|, Ww, Wo, Ww, Wo, Ww, Wo, Wo, Wo, Ww, Wo, Ww, Ww, Ww, Wwf, Wwf, Wwf, Wwf, Wwf, Ww, Hh^Qhh, Hh^Qhh, Hh, Hh, Hh^Qhh
Re^Gvs, Re^Gvs, Re^Gvs, Gs, Gd, Gd, Gd^Fds, Gs, Gg, Rr, Gg, Gs, Rp, Rr, Rrc, Ww, Ww, Isa^Vhc, Isa, Isa^Vhc, Ww, Ww, Ww, Rrc, Rr, Rr, Rr, Gg, Gg, Gg, Gg, Ds, Gs, Ds, Ww, Ww, Ww, Ww, Wo, Wo, Wo, Wo, Wo, Wo, Ww, Wo, Ww, Ww, Ww, Ww, Wwf, Ww, Wwf, Wwf, Wwf, Wwf, Gg^Qhhf, Hh^Qhh, Hh, Hh^Qhh, Hh, Hh, Hh^Qhh
Gs, Re^Gvs, Re, Re, Gg, Gg, Ce, Gs, Gs, Rr, Rr, Rp, Gg, Rrc^Vhc, Rrc, Rrc^Vhc, Rr, Ww, Ww^Bsb|, Ww, Rr^Vhc, Rr, Ww, Rr^Vhc, Ww, Ce, Gs^Edt, Rr, Rr, Gg, Ds, Ds, Ww, Ww, Ww, Ww, Wo, Wo, Ww, Wo, Ww, Ww, Ww, Ww, Ww, Ww, Gs^Fds, Ww, Wwf^Vm, Wwf, Gg, Wwf, Gg, Gg, Gg^Qhhf, Gg^Qhhf, Hh^Fds, Gg, Hh^Qhh, Hh, Hh^Qhh, Hh^Qhh, Gg
Gs, Re, Gg^Es, Gg, Gs, Re, Ce, Re, Rr, Rr, Gs, Gg, Gg, Gg, Gg^Edt, Rrc, Rrc^Vhc, Rr, Rr, Rr, Rr^Vhc, Ch^Kov, Ch, Ww, Ww, Ww, Ww, Gg, Ww, Wwf^Bsb\, Ww^Bsb\, Ww, Ww, Ww, Ww, Ww, Ww, Ww, Ww, Ww, Gg, Ww, Gg, Gg, Gg, Gg, Gs^Fds, Gs^Fds, Gg, Gg, Gg, Gg, Gg, Gg, Gg^Qhh, Hh^Fds, Gg^Vl, Hh^Fds, Gg, Gg^Qhh, Gg, Gg, Gg
Gs, Gs, Gd, Gs, Re, Re, Rr, Rr, Rr^Vhc, Gs, Gg, Gd, Gs, Gg, Gg^Efm, Ce, Ce, Rr^Vhc, Rr, Rrc^Ebn, Rr, Ch, Ww, Ww, Ww, Ww, Ww, Ww, Wo, Ww, Ww, Ww^Bsb\, Wwf^Bsb\, Ww, Ce, Ww, Gg, Gg, Gg, Gg, Gg, Gg, Gg, Gg, Gg, Gs^Fds, Gs^Fds, Gs^Fds, Gg, Gg, Gg, Hh, Hh, Hh, Hh, Gg^Qhh, Gg, Gg, Gg, Gg, Cer, Hh, Hh
Hhd, Gd, Hhd, Hhd, Rr, Rr, Re, Ce, Gg, Gg, Gd, Gd, Gd^Efm, Gg^Efm, Gg^Efm, Ds, Ww, Ww, Ww, Ch, Ww^Bh|, Ww, Wo, Ww, Ww, Ww, Ww, Wo, Ww, Ww, Ww, Rr^Vhc, Rr, Rr, Rb, Gg, Gg, Gg, Gg, Gd, Gs^Fds, Gs^Fds, Gs^Fds, Gd^Fms, Gd^Fms, Gd^Fms, Gg, Gg, Gg, Gg, Gg^Efm, Gg, Gg, Hh, Hh, Hh, Hh, Gg, Gg, Gg, Hh, Hh, Hh
Gd, Hhd, Hhd, Rr, Gg^Em, Re, Gs^Es, Gs, Gg, Gg, Gs^Vh, Gg, Ww, Ww, Ww, Ww, Wo, Ww, Ww, Ww, Ww^Bh|, Ww, Ww, Ww, Ww, Ww, Ds, Ww, Ds, Gs, Gs, Gs, Gs, Rr, Gg, Rb, Gd, Gg, Gg^Efm, Gd, Gg, Gs^Fds, Gg, Gd^Fms, Gs^Fds, Gs^Fds, Gs^Fds, Gd^Fms, Gd^Fms, Gg^Efm, Gg^Efm, Gg^Efm, Gg, Gg, Hh, Hh, Hh, Gg, Hh^Vhh, Gg, Gg, Hh, Gg
Gd, Hhd, Rr, Rr, Gd, Gs^Em, Gd, Gd, Ds, Ww, Ww, Ww, Ww, Ww, Wo, Wo, Ww, Ww, Ww, Ww, Rr, Ww, Ds, Ds, Ds, Ds, Ds, Ds, Ds, Ds, Gs, Gs, Gg, Gs, Gs, Rr, Gd, Gg, Gg, Gg^Efm, Gg, Gg, Gg^Efm, Gg, Gs^Fds, Gs^Fds, Gs^Fds, Gg, Gg, Gg, Gg, Gg^Efm, Gg, Gg, Gg, Gg, Gg, Cer, Cer, Gg, Cer, Gg, Hh
Gd, Rr, Gd, Gd, Ds, Gd^Vh, Ww, Ww, Ww, Ww, Ww, Ww, Ww, Ww, Ww, Ww, Wwg, Ww, Gg, Gg^Vh, Rr, Ds, Gg, Gg, Gg, Ds, Gs^Eff, Ds, Rb^Eff, Gs, Rb^Gvs, Rb^Gvs, Re^Gvs, Gs, Gd^Vwm, Rr, Rb, Gg, Gg, Gg, Gg, Gg, Gg, Gd^Vh, Gs^Es, Gll, Gg, Gg, Gg, Gg, Gs^Es, Gs, Gg^Vl, Gg, Rb^Gvs, Rb^Gvs, Rb^Gvs, Cer, Gg, Gg, Ker, Cer, Gg
Rr, Rr, Ds, Ds, Ww, Ww, Ww, Ww, Ww, Ww, Ww, Ww, Ww^Vm, Ww, Gg, Gg, Gg, Gg, Gd, Re, Gs, Rb, Rb, Gg, Re^Eff, Re^Eff, Rb^Gvs, Rb^Eff, Rb^Gvs, Gs^Es, Re^Gvs, Rb^Gvs, Rb^Gvs, Gd, Gd, Gs, Gd^Qhu, Rb, Rr, Gs, Gs, Gg, Gg, Gg, Gs^Em, Gd, Gg, Gg, Gd, Gg, Gs, Gg^Fms, Gg^Fms, Rb^Gvs, Rb^Gvs, Re^Gvs, Re^Gvs, Rb^Gvs, Rb^Gvs, Cer, Cer, Gs, Gs
Rr, Gd, Gs, Wwf, Ww, Ww, Wo, Ww, Ww, Ww, Gs, Ds, Gg, Gg, Gg, Gg, Re^Gvs, Re^Gvs, Re^Gvs, Rb^Gvs, Gs, Gg, Rb, Re^Eff, Re^Gvs, Re^Gvs, Re^Gvs, Re^Gvs, Re^Gvs, Re^Gvs, Rb^Gvs, Re^Gvs, Gg, Gs, Gd^Qhu, Gd^Qhu, Gd, Gd, Gd, Rb, Rr, Gd, Gd, Gd^Em, Gd, Gg, Gg, Gg, Gd^Fms, Gd, Gs, Gd, Gg, Rb^Gvs, Rb^Gvs, Re^Gvs, Re^Gvs, Re^Gvs, Re^Gvs, Rb^Gvs, Re^Gvs, Re^Eff, Re^Eff
Rr, Gd, Ww, Ww, Wo, Wo, Ww, Ww, Gd, Gd, Gs, Gs, Gg, Gg, Gg, Re^Gvs, Re^Gvs, Re^Gvs, Rb^Gvs, Re^Gvs, Rb^Gvs, Gg, Rr, Re^Gvs, Rb^Gvs, Re^Gvs, Rb^Gvs, Re^Gvs, Rb^Gvs, Rb^Gvs, Rb^Gvs, Re^Gvs, Gd, Gs, Gs^Qhu, Gd, Gs, Gd, Gs, Gs, Gs^Es, Rr, Gs, Gs, Gs, Gg, Gs, Gg, Gg^Fms, Gs^Fms, Gs, Gs, Gd, Gd, Gd, Rb^Gvs, Rb^Gvs, Re^Gvs, Rb^Gvs, Rb^Gvs, Rb^Gvs, Re^Gvs, Rb^Gvs
Ds, Ds, Ww, Ww, Ww, Ww, Ds, Gs, Gs, Gs, Gs, Gs, Gd^Fds, Gg^Em, Gd^Fds, Gg^Em, Re^Gvs, Rb^Gvs, Rb^Gvs, Re^Gvs, Rb^Gvs, Rb^Gvs, Rr, Re^Gvs, Re^Gvs, Re^Gvs, Re^Gvs, Rb^Gvs, Rb^Gvs, Rb^Gvs, Gs, Gd, Gd^Qhu, Gs^Qhu, Gs, Gg, Gg, Gd, Gs^Fms, Gs^Fms, Gs^Fms, Rb, Rr, Gs, Gs, Gs, Gg^Efm, Gg^Fms, Gd^Fms, Gs, Gg, Gs^Fms, Gd^Fms, Gd^Fms, Gd^Fms, Gd^Fms, Gd^Fms, Rb^Gvs, Rb^Gvs, Re^Gvs, Re^Gvs, Re^Gvs, Re^Eff
Ww, Ww^Vm, Wo, Wo, Ww, Wwf, Gs, Gs, Gd^Fds, Gd^Fds, Gd^Fds, Gd^Fds, Gd^Fds, Gd^Fds, Gd^Fds, Gd^Fds, Gg, Gg^Em, Rb^Gvs, Re^Gvs, Re^Gvs, Rb^Gvs, Rr, Re^Gvs, Re^Gvs, Re^Gvs, Rb^Gvs, Rb^Gvs, Rb^Gvs, Rb^Gvs, Gs, Gs^Qhu, Gs, Gs, Gs^Efm, Gs, Gd, Gd, Gs^Fms, Gs^Fms, Gs^Fms, Gs^Fms, Gg^Qhu, Rr, Rr, Gg^Qhu, Gg^Qhu, Gg, Gg, Gs, Gs, Gg^Fms, Gd^Fms, Gd^Fms, Gd^Fms, Gd^Fms, Gd^Fms, Gd, Gd, Rb^Gvs, Rb^Eff, Re^Eff, Re^Gvs
Ww, Wo, Wo, Ww, Ww, Gg, Gd^Fds, Gd^Fds, Gd^Fds, Gd^Fds, Gd^Fds, Gd^Fds, Gd^Fds, Gd^Fds, Gd^Fds, Gg, Rb^Gvs, Re^Gvs, Re^Gvs, Re^Gvs, Re^Gvs, Gs, Rb, Re^Gvs, Re^Gvs, Rb^Gvs, Rb^Gvs, Rb^Gvs, Gs, Gs, Gs^Qhu, Gs^Qhu, Gs^Efm, Gs^Efm, Gs^Efm, Gs, Gs, Gg^Vl, Gs^Fms, Gs^Fms, Gs^Fms, Gs^Fms, Gs^Fms, Gg^Qhu, Gg^Qhu, Rr, Rr, Gd^Vh, Gs, Gg, Gg^Fms, Gg^Fms, Gg^Fms, Gg^Fms, Gg^Fms, Gg^Fms, Gg^Fms, Gg^Fms, Gs^Vwm, Rb^Eff, Re^Gvs, Re^Eff, Re^Eff
Ww, Ww, Wwf, Ww, Gg, Gs, Gd^Fds, Gd^Fds, Gd^Fds, Gd^Fds, Gs^Vl, Gd^Fds, Rb^Gvs, Re^Gvs, Re^Gvs, Rb^Gvs, Re^Gvs, Re^Gvs, Re^Gvs, Re^Gvs, Gg^Vwm, Gs, Rr, Re^Gvs, Gs, Gs, Gg, Gg, Gs^Qhu, Gs^Qhu, Gs, Gs, Gs, Gs^Efm, Gs, Gd^Es, Gs, Gs^Fms, Gd, Gs^Qhu, Gg^Qhu, Gs, Gs, Gg^Qhu, Gd^Vh, Gg^Efm, Gg, Rr, Rr, Gs, Gg, Gg^Fms, Gg^Fms, Gg^Fms, Gg^Fms, Gg^Fms, Gg^Fms, Gg^Fms, Gg^Fms, Rb^Gvs, Re^Gvs, Re^Gvs, Re^Gvs
Ww, Wwf, Wwf, Ds, Gg, Gg, Gg^Es, Gd^Vl, Gd, Gs, Rb^Gvs, Rb^Gvs, Rb^Gvs, Re^Gvs, Re^Gvs, Re^Gvs, Re^Gvs, Rb^Gvs, Gs, Gs, Gs, Gs, Gs, Rb, Gs^Vh, Gs, Gs^Qhu, Gs^Qhuf, Gg^Fds, Gs, Gs, Gs, Gg, Gs, Gs^Fms, Gg, Gs^Fms, Gs, Gs^Fds, Gg^Fds, Gg^Fms, Gg^Qhu, Gs^Qhu, Gg^Qhu, Gs^Qhu, Gs^Efm, Gs^Efm, Gg, Gg, Rb, Rr, Gg, Gg, Gg, Gg, Gg, Gg, Gg, Gg, Re^Gvs, Re^Gvs, Re^Gvs, Re^Gvs
Ww, Wwf, Ds, Ds, Gs^Fms, Gs, Gs, Gg, Gg, Rb^Gvs, Rb^Gvs, Rb^Gvs, Rb^Gvs, Re^Gvs, Gs, Re^Gvs, Gs, Gs, Gd^Fms, Gs^Fds, Gs^Fds, Gs, Rr, Rb, Gg, Gg^Fds, Gg^Qhuf, Gs^Fms, Gg^Fms, Gs, Gs, Gs, Gs, Gg^Fms, Gg^Fms, Gs^Fms, Gg^Fds, Gs^Fms, Gg^Fds, Gs^Fms, Gs^Fds, Gs^Fms, Gs^Fms, Gs^Qhu, Gs^Fms, Gs^Qhu, Gs^Qhu, Gg, Gg, Gs, Gg, Rr, Rr, Rr, Rr, Gg, Gg, Gg, Gg^Fms, Gg^Fms, Gg^Fms, Re^Gvs, Gg^Fms
Wwf, Wwf, Gg, Gs^Fms, Gs^Fds, Gs^Fds, Gs^Fds, Gg, Gs, Rb^Gvs, Rb^Gvs, Re^Gvs, Gg, Gs^Fms, Gg^Fms, Gs^Fds, Gg^Fds, Gd^Fds, Gg, Gd^Fms, Gd^Fms, Gs, Rr, Gs, Gg^Qhu, Gg^Qhuf, Gg^Qhuf, Gs^Qhu, Gg^Qhuf, Gg^Fds, Gg, Gg, Gg, Gg^Fms, Gg^Fms, Gg^Fds, Gg, Gg^Fds, Gg, Gg, Gg^Fds, Gs^Fds, Gg^Fds, Gs^Fds, Gg^_mll, Gg^Fms, Gg, Gs^Qhu, Gg^Qhu, Gs, Gg, Gg, Gg, Gg, Gg, Rr, Rr, Gg, Gg, Gg^Fms, Gg^Fms, Gg^Fms, Gg^Fms
