Md^Qhh, Md^Qhh, Md^Qhh, Md^Qhh, Md^Qhh, Gd^Qhh, Hhd^Qhh, Gd, Gd, Gs, Gs, Gg, Hhd, Md^Qhh, Hhd^Qhh, Gg^Qhh, Mm^Qhh, Gd^Qhh, Hhd^Qhh, Gd^Qhh, Md^Xm, Gg, Hhd, Gg, Hhd, Mm, Md^Qhh, Hhd^Qhh, Hhd, Gd, Mdd, Mm, Hhd, Gg, Hhd, Md^Xm, Hhd, Md^Xm, Md^Xm, Gg, Hhd
Md^Qhh, Md^Xm, Md^Xm, Md, Md, Md^Xm, Md, Hhd^Qhh, Hhd^Qhh, Gs, Gs, Gs, Hhd, Md^Qhh, Md^Qhh, Md^Xm, Md, Md^Xm, Md^Xm, Md^Xm, Md^Xm, Md^Xm, Md, Md^Xm, Md^Xm, Md^Xm, Md^Qhh, Md^Xm, Hhd, Mdd, Mdd, Mm, Mm, Chr, Md, Md^Xm, Md^Xm, Md^Xm, Md^Xm, Md^Xm, Md^Xm
Md^Qhh, Md, Hhd, Md, Md, Md, Md, Md, Md^Qhh, Hhd, Gd, Gs, Gd, Md, Gd, Md^Qhh, Md^Qhh, Md^Xm, Md^Xm, Md^_mh, Md, Md^Xm, Md^Xm, Hhd, Hhd, Md^Xm, Md, Md^Qhh, Md^Qhh, Md, Md, Md, Md, Md, Md^Xm, Md^Xm, Md^Xm, Md, Hhd, Md^Xm, Md^Xm
Hhd^Qhh, Hhd, Hhd, Md, Md, Md^Xm, Md, Md, Md, Hhd^Qhh, Hhd^Es, Gs, Gd, Gd, Gd, Hhd, Hhd, Md^Qhh, Md^Qhh, Md^Xm, Md, Md, Md, Md, Hhd, Hhd, Hhd^Vhr, Hhd, Gd^Dr, Chr^Qhh, Md, Md, Chr^Edb, Md, Md, Md^Xm, Md^Xm, Md, Md, Hhd, Hhd
Gs, Gd^Qhh, Hhd^Qhh, Hhd, Md^Qhh, Md, Md, Md, Md, Md^Qhh, Md^Qhh, Hhd, Hhd, Gs, Gs, Hhd, Gs, Hhd^Qhh, Hhd^Qhh, Md^Qhh, Hhd^Qhh, Md, Hhd, Hhd, Wwg, Gs, Gd, Gd, Gd^Edb, Hhd^Qhh, Md, Hhd^Vhhr, Chr^Dr, 3 Khr^Edb, Chr^Edb, Md^Xm, Md, Md^Xm, Md, Md, Hhd
Gs, Gs, Hhd, Hhd^Qhh, Hhd^Qhh, Md^Qhh, Md^Qhh, Md, Md, Mm, Md, Md^Qhh, Hhd, Gd, Re^Vct, Gd^Efm, Gs^Efm, Gd, Gs, Hhd, Hhd^Qhh, Md, Md, Hhd, Wwg, Wwg, Wwg, Gd^Edb, Gd, Hhd^Qhh, Hhd^Qhh, Hhd^Qhh, Hhd^Qhh, Md^_mhh, Md, Md, Md, Md, Chr^Dr, Hhd, Hhd
Gd, Gs, Gs, Hhd, Gs, Hhd^Es, Hhd^Es, Hhd^Qhh, Hhd^Qhh, Md^_mh, Md^Qhh, Md^Qhh, Ce^Edb, Gd, Gd^Ecf, Gs, Gs^Efm, Gs^Efm, Gs, Gd, Md^Qhh, Md, Hhd^Es, Hhd, Hhd, Wwg, Gd, Gd, Hhd, Gd, Gd, Gd^Edb, Gd^Edb, Chr^Qhh, Md^Qhh, Md, Md^Xm, Md, Mm, Hhd, Hhd
Gd, Gd, Gd^Es, Gd, Gs, Gs, Gd, Gd^Es, Hhd, Md^Qhh, Md^Qhh, 2 Ke, Ce^Edb, Gd^Edb, Gd, Gd, Gs, Gs^Efm, Gd, Hhd, Md^Qhh, Md, Hhd, Hhd, Mdd, Md, Md, Hhd, Hhd, Hhd, Hhd, Gd^Edb, Hhd^Dr, Gd, Hhd^Vhhr, Md^Qhh, Md, Md, Md, Md, Hhd
Gd, Gd, Gd^Wm, Gd, Gd^Es, Gd, Gd, Gd, Gd^Edb, Hhd, Ce, Hhd, Re^Vct, Hhd, Gd^Edb, Gd^Edb, Gs, Gs, Gd, Hhd, Gd, Hhd^Qhh, Hhd, Mdd, Mdd, Md, Chr, Md, Md^Xm, Md, Md^Xm, Md, Md, Hhd, Hhd, Chr^Qhh, Md, Md, Md^Xm, Md, Hhd
Gs, Gd, Gs, Gd, Gs^Es, Gs, Gs, Gd, Gd, Gd, Gd, Gd^Edb, Gd^Ecf, Gd, Re^Vct, Gd, Gd, Gd, Hh, Hh^Es, Mm, Hh^Qhh, Hhd^Qhh, Md, Md, Md, Md, Md, Md, Md^Xm, Md^Xm, Md^Xm, Md^Xm, Md, Md, Md^Qhh, Hhd, Md, Md, Md, Hhd
Gg^Efm, Gs, Gd, Gs, Gs, Gs, Gs^Es, Gs, Gd, Gd, Gg, Gd, Gs, Gg, Gd, Gd, Gd, Gd, Hhd, Hh, Hh, Md, Hhd, Md^Qhh, Md^Qhh, Md, Md, 4 Chr^Kov, Chr^Qhh, Md, Mdd, Mdd, Md, Md, Md, Hhd^Qhh, Hhd^Qhh, Gd, Hhd^Es, Hhd, Gd
Gg^Efm, Gs, Gs, Gs, Gs^Efm, Gs, Gs, Gs, Gg, Gg, Gg, Gs, Gg, Gs, Gd, Gs^Es, Gd, Gd, Gd, Gd, Gd, Hhd, Hhd, Hhd, Hhd, Gd^Qhh, Hhd^Qhh, Chr^Qhh, Hhd^Vhhr, Md^Qhh, Chr^Qhh, Mdd, Mdd^Qhh, Md, Md^Qhh, Md^Xm, Md, Hhd^Qhh, Hhd^Qhh, Gd^Es, Gd
Gg, Gd^Efm, Gg^Efm, Gd, Gg^Efm, Gs, Gs, Gs, Gg, Gg, Gg, Gg, Hh^Qhh, Gg, Gg, Gs, Gs, Gd, Gd, Gd, Hhd, Gd, Md, Md, Hhd^Dr, Md, Gd, Gd^Edb, Hhd, Hhd, Gd^Edb, Hhd^Qhh, Dd, Hhd^Qhh, Dd, Hhd^Qhh, Hhd^Qhh, Md, Md^Qhh, Hhd, Hhd
Gg^Efm, Gg, Gg^Efm, Gg^Efm, Gg^Efm, Gg^Efm, Hh^Qhh, Hh, Gg, Gg, Hh^Qhh, Gg^Qhh, Hh^Qhh, Gg, Gg, Gd, Gs, Gd, Gd, Hhd, Hhd, Hhd, Hhd, Md, Hh, Hhd, Gs, Gd, Gs, Gd^Edb, Gd, Gd, Gd, Dd^Edb, Dd^Edb, Hhd, Dd, Hhd^Qhh, Hhd^Qhh, Md^Qhh, Md^Qhh
Gg^Efm, Gg, Gg^Qhh, Gg^Qhh, Gg^Qhh, Hh^Qhh, Mm, Mm^Qhh, Hh^Qhh, Gs^Vhr, Hh^Qhh, Hh^Edb, Hh^Qhh, Gg, Gg^Efm, Gg, Gg^Efm, Gd, Gd, Hhd, Hhd, Hhd, Gd, Mm, Mm, Hh^Edb, Hh, Gs^Vhr, Mm, Gs, Gs, Gs, Gd, Dd, Gs, Dd, Gd, Dd, Dd, Hhd^Qhh, Hhd^Qhh
Gg^Qhh, Gg^Qhh, Gg, Gg, Gg, Hh, Hh, Mm, Mm, Hh^Qhh, Mm, Hh^Edb, Hh^Qhh, Gg, Gg, Gs^Efm, Gg^Efm, Gg^Efm, Gg, Gd, Gs, Gd, Gs, Hh, Hhd, Md, Md, Mm, Mm, Mm, Mm^Efm, Mm^Xm, Mm^Efm, Gs, Gs, Dd, Gd^Es, Gd, Gd, Hhd, Hhd
Hh, Hh, Gg, Gg, Gs, Gg, Gg, Hh^Dr, Mm, Mm, Mm, Mm, Hh, Hh^Qhh, Gs, Gs, Gg^Efm, Gg^Efm, Gg, Gd, Gs, Gs, Gg, Gd, Gd, Hhd, Gd, Md, Md, Mm, Md, Mm^Efm, Mm, Hh^Edb, Hh^Edb, Gs, Gs^Efm, Gd, Gd, Gd, Gd
Hh, Hh, Hh, Gg^Vwm, Hh^Es, Hh, Mm, Mm, Mm, Mm, Mm, Mm, Mm, Hh^Qhh, Gs, Gs, Gs^Efm, Gg^Efm, Gg^Efm, Gg, Gg, Gg, Gs, Gd, Gd, Gd, Gs, Hhd, Hhd, Md, Md, Md, Mm, Mm, Hhd, Gs, Gs, Gd^Efm, Gd^Efm, Gs^Efm, Gs^Efm
Mm, Mm, Mm, Hh^Es, Hh^Es, Mm, Mm, Mm, Mm^Xm, Mm^Xm, Mm, Hh, Mm, Hh^Qhh, Hh^Qhh, Gg, Gg, Gg, Gg^Efm, Gg, Gg, Gg, Gd, Gd, Gs, Gd, Gs, Gd, Hhd, Gd, Hhd, Md, Md, Md, Hhd, Gd, Gd, Gd, Gs^Efm, Gs^Efm, Gs^Efm
Mm, Mm, Mm, Mm, Mm, Mm, Mm, Mm, Mm, Mm, Mm, Mm, Hh^Es, Mm, Chr^Qhh, Hh^Qhh, Gs^Vhr, Gs, Gs, Gg, Gg, Gg, Gg, Gg, Gd, Gs, Gd, Gs, Gd, Hhd^Es, Hhd, Hhd, Hhd^Vhhr, Md, Mm, Hhd^Es, Hhd^Es, Gd, Gs, Gs^Efm, Gs^Efm
Mm, Mm, Mm, Mm, Mm, Mm^Xm, Mm^Xm, Mm, Mm, Mm, Mm, Mm, Hh^Es, Hh^Qhh, Gs, Hh, Gg^Es, Gg, Gs, Gg, Gg^Es, Gs, Gd, Gg, Gs, Gs, Gd, Gs, Gd, Gd, Gd, Gs, Gs, Hh, Hh, Hh, Hh^Es, Gs, Gg, Gs, Gs
Hh, Mm, Mm, Mm, Mm^Xm, Mm, Mm^Xm, Mm^Xm, Mm, Mm, Mm, Mm, Chr^Dr, Hh^Qhh, Gs^Edb, Gs^Edb, Gs^Edb, Gg, Gs^Qhh, Gs, Gg, Gs, Hh, Gs, Hh, Hh, Gd, Gd, Gs, Gd, Gd, Gd, Gd, Gs, Gs, Hh, Hh, Hh, Gg, Gs, Gd
Gs, Hh, Hh^Es, Mm, Mm, Mm^Xm, Mm^Xm, Mm^Xm, Mm, Mm, Chr^Edb, Mm, 5 Khr, Chr^Qhh, Hh^Qhh, Hh^Qhh, Mm^Qhh, Chr^Qhh, Hh, Gs^Qhh, Hh, Hh^Vhr, Hh, Hh, Hh, Gg, Gg, Gs, Gs, Gs, Gs, Gd, Gs, Gd, Gs, Gd, Gd, Gg, Gs, Gs, Gs
Hh, Gs, Hh^Es, Hh^Es, Mm^Xm, Mm^Xm, Mm^Xm, Mm, Hh, Mm, Mm, Mm, Mm, Chr^_mh, Hh^Edb, Hh^Vhhr, Mm^Xm, Mm, Mm^Edb, Hh^Qhh, Hh^Qhh, Mm, Mm, Hh, Hh, Gg, Gg, Gg, Gs, Gs, Gs, Gs, Gs, Gs, Gg, Gs, Gs, Gs, Gs, Gs, Gs
Hh, Hh, Mm, Hh, Mm^Xm, Mm^Xm, Hh, Hh^Dr, Mm^Xm, Mm, Mm, Hh^Es, Hh, Mm, Mm, Mm, Mm, Mm, Hh^Edb, Mm, Mm, Mm^Qhh, Mm, Mm, Mm, Hh, Gs, Gg, Gg^Efm, Gs, Gg^Efm, Gg, Gg, Gg, Gg, Gg^Vh, Gg^Eff, Gs, Gs, Gd, Gs
Mm, Mm, Mm^Xm, Mm^Xm, Mm, Mm^Xm, Mm^Xm, Mm, Mm, Mm^Xm, Mm, Mm, Hh^Es, Hh^Dr, Mm, Mm, Mm, Mm, Mm, Mm, Hh^Es, Mm^Qhh, Mm^Qhh, Mm, Mm, Hh, Hh, Gg, Gg, Gg^Efm, Gs^Efm, Gg^Efm, Gg^Efm, Gg, Gg, Gg, Rb^Eff, Gs^Eff, Gs^Eff, Gs, Gs
Mm, Mm, Mm, Mm, Mm, Mm, Mm^Xm, Mm^Xm, Mm^Xm, Mm, Mm, Mm, Mm^Xm, Hh^Es, Mm, Mm, Mm, Mm, Mm, Mm, Hh^Es, Hh, Hh^Qhh, Mm, Mm, Mm, Hh, Gg, Gg, Gg, Gs^Efm, Gs^Efm, Gs, Gg^Efm, Rb^Gvs, Rb, Rb^Gvs, Rb^Gvs, Rb^Gvs, Rb^Eff, Rb^Eff
Mm, Mm, Mm, Mm, Mm^Xm, Mm, Mm^Xm, Mm^Xm, Mm, Mm, Mm^Xm, Hh, Gd, Mm^Xm, Mm^Xm, Mm^Xm, Mm^Xm, Mm, Mm, Hh, Hh^Es, Hh^Es, Hh, Hh^Qhh, Mm^Qhh, Mm, Hh, Hh, Hh, Gd, Gd, Gg^Efm, Gg^Efm, Gg, Rb^Gvs, Rb^Gvs, Rb^Gvs, Rb^Gvs, Rb^Gvs, Rb^Gvs, Rb^Gvs
